Account No,DATE,TRANSACTION DETAILS,CHQ.NO.,VALUE DATE,WITHDRAWAL AMT,DEPOSIT AMT,BALANCE AMT,.
409000493201',2016-09-05,TRF FROM  Indiaforensic SERVICES,,2016-09-05,,500000.0,962200.0,.
409000493201',2016-09-06,BBPS SETTLEMENT DT 30/08/,,2016-09-06,802.77,,961397.23,.
409000493201',2016-09-06,BBPS SETTLEMENT DT 31/08/,,2016-09-06,239.89,,961157.34,.
409000493201',2016-09-06,BBPS SETTLEMENT DT 01/09/,,2016-09-06,1193.54,,959963.7999999999,.
409000493201',2016-10-18,BBPS SETTLEMENT DTD 17.10,,2016-10-18,32.99,,959930.8099999999,.
409000493201',2016-10-19,BBPS SETTLEMENT DTD 18.10,,2016-10-19,16.3,,959914.5099999999,.
409000493201',2016-10-19,BBPS SETTLEMENT DTD 19.10,,2016-10-19,18.04,,959896.4699999999,.
409000493201',2016-10-20,BBPS SETTLEMENT DTD 20.10,,2016-10-20,22.99,,959873.4799999999,.
409000493201',2016-10-21,BBPS SETTLEMENT DTD 21.10,,2016-10-21,14.85,,959858.6299999999,.
409000493201',2016-10-27,BBPS SETTLEMENT FOR DT 27,,2016-10-27,198.15,,959660.4799999999,.
409000493201',2016-11-01,BBPS SETTLEMENT FOR DT 31,,2016-11-01,1015.71,,958644.7699999999,.
409000493201',2016-11-03,BBPS SETTLEMENT FOR DT 03,,2016-11-03,1925.33,,956719.44,.
409000493201',2016-11-04,BBPS SETTLEMENT FOR DT 04,,2016-11-04,2284.09,,954435.35,.
409000493201',2016-11-05,BBPS SETTLEMENT FOR DT 05,,2016-11-05,689.3,,953746.0499999999,.
409000493201',2016-11-07,BBPS SETTLEMENT FOR DTD 0,,2016-11-07,199.3,,953546.7499999999,.
409000493201',2016-11-17,BBPS SETTLEMENT FOR DT 17,,2016-11-17,1938.02,,951608.7299999999,.
409000493201',2016-11-18,BBPS SETTLEMENT FOR DTD 1,,2016-11-18,579.3,,951029.4299999998,.
409000493201',2016-11-23,BBPS SETTLEMENT FOR DT 23,,2016-11-23,899.17,,950130.2599999998,.
409000493201',2016-11-24,BBPS SETTLEMENT FOR DT 24,,2016-11-24,3927.5,,946202.7599999998,.
409000493201',2016-12-21,BBPS SETTLEMENT FOR DT 21,,2016-12-21,8.15,,946194.6099999998,.
409000493201',2016-12-22,BBPS SETTLEMENT FOR DT 22,,2016-12-22,98.15,,946096.4599999997,.
409000493201',2016-12-23,BBPS SETTLEMENT FOR DT 23,,2016-12-23,499.17,,945597.2899999997,.
409000493201',2016-12-30,BBPS SETTLEMENT DTD 30DEC,,2016-12-30,8.15,,945589.1399999997,.
409000493201',2017-01-03,BBPS SETTLEMENT FOR DT 03,,2017-01-03,8.15,,945580.9899999996,.
409000493201',2017-01-04,BBPS SETTLEMENT FOR DT 04,,2017-01-04,1758.02,,943822.9699999996,.
409000493201',2017-01-16,BBPS SETTLEMENT FOR 16JAN,,2017-01-16,4320.41,,939502.5599999996,.
409000493201',2017-01-17,BBPS SETTLEMENT DTD 17JAN,,2017-01-17,3875.0,,935627.5599999996,.
409000493201',2017-01-18,BBPS SETTLEMENT DTD 18JAN,,2017-01-18,1387.44,,934240.1199999996,.
409000493201',2017-01-19,BBPS SETTLEMENT DTD 19JAN,,2017-01-19,10379.49,,923860.6299999997,.
409000493201',2017-01-20,BBPS SETTLEMENT DTD 20JAN,,2017-01-20,3234.87,,920625.7599999997,.
409000493201',2017-01-23,BBPS SETTLEMENT DTD 21JAN,,2017-01-23,884.87,,919740.8899999997,.
409000493201',2017-01-23,BBPS SETTLEMENT DTD 23JAN,,2017-01-23,47.44,,919693.4499999997,.
409000493201',2017-01-24,BBPS SETTLEMENT DTD 24JAN,,2017-01-24,190.0,,919503.4499999997,.
409000493201',2017-01-27,BBPS SETTLEMENT DTD 27JAN,,2017-01-27,15009.49,,904493.9599999997,.
409000493201',2017-01-30,BBPS SETTLEMENT FOR DT 30,,2017-01-30,41386.19,,863107.7699999998,.
409000493201',2017-01-31,BBPS SETTLEMENT FOR DT 31,,2017-01-31,2232.44,,860875.3299999998,.
409000493201',2017-02-01,BBPS SETTLEMENT FOR DT 01,,2017-02-01,4642.19,,856233.1399999999,.
409000493201',2017-02-02,BBPS SETTLEMENT FOR DT 02,,2017-02-02,2442.44,,853790.7,.
409000493201',2017-02-03,BBPS SETTLEMENT FOR DT 03,,2017-02-03,2338.45,,851452.25,.
409000493201',2017-02-04,BBPS SETTLEMENT FOR DT 04,,2017-02-04,7.57,,851444.68,.
409000493201',2017-02-06,BBPS SETTLEMENT FOR DT 06,,2017-02-06,10449.24,,840995.4400000001,.
409000493201',2017-02-07,BBPS SETTLEMENT FOR DT 07,,2017-02-07,2852.05,,838143.39,.
409000493201',2017-02-08,BBPS SETTLEMENT FOR DT 08,,2017-02-08,6777.18,,831366.21,.
409000493201',2017-02-09,BBPS SETTLEMENT FOR DT 09,,2017-02-09,2.1,,831364.11,.
409000493201',2017-02-10,BBPS SETTLEMENT FOR DT 10,,2017-02-10,,0.9,831365.01,.
409000493201',2017-02-13,BBPS SETTLEMENT FOR DT 13,,2017-02-13,4.7,,831360.31,.
409000493201',2017-02-15,BBPS SETTLEMENT FOR DT 15,,2017-02-15,3238.66,,828121.65,.
409000493201',2017-02-16,BBPS SETTLEMENT FOR DT 16,,2017-02-16,4.7,,828116.9500000001,.
409000493201',2017-02-17,BBPS SETTLEMENT FOR DT 17,,2017-02-17,14823.01,,813293.9400000001,.
409000493201',2017-02-18,BBPS SETTLEMENT 18.02.201,,2017-02-18,302.48,,812991.4600000001,.
409000493201',2017-02-21,BBPS SETTLEMENT FOR DT 21,,2017-02-21,523.18,,812468.28,.
409000493201',2017-02-22,BBPS SETTLEMENT FOR DT 22,,2017-02-22,3201.71,,809266.5700000001,.
409000493201',2017-02-23,BBPS SETTLEMENT FOR DT 23,,2017-02-23,6859.36,,802407.2100000001,.
409000493201',2017-02-24,BBPS SETTLEMENT FOR DT 24,,2017-02-24,12674.8,,789732.41,.
409000493201',2017-02-27,BBPS SETTLEMENT FOR DT 27,,2017-02-27,87395.82,,702336.5900000001,.
409000493201',2017-02-28,BBPS SETTLEMENT FOR DT 28,,2017-02-28,15225.89,,687110.7000000001,.
409000493201',2017-03-01,BBPS SETTLEMENT FOR DT 01,,2017-03-01,20337.85,,666772.8500000001,.
409000493201',2017-03-02,BBPS SETTLEMENT FOR DT 02,,2017-03-02,21616.66,,645156.1900000001,.
409000493201',2017-03-03,BBPS SETTLEMENT FOR DT 03,,2017-03-03,8082.01,,637074.18,.
409000493201',2017-03-04,BBPS SETTLEMENT 04032017,,2017-03-04,12695.55,,624378.63,.
409000493201',2017-03-06,BBPS SETTLEMENT 06032017,,2017-03-06,68860.48,,555518.15,.
409000493201',2017-03-07,BBPS SETTLEMENT 07032017,,2017-03-07,73209.78,,482308.37,.
409000493201',2017-03-09,TRF FROM  Indiaforensic SERVICES,,2017-03-09,,500000.0,982308.37,.
409000493201',2017-03-09,BBPS SETTLEMENT  OX01 09.,,2017-03-09,35996.01,,946312.36,.
409000493201',2017-03-09,BBPS SETTLEMENT FOR OX01,,2017-03-09,73844.12,,872468.24,.
409000493201',2017-03-10,BBPS SETTLEMENT 10032017,,2017-03-10,71365.62,,801102.62,.
409000493201',2017-03-13,BBPS SETTLEMENT 13032017,,2017-03-13,108914.09,,692188.53,.
409000493201',2017-03-14,BBPS SETTLEMENT FOR DT 14,,2017-03-14,1059.13,,691129.4,.
409000493201',2017-03-15,BBPS SETTLEMENT 15032017,,2017-03-15,83102.87,,608026.53,.
409000493201',2017-03-15,TRF FROM  Indiaforensic SERVICES,,2017-03-15,,67000.0,675026.53,.
409000493201',2017-03-16,BBPS SETTLEMENT 16032017,,2017-03-16,89537.25,,585489.28,.
409000493201',2017-03-16,TRF FRM  Indiaforensic SERVICES,,2017-03-16,,117000.0,702489.28,.
409000493201',2017-03-17,BBPS SETTLEMENT 17032017,,2017-03-17,117674.17,,584815.11,.
409000493201',2017-03-17,TRF FRM  Indiaforensic SERVICES,,2017-03-17,,150000.0,734815.11,.
409000493201',2017-03-18,BBPS OX01 SETTLEMENT 1803,,2017-03-18,93646.0,,641169.11,.
409000493201',2017-03-20,TRF FRM  Indiaforensic SERVICES,,2017-03-20,,150000.0,791169.11,.
409000493201',2017-03-20,BBPS SETTLEMENT FOR DT 20,,2017-03-20,87337.96,,703831.15,.
409000493201',2017-03-21,BBPS SETTLEMENT 21032017,,2017-03-21,183235.55,,520595.60000000003,.
409000493201',2017-03-21,T FRM  Indiaforensic SERVICES IN,,2017-03-21,,200000.0,720595.6000000001,.
409000493201',2017-03-22,TRF FROM  Indiaforensic SERVICES,,2017-03-22,,100000.0,820595.6000000001,.
409000493201',2017-03-22,BBPS OX01 SETTLEMENT 22.0,,2017-03-22,78583.4,,742012.2000000001,.
409000493201',2017-03-23,TRF FRM  Indiaforensic SERVICES,,2017-03-23,,100000.0,842012.2000000001,.
409000493201',2017-03-23,BBPS OX01 SETTLEMENT 23.0,,2017-03-23,146774.9,,695237.3,.
409000493201',2017-03-24,BBPS XO01 SETTLEMENT 24.0,,2017-03-24,81047.31,,614189.99,.
409000493201',2017-03-24,TRF FROM  Indiaforensic SERVICES,,2017-03-24,,200000.0,814189.99,.
409000493201',2017-03-26,BBPS SETTLEMENT 26032017,,2017-03-26,169846.16,,644343.83,.
409000493201',2017-03-27,TRF FROM  Indiaforensic SERVICES,,2017-03-27,,100000.0,744343.83,.
409000493201',2017-03-27,BBPS SETTLEMENT DTD 27MAR,,2017-03-27,27509.12,,716834.71,.
409000493201',2017-03-28,TRF FRM  Indiaforensic SERVICES,,2017-03-28,,200000.0,916834.71,.
409000493201',2017-03-28,TRF FRM  Indiaforensic SERVICES,,2017-03-28,,400000.0,1316834.71,.
409000493201',2017-03-28,BBPS SETTLEMENT 28032017,,2017-03-28,391248.8,,925585.9099999999,.
409000493201',2017-03-29,BBPS SETTLEMENT 29032017,,2017-03-29,149362.11,,776223.7999999999,.
409000493201',2017-03-30,BBPS SETTLEMENT 30032017,,2017-03-30,192834.72,,583389.08,.
409000493201',2017-03-30,TRF FRM  Indiaforensic SERVICES,,2017-03-30,,100000.0,683389.08,.
409000493201',2017-03-31,BBPS SETTLEMENT FOR DT 31,,2017-03-31,145409.67,,537979.4099999999,.
409000493201',2017-03-31,FDRL/INTERNAL FUND TRANSFE,,2017-03-31,,150000.0,687979.4099999999,.
409000493201',2017-04-03,TRF FROM  Indiaforensic SERVICES,,2017-04-03,,200000.0,887979.4099999999,.
409000493201',2017-04-03,BBPS SETTLEMENT 03042017,,2017-04-03,348756.64,,539222.7699999999,.
409000493201',2017-04-03,TRF FRM  Indiaforensic SERVICES,,2017-04-03,,100000.0,639222.7699999999,.
409000493201',2017-04-04,BBPS SETTLEMENT 04042017,,2017-04-04,58178.96,,581043.8099999999,.
409000493201',2017-04-04,TRF FRM  Indiaforensic SERVICES,,2017-04-04,,100000.0,681043.8099999999,.
409000493201',2017-04-05,BBPS OX01 SETTLEMENT 05.0,,2017-04-05,72560.62,,608483.19,.
409000493201',2017-04-05,TRF FRM  Indiaforensic SERVICES,,2017-04-05,,50000.0,658483.19,.
409000493201',2017-04-06,BBPS SETTLEMENT FOR DT 06,,2017-04-06,92843.96,,565639.23,.
409000493201',2017-04-06,TRF FRM  Indiaforensic SERVICES,,2017-04-06,,100000.0,665639.23,.
409000493201',2017-04-07,BBPS OX01 SETTLEMENT 07.0,,2017-04-07,77750.54,,587888.69,.
409000493201',2017-04-07,TRF FRM  Indiaforensic SERVICES,,2017-04-07,,50000.0,637888.69,.
409000493201',2017-04-07,TRF FROM  Indiaforensic SERVICES,,2017-04-07,,500000.0,1137888.69,.
409000493201',2017-04-10,BBPS OX01 SETTLEMENT 10.0,,2017-04-10,70821.9,,1067066.79,.
409000493201',2017-04-11,BBPS OX01 SETTLEMENT 11.0,,2017-04-11,105418.35,,961648.4400000001,.
409000493201',2017-04-11,WAIVE SWITCHING FEES 31.0,,2017-04-11,,665.49,962313.93,.
409000493201',2017-04-12,BBPS SETTLEMENT 12042017,,2017-04-12,127317.4,,834996.53,.
409000493201',2017-04-13,BBPS SETTLEMENT DTD 13APR,,2017-04-13,57483.14,,777513.39,.
409000493201',2017-04-15,BBPS SETTLEMENT FOR DT 15,,2017-04-15,103667.55,,673845.84,.
409000493201',2017-04-17,BBPS OX01 SETTLEMENT 17.0,,2017-04-17,102737.16,,571108.6799999999,.
409000493201',2017-04-17,TRF FRM  Indiaforensic SERVICES,,2017-04-17,,500000.0,1071108.68,.
409000493201',2017-04-18,BBPS OX01 SETTLEMENT 18.0,,2017-04-18,75758.03,,995350.6499999999,.
409000493201',2017-04-19,BBPS OX01 SETTLEMENT 19.0,,2017-04-19,145936.93,,849413.72,.
409000493201',2017-04-20,BBPS OX01 SETTLEMENT 20.0,,2017-04-20,47216.93,,802196.7899999999,.
409000493201',2017-04-21,BBPS OX01 SETTLEMENT 21.0,,2017-04-21,51735.72,,750461.07,.
409000493201',2017-04-24,BBPS SETTLMENT OX01 24.04,,2017-04-24,89131.66,,661329.4099999999,.
409000493201',2017-04-25,BBPS SETTLEMENT FOR DT 25,,2017-04-25,118834.97,,542494.44,.
409000493201',2017-04-26,TRF FROM  Indiaforensic SERVICES,,2017-04-26,,500000.0,1042494.44,.
409000493201',2017-04-26,BBPS SETTLEMENT FOR DT 26,,2017-04-26,107909.86,,934584.58,.
409000493201',2017-04-28,BBPS SETTLEMENT 28042017,,2017-04-28,78121.88,,856462.7,.
409000493201',2017-04-29,BBPS SETTLEMENT 29042017,,2017-04-29,73483.43,,782979.27,.
409000493201',2017-05-01,BBPS SETTLEMENT 01052017,,2017-05-01,36802.24,,746177.03,.
409000493201',2017-05-02,BBPS SETTLEMENT 02052017,,2017-05-02,27621.17,,718555.86,.
409000493201',2017-05-03,BBPS SETTLEMENT 03052017,,2017-05-03,36178.03,,682377.83,.
409000493201',2017-05-04,BBPS SETTLEMENT 04052017,,2017-05-04,44830.92,,637546.9099999999,.
409000493201',2017-05-05,BBPS SETTLEMENT 05052017,,2017-05-05,54274.88,,583272.0299999999,.
409000493201',2017-05-05,FDRL/INTERNAL FUND TRANSFE,,2017-05-05,,100000.0,683272.0299999999,.
409000493201',2017-05-06,BBPS SETTLEMENT 06052017,,2017-05-06,56535.19,,626736.8399999999,.
409000493201',2017-05-08,BBPS SETTLEMENT FOR DT 08,,2017-05-08,76276.17,,550460.6699999998,.
409000493201',2017-05-08,FDRL/INTERNAL FUND TRANSFE,,2017-05-08,,100000.0,650460.6699999998,.
409000493201',2017-05-09,BBPS SETTLEMENT 09052017,,2017-05-09,92354.75,,558105.9199999998,.
409000493201',2017-05-09,BBPS OX01 SETTLEMENT 20.0,,2017-05-09,60288.54,,497817.37999999983,.
409000493201',2017-05-09,REV BBPS OX01 SETTLEMENT,,2017-05-09,,47216.93,545034.3099999998,.
409000493201',2017-05-10,FDRL/INTERNAL FUND TRANSFE,,2017-05-10,,100000.0,645034.3099999998,.
409000493201',2017-05-10,FDRL/INTERNAL FUND TRANSFE,,2017-05-10,,50000.0,695034.3099999998,.
409000493201',2017-05-10,FDRL/INTERNAL FUND TRANSFE,,2017-05-10,,100000.0,795034.3099999998,.
409000493201',2017-05-10,BBPS SETTLEMENT 10052017,,2017-05-10,93277.36,,701756.9499999998,.
409000493201',2017-05-11,BBPS SETTLEMENT 11052017,,2017-05-11,53444.53,,648312.4199999998,.
409000493201',2017-05-12,BBPS SETTLEMENT 12052017,,2017-05-12,93913.0,,554399.4199999998,.
409000493201',2017-05-12,FDRL/INTERNAL FUND TRANSFE,,2017-05-12,,100000.0,654399.4199999998,.
409000493201',2017-05-15,BBPS SETTLEMENT 15052017,,2017-05-15,171720.19,,482679.2299999998,.
409000493201',2017-05-15,FDRL/INTERNAL FUND TRANSFE,,2017-05-15,,200000.0,682679.2299999997,.
409000493201',2017-05-16,BBPS SETTLEMENT 16052017,,2017-05-16,195767.92,,486911.3099999997,.
409000493201',2017-05-16,FDRL/INTERNAL FUND TRANSFE,,2017-05-16,,200000.0,686911.3099999997,.
409000493201',2017-05-17,BBPS SETTLEMENT 17052017,,2017-05-17,106620.67,,580290.6399999997,.
409000493201',2017-05-18,FDRL/INTERNAL FUND TRANSFE,,2017-05-18,,200000.0,780290.6399999997,.
409000493201',2017-05-18,BBPS SETTLEMENT 18052017,,2017-05-18,131020.4,,649270.2399999996,.
409000493201',2017-05-19,BBPS SETTLEMENT 19052017,,2017-05-19,83209.48,,566060.7599999997,.
409000493201',2017-05-19,FDRL/INTERNAL FUND TRANSFE,,2017-05-19,,50000.0,616060.7599999997,.
409000493201',2017-05-20,BBPS SETTLEMENT 20052017,,2017-05-20,97156.51,,518904.24999999965,.
409000493201',2017-05-22,FDRL/INTERNAL FUND TRANSFE,,2017-05-22,,100000.0,618904.2499999997,.
409000493201',2017-05-22,BBPS SETTLEMENT 22052017,,2017-05-22,56789.04,,562115.2099999996,.
409000493201',2017-05-23,BBPS SETTLEMENT 23052017,,2017-05-23,75945.44,,486169.7699999996,.
409000493201',2017-05-24,FDRL/INTERNAL FUND TRANSFE,,2017-05-24,,200000.0,686169.7699999996,.
409000493201',2017-05-24,BBPS SETTLEMENT 24052017,,2017-05-24,147938.81,,538230.9599999995,.
409000493201',2017-05-25,FDRL/INTERNAL FUND TRANSFE,,2017-05-25,,200000.0,738230.9599999995,.
409000493201',2017-05-25,FDRL/INTERNAL FUND TRANSFE,,2017-05-25,,200000.0,938230.9599999995,.
409000493201',2017-05-25,BBPS SETTLEMENT 25052017,,2017-05-25,181189.4,,757041.5599999995,.
409000493201',2017-05-26,BBPS SETTLEMENT 26052017,,2017-05-26,62213.14,,694828.4199999995,.
409000493201',2017-05-26,FDRL/INTERNAL FUND TRANSFE,,2017-05-26,,100000.0,794828.4199999995,.
409000493201',2017-05-29,BBPS SETTLEMENT 29052017,,2017-05-29,187145.89,,607682.5299999994,.
409000493201',2017-05-30,TRF FRM  Indiaforensic SERVICES,,2017-05-30,,400000.0,1007682.5299999994,.
409000493201',2017-05-30,BBPS SETTLEMENT 30052017,,2017-05-30,128069.51,,879613.0199999994,.
409000493201',2017-05-30,FDRL/INTERNAL FUND TRANSFE,,2017-05-30,,100000.0,979613.0199999994,.
409000493201',2017-05-30,FDRL/INTERNAL FUND TRANSFE,,2017-05-30,,200000.0,1179613.0199999996,.
409000493201',2017-05-31,BBPS SETTLEMENT 31052017,,2017-05-31,74751.37,,1104861.6499999994,.
409000493201',2017-06-01,BBPS SETTLEMENT 01062017,,2017-06-01,76825.54,,1028036.1099999994,.
409000493201',2017-06-02,BBPS STMT FOR DTD 01JUN17,,2017-06-02,98256.42,,929779.6899999994,.
409000493201',2017-06-03,BBPS SETMNT FOR DT 020620,,2017-06-03,99989.44,,829790.2499999993,.
409000493201',2017-06-05,FDRL/INTERNAL FUND TRANSFE,,2017-06-05,,200000.0,1029790.2499999993,.
409000493201',2017-06-05,BBPS SETMNT FOR DT 030620,,2017-06-05,77700.46,,952089.7899999993,.
409000493201',2017-06-06,BBPS SETMNT FOR DT 050620,,2017-06-06,54678.2,,897411.5899999994,.
409000493201',2017-06-07,BBPS SETMNT FOR DT 060620,,2017-06-07,89160.28,,808251.3099999994,.
409000493201',2017-06-08,BBPS SETMNT FOR DT 070620,,2017-06-08,53804.99,,754446.3199999994,.
409000493201',2017-06-09,BBPS SETMNT FOR DT 080620,,2017-06-09,92193.6,,662252.7199999994,.
409000493201',2017-06-12,TRF FROM  Indiaforensic SERVICES,,2017-06-12,,750000.0,1412252.7199999993,.
409000493201',2017-06-12,BBPS SETTLEMENT DATED 12.,,2017-06-12,856588.64,,555664.0799999993,.
409000493201',2017-06-13,BBPS SETMNT FOR DT 130620,,2017-06-13,54089.18,,501574.89999999927,.
409000493201',2017-06-14,FDRL/INTERNAL FUND TRANSFE,,2017-06-14,,100000.0,601574.8999999992,.
409000493201',2017-06-14,FDRL/INTERNAL FUND TRANSFE,,2017-06-14,,100000.0,701574.8999999992,.
409000493201',2017-06-14,BBPS SETMNT FOR DT 140620,,2017-06-14,119587.27,,581987.6299999992,.
409000493201',2017-06-15,FDRL/INTERNAL FUND TRANSFE,,2017-06-15,,100000.0,681987.6299999992,.
409000493201',2017-06-15,FDRL/INTERNAL FUND TRANSFE,,2017-06-15,,100000.0,781987.6299999992,.
409000493201',2017-06-15,FDRL/INTERNAL FUND TRANSFE,,2017-06-15,,100000.0,881987.6299999992,.
409000493201',2017-06-15,BBPS SETMNT FOR DT 150620,,2017-06-15,227030.51,,654957.1199999992,.
409000493201',2017-06-16,BBPS SETMNT FOR DT 160620,,2017-06-16,119516.51,,535440.6099999992,.
409000493201',2017-06-16,FDRL/INTERNAL FUND TRANSFE,,2017-06-16,,200000.0,735440.6099999992,.
409000493201',2017-06-17,BBPS SETMNT FOR DT 170620,,2017-06-17,98749.92,,636690.6899999991,.
409000493201',2017-06-19,FDRL/INTERNAL FUND TRANSFE,,2017-06-19,,200000.0,836690.6899999991,.
409000493201',2017-06-19,BBPS SETMNT FOR DT 190620,,2017-06-19,175151.51,,661539.1799999991,.
409000493201',2017-06-20,BBPS SETMNT FOR DT 200620,,2017-06-20,155678.63,,505860.5499999991,.
409000493201',2017-06-20,FDRL/INTERNAL FUND TRANSFE,,2017-06-20,,200000.0,705860.5499999991,.
409000493201',2017-06-21,BBPS SETMNT FOR DT 210620,,2017-06-21,100834.49,,605026.0599999991,.
409000493201',2017-06-21,FDRL/INTERNAL FUND TRANSFE,,2017-06-21,,200000.0,805026.0599999991,.
409000493201',2017-06-22,BBPS SETMNT FOR DT 220620,,2017-06-22,127130.39,,677895.6699999991,.
409000493201',2017-06-22,FDRL/INTERNAL FUND TRANSFE,,2017-06-22,,200000.0,877895.6699999991,.
409000493201',2017-06-23,BBPS SETMNT FOR DT 230620,,2017-06-23,135857.04,,742038.6299999991,.
409000493201',2017-06-27,TRF FROM  Indiaforensic SERVICES,,2017-06-27,,500000.0,1242038.629999999,.
409000493201',2017-06-27,BBPS SETTLEMENT DATED 270,,2017-06-27,540324.73,,701713.899999999,.
409000493201',2017-06-28,FDRL/INTERNAL FUND TRANSFE,,2017-06-28,,100000.0,801713.899999999,.
409000493201',2017-06-28,FDRL/INTERNAL FUND TRANSFE,,2017-06-28,,200000.0,1001713.899999999,.
409000493201',2017-06-28,BBPS SETTLEMENT FOR DT 28,,2017-06-28,241548.23,,760165.669999999,.
409000493201',2017-06-29,TRF FROM  Indiaforensic SERVICES,,2017-06-29,,500000.0,1260165.669999999,.
409000493201',2017-06-29,BBPS SETMNT FOR DT 290620,,2017-06-29,66778.43,,1193387.239999999,.
409000493201',2017-06-30,BBPS SETMNT FOR DT 300620,,2017-06-30,88020.44,,1105366.799999999,.
409000493201',2017-07-01,BBPS SETMNT FOR DT 010720,,2017-07-01,79105.87,,1026260.9299999991,.
409000493201',2017-07-03,BBPS SETMNT FOR DT 030720,,2017-07-03,129069.18,,897191.7499999991,.
409000493201',2017-07-03,REV SWITCHING FEE + SERVI,,2017-07-03,,1671.63,898863.3799999991,.
409000493201',2017-07-04,BBPS SETMNT FOR DT 040720,,2017-07-04,131864.31,,766999.0699999991,.
409000493201',2017-07-05,BBPS SETMNT FOR DT 050720,,2017-07-05,64350.32,,702648.7499999992,.
409000493201',2017-07-06,BBPS SETMNT FOR DT 060720,,2017-07-06,158111.18,,544537.5699999991,.
409000493201',2017-07-07,BBPS SETMNT FOR DT 070720,,2017-07-07,39166.52,,505371.0499999991,.
409000493201',2017-07-07,FDRL/INTERNAL FUND TRANSFE,,2017-07-07,,200000.0,705371.0499999991,.
409000493201',2017-07-10,BBPS SETMNT FOR DT 100720,,2017-07-10,182353.53,,523017.5199999991,.
409000493201',2017-07-10,FDRL/INTERNAL FUND TRANSFE,,2017-07-10,,200000.0,723017.5199999991,.
409000493201',2017-07-10,FDRL/INTERNAL FUND TRANSFE,,2017-07-10,,200000.0,923017.5199999991,.
409000493201',2017-07-11,BBPS SETMNT FOR DT 110720,,2017-07-11,227142.83,,695874.6899999991,.
409000493201',2017-07-11,FDRL/INTERNAL FUND TRANSFE,,2017-07-11,,200000.0,895874.6899999991,.
409000493201',2017-07-11,FDRL/INTERNAL FUND TRANSFE,,2017-07-11,,100000.0,995874.6899999991,.
409000493201',2017-07-11,FDRL/INTERNAL FUND TRANSFE,,2017-07-11,,200000.0,1195874.689999999,.
409000493201',2017-07-12,BBPS SETMNT FOR DT 120720,,2017-07-12,128509.5,,1067365.189999999,.
409000493201',2017-07-13,BBPS SETMNT FOR DT 130720,,2017-07-13,138813.76,,928551.429999999,.
409000493201',2017-07-14,BBPS SETMNT FOR DT 140720,,2017-07-14,129618.64,,798932.789999999,.
409000493201',2017-07-14,FDRL/INTERNAL FUND TRANSFE,,2017-07-14,,100000.0,898932.789999999,.
409000493201',2017-07-14,FDRL/INTERNAL FUND TRANSFE,,2017-07-14,,200000.0,1098932.789999999,.
409000493201',2017-07-15,BBPS SETMNT FOR DT 150720,,2017-07-15,130451.9,,968480.8899999991,.
409000493201',2017-07-17,BBPS SETMNT FOR DT 170720,,2017-07-17,125047.3,,843433.589999999,.
409000493201',2017-07-18,BBPS SETMNT FOR DT 180720,,2017-07-18,252733.4,,590700.189999999,.
409000493201',2017-07-19,BBPS SETMNT FOR DT 190720,,2017-07-19,97236.56,,493463.629999999,.
409000493201',2017-07-19,FDRL/INTERNAL FUND TRANSFE,,2017-07-19,,200000.0,693463.629999999,.
409000493201',2017-07-20,BBPS SETMNT FOR DT 200720,,2017-07-20,95441.08,,598022.549999999,.
409000493201',2017-07-20,FDRL/INTERNAL FUND TRANSFE,,2017-07-20,,100000.0,698022.549999999,.
409000493201',2017-07-20,FDRL/INTERNAL FUND TRANSFE,,2017-07-20,,100000.0,798022.549999999,.
409000493201',2017-07-21,BBPS SETMNT FOR DT 210720,,2017-07-21,84080.38,,713942.169999999,.
409000493201',2017-07-21,FDRL/INTERNAL FUND TRANSFE,,2017-07-21,,200000.0,913942.169999999,.
409000493201',2017-07-21,FDRL/INTERNAL FUND TRANSFE,,2017-07-21,,200000.0,1113942.169999999,.
409000493201',2017-07-24,BBPS SETMNT FOR DT 240720,,2017-07-24,202879.78,,911062.389999999,.
409000493201',2017-07-25,BBPS SETMNT FOR DT 250720,,2017-07-25,137149.6,,773912.789999999,.
409000493201',2017-07-25,FDRL/INTERNAL FUND TRANSFE,,2017-07-25,,200000.0,973912.789999999,.
409000493201',2017-07-26,BBPS SETMNT FOR DT 260720,,2017-07-26,89718.9,,884193.889999999,.
409000493201',2017-07-27,BBPS SETMNT FOR DT 270720,,2017-07-27,109103.6,,775090.289999999,.
409000493201',2017-07-27,FDRL/INTERNAL FUND TRANSFE,,2017-07-27,,100000.0,875090.289999999,.
409000493201',2017-07-27,FDRL/INTERNAL FUND TRANSFE,,2017-07-27,,100000.0,975090.289999999,.
409000493201',2017-07-28,BBPS SETMNT FOR DT 280720,,2017-07-28,128572.3,,846517.989999999,.
409000493201',2017-07-28,FDRL/INTERNAL FUND TRANSFE,,2017-07-28,,50000.0,896517.989999999,.
409000493201',2017-07-28,FDRL/INTERNAL FUND TRANSFE,,2017-07-28,,100000.0,996517.989999999,.
409000493201',2017-07-28,FDRL/INTERNAL FUND TRANSFE,,2017-07-28,,50000.0,1046517.989999999,.
409000493201',2017-07-28,FDRL/INTERNAL FUND TRANSFE,,2017-07-28,,100000.0,1146517.9899999988,.
409000493201',2017-07-28,FDRL/INTERNAL FUND TRANSFE,,2017-07-28,,100000.0,1246517.9899999988,.
409000493201',2017-07-28,FDRL/INTERNAL FUND TRANSFE,,2017-07-28,,100000.0,1346517.9899999988,.
409000493201',2017-07-29,BBPS SETMNT FOR DT 290720,,2017-07-29,125092.78,,1221425.2099999988,.
409000493201',2017-07-31,BBPS SETMNT FOR DT 310720,,2017-07-31,191881.3,,1029543.9099999988,.
409000493201',2017-08-01,BBPS SETMNT FOR DT 010820,,2017-08-01,99288.6,,930255.3099999988,.
409000493201',2017-08-02,BBPS SETMNT FOR DT 020820,,2017-08-02,158804.4,,771450.9099999988,.
409000493201',2017-08-02,FDRL/INTERNAL FUND TRANSFE,,2017-08-02,,200000.0,971450.9099999988,.
409000493201',2017-08-03,BBPS SETMNT FOR DT 030820,,2017-08-03,52393.37,,919057.5399999988,.
409000493201',2017-08-04,BBPS SETMNT FOR DT 040820,,2017-08-04,109234.48,,809823.0599999988,.
409000493201',2017-08-04,FDRL/INTERNAL FUND TRANSFE,,2017-08-04,,50000.0,859823.0599999988,.
409000493201',2017-08-04,FDRL/INTERNAL FUND TRANSFE,,2017-08-04,,50000.0,909823.0599999988,.
409000493201',2017-08-04,FDRL/INTERNAL FUND TRANSFE,,2017-08-04,,50000.0,959823.0599999988,.
409000493201',2017-08-04,FDRL/INTERNAL FUND TRANSFE,,2017-08-04,,50000.0,1009823.0599999988,.
409000493201',2017-08-04,FDRL/INTERNAL FUND TRANSFE,,2017-08-04,,50000.0,1059823.0599999987,.
409000493201',2017-08-04,FDRL/INTERNAL FUND TRANSFE,,2017-08-04,,50000.0,1109823.0599999987,.
409000493201',2017-08-04,FDRL/INTERNAL FUND TRANSFE,,2017-08-04,,50000.0,1159823.0599999987,.
409000493201',2017-08-04,FDRL/INTERNAL FUND TRANSFE,,2017-08-04,,50000.0,1209823.0599999987,.
409000493201',2017-08-04,FDRL/INTERNAL FUND TRANSFE,,2017-08-04,,50000.0,1259823.0599999987,.
409000493201',2017-08-04,FDRL/INTERNAL FUND TRANSFE,,2017-08-04,,50000.0,1309823.0599999987,.
409000493201',2017-08-04,FDRL/INTERNAL FUND TRANSFE,,2017-08-04,,50000.0,1359823.0599999987,.
409000493201',2017-08-04,FDRL/INTERNAL FUND TRANSFE,,2017-08-04,,50000.0,1409823.0599999987,.
409000493201',2017-08-04,FDRL/INTERNAL FUND TRANSFE,,2017-08-04,,50000.0,1459823.0599999987,.
409000493201',2017-08-04,FDRL/INTERNAL FUND TRANSFE,,2017-08-04,,50000.0,1509823.0599999987,.
409000493201',2017-08-04,FDRL/INTERNAL FUND TRANSFE,,2017-08-04,,50000.0,1559823.0599999987,.
409000493201',2017-08-04,FDRL/INTERNAL FUND TRANSFE,,2017-08-04,,50000.0,1609823.0599999987,.
409000493201',2017-08-05,BBPS SETTMT DTD 050817,,2017-08-05,174658.14,,1435164.9199999985,.
409000493201',2017-08-07,BBPS SETMNT FOR DT 070820,,2017-08-07,126978.66,,1308186.2599999986,.
409000493201',2017-08-08,BBPS SETMNT FOR DT 080820,,2017-08-08,12646.88,,1295539.3799999987,.
409000493201',2017-08-09,BBPS SETMNT FOR DT 090820,,2017-08-09,234382.52,,1061156.8599999987,.
409000493201',2017-08-10,BBPS SETMNT FOR DT 100820,,2017-08-10,106384.13,,954772.7299999987,.
409000493201',2017-08-11,BBPS SETMNT FOR DT 110820,,2017-08-11,137544.04,,817228.6899999987,.
409000493201',2017-08-11,FDRL/INTERNAL FUND TRANSFE,,2017-08-11,,50000.0,867228.6899999987,.
409000493201',2017-08-11,FDRL/INTERNAL FUND TRANSFE,,2017-08-11,,50000.0,917228.6899999987,.
409000493201',2017-08-11,FDRL/INTERNAL FUND TRANSFE,,2017-08-11,,50000.0,967228.6899999987,.
409000493201',2017-08-11,FDRL/INTERNAL FUND TRANSFE,,2017-08-11,,50000.0,1017228.6899999987,.
409000493201',2017-08-11,FDRL/INTERNAL FUND TRANSFE,,2017-08-11,,50000.0,1067228.6899999985,.
409000493201',2017-08-11,FDRL/INTERNAL FUND TRANSFE,,2017-08-11,,50000.0,1117228.6899999985,.
409000493201',2017-08-11,FDRL/INTERNAL FUND TRANSFE,,2017-08-11,,50000.0,1167228.6899999985,.
409000493201',2017-08-11,FDRL/INTERNAL FUND TRANSFE,,2017-08-11,,50000.0,1217228.6899999985,.
409000493201',2017-08-11,FDRL/INTERNAL FUND TRANSFE,,2017-08-11,,50000.0,1267228.6899999985,.
409000493201',2017-08-11,FDRL/INTERNAL FUND TRANSFE,,2017-08-11,,50000.0,1317228.6899999985,.
409000493201',2017-08-11,FDRL/INTERNAL FUND TRANSFE,,2017-08-11,,50000.0,1367228.6899999985,.
409000493201',2017-08-11,FDRL/INTERNAL FUND TRANSFE,,2017-08-11,,50000.0,1417228.6899999985,.
409000493201',2017-08-14,BBPS SETMNT FOR DT 110820,,2017-08-14,393022.08,,1024206.6099999985,.
409000493201',2017-08-16,BBPS SETMNT FOR DT 160820,,2017-08-16,320215.84,,703990.7699999984,.
409000493201',2017-08-16,FDRL/INTERNAL FUND TRANSFE,,2017-08-16,,50000.0,753990.7699999984,.
409000493201',2017-08-16,FDRL/INTERNAL FUND TRANSFE,,2017-08-16,,100000.0,853990.7699999984,.
409000493201',2017-08-16,FDRL/INTERNAL FUND TRANSFE,,2017-08-16,,50000.0,903990.7699999984,.
409000493201',2017-08-16,FDRL/INTERNAL FUND TRANSFE,,2017-08-16,,50000.0,953990.7699999984,.
409000493201',2017-08-17,BBPS SETMNT FOR DT 170820,,2017-08-17,284668.24,,669322.5299999984,.
409000493201',2017-08-17,TRF FRM  Indiaforensic SERVICES,,2017-08-17,,300000.0,969322.5299999984,.
409000493201',2017-08-18,BBPS SETMNT FOR DT 180820,,2017-08-18,173738.94,,795583.5899999985,.
409000493201',2017-08-18,TRF FROM  Indiaforensic SERVICES,,2017-08-18,,700000.0,1495583.5899999985,.
409000493201',2017-08-19,BBPS SETMNT FOR DT 190820,,2017-08-19,312417.98,,1183165.6099999985,.
409000493201',2017-08-21,BBPS SETMNT FOR DT 210820,,2017-08-21,192034.74,,991130.8699999985,.
409000493201',2017-08-22,BBPS SETMNT FOR DT 220820,,2017-08-22,197829.48,,793301.3899999985,.
409000493201',2017-08-22,TRF FROM  Indiaforensic SERVICES,,2017-08-22,,300000.0,1093301.3899999985,.
409000493201',2017-08-23,BBPS SETMNT FOR DT 230820,,2017-08-23,196623.9,,896677.4899999985,.
409000493201',2017-08-24,BBPS SETMNT FOR DT 240820,,2017-08-24,238134.06,,658543.4299999985,.
409000493201',2017-08-24,TRF FROM  Indiaforensic SERVICES,,2017-08-24,,1000000.0,1658543.4299999985,.
409000493201',2017-08-25,BBPS SETMNT FOR DT 250820,,2017-08-25,110264.22,,1548279.2099999986,.
409000493201',2017-08-28,BBPS SETMNT FOR DT 280820,,2017-08-28,292705.76,,1255573.4499999986,.
409000493201',2017-08-29,BBPS SETMNT FOR DT 290820,,2017-08-29,162675.2,,1092898.2499999986,.
409000493201',2017-08-30,BBPS SETMNT FOR DT 300820,,2017-08-30,163053.01,,929845.2399999986,.
409000493201',2017-08-31,BBPS SETMNT FOR DT 310820,,2017-08-31,135399.38,,794445.8599999986,.
409000493201',2017-08-31,TRF FROM  Indiaforensic SERVICES,,2017-08-31,,300000.0,1094445.8599999985,.
409000493201',2017-09-01,BBPS SETMNT FOR DT 010920,,2017-09-01,95113.98,,999331.8799999985,.
409000493201',2017-09-01,TRF FROM  Indiaforensic SERVICES,,2017-09-01,,300000.0,1299331.8799999985,.
409000493201',2017-09-04,BBPS SETMNT FOR DT 040920,,2017-09-04,215378.07,,1083953.8099999984,.
409000493201',2017-09-05,BBPS SETMNT FOR DT 050920,,2017-09-05,139586.04,,944367.7699999984,.
409000493201',2017-09-05,TRF FROM  Indiaforensic SERVICES,,2017-09-05,,200000.0,1144367.7699999984,.
409000493201',2017-09-06,BBPS SETMNT FOR DT 060920,,2017-09-06,51906.35,,1092461.4199999983,.
409000493201',2017-09-07,BBPS SETMNT FOR DT 070920,,2017-09-07,103643.52,,988817.8999999983,.
409000493201',2017-09-08,BBPS SETMNT FOR DT 080920,,2017-09-08,103607.47,,885210.4299999983,.
409000493201',2017-09-08,TRF FROM  Indiaforensic SERVICES,,2017-09-08,,700000.0,1585210.4299999983,.
409000493201',2017-09-11,BBPS SETMNT FOR DT 110920,,2017-09-11,248270.54,,1336939.8899999983,.
409000493201',2017-09-12,BBPS SETMNT FOR DT 120920,,2017-09-12,198397.74,,1138542.1499999983,.
409000493201',2017-09-13,BBPS SETMNT FOR DT 130920,,2017-09-13,185118.88,,953423.2699999983,.
409000493201',2017-09-14,BBPS SETMNT FOR DT 140920,,2017-09-14,153981.32,,799441.9499999983,.
409000493201',2017-09-15,BBPS SETMNT FOR DT 150920,,2017-09-15,135500.36,,663941.5899999983,.
409000493201',2017-09-15,TRF FROM  Indiaforensic SERVICES,,2017-09-15,,500000.0,1163941.5899999985,.
409000493201',2017-09-16,BBPS SETMNT FOR DT 160920,,2017-09-16,136074.51,,1027867.0799999984,.
409000493201',2017-09-18,BBPS SETMNT FOR DT 180920,,2017-09-18,249806.2,,778060.8799999985,.
409000493201',2017-09-18,TRF FRM  Indiaforensic SERVICES,,2017-09-18,,300000.0,1078060.8799999985,.
409000493201',2017-09-19,BBPS SETMNT FOR DT 190920,,2017-09-19,209833.19,,868227.6899999985,.
409000493201',2017-09-20,BBPS SETMNT FOR DT 200920,,2017-09-20,128161.28,,740066.4099999985,.
409000493201',2017-09-20,TRF FROM  Indiaforensic SERVICES,,2017-09-20,,300000.0,1040066.4099999985,.
409000493201',2017-09-21,BBPS SETMNT FOR DT 210920,,2017-09-21,162881.7,,877184.7099999986,.
409000493201',2017-09-22,BBPS SETMNT FOR DT 220920,,2017-09-22,144857.19,,732327.5199999986,.
409000493201',2017-09-22,TRF FRM  Indiaforensic SERVICES,,2017-09-22,,500000.0,1232327.5199999986,.
409000493201',2017-09-25,BBPS SETMNT FOR DT 250920,,2017-09-25,364716.38,,867611.1399999986,.
409000493201',2017-09-25,NEFT/FDRL666621043/ONE 97,,2017-09-25,,2624.66,870235.7999999986,.
409000493201',2017-09-25,TRF FRM  Indiaforensic SERVICES,,2017-09-25,,300000.0,1170235.7999999986,.
409000493201',2017-09-26,BBPS SETMNT FOR DT 260920,,2017-09-26,182120.07,,988115.7299999986,.
409000493201',2017-09-27,BBPS SETMNT FOR DT 270920,,2017-09-27,234319.9,,753795.8299999986,.
409000493201',2017-09-27,TRF FRM  Indiaforensic SERVICES,,2017-09-27,,500000.0,1253795.8299999987,.
409000493201',2017-09-28,BBPS SETMNT FOR DT 280920,,2017-09-28,245871.02,,1007924.8099999987,.
409000493201',2017-09-29,BBPS SETMNT FOR DT 290920,,2017-09-29,157424.01,,850500.7999999986,.
409000493201',2017-09-29,FDRL/INTERNAL FUND TRANSFE,,2017-09-29,,200000.0,1050500.7999999986,.
409000493201',2017-09-29,FDRL/INTERNAL FUND TRANSFE,,2017-09-29,,200000.0,1250500.7999999986,.
409000493201',2017-09-29,FDRL/INTERNAL FUND TRANSFE,,2017-09-29,,200000.0,1450500.7999999986,.
409000493201',2017-09-29,FDRL/INTERNAL FUND TRANSFE,,2017-09-29,,200000.0,1650500.7999999986,.
409000493201',2017-09-29,FDRL/INTERNAL FUND TRANSFE,,2017-09-29,,200000.0,1850500.7999999986,.
409000493201',2017-10-03,BBPS SETMNT FOR DT 031020,,2017-10-03,270162.95,,1580337.8499999987,.
409000493201',2017-10-04,BBPS SETMNT FOR DT 041020,,2017-10-04,181195.86,,1399141.9899999988,.
409000493201',2017-10-05,BBPS SETMNT FOR DT 051020,,2017-10-05,161169.73,,1237972.2599999988,.
409000493201',2017-10-06,BBPS SETMNT FOR DT 061020,,2017-10-06,89091.32,,1148880.9399999988,.
409000493201',2017-10-07,BBPS SETMNT FOR DT 071020,,2017-10-07,178893.4,,969987.5399999988,.
409000493201',2017-10-09,BBPS SETMNT FOR DT 091020,,2017-10-09,214144.33,,755843.2099999988,.
409000493201',2017-10-09,FDRL/INTERNAL FUND TRANSFE,,2017-10-09,,300000.0,1055843.2099999988,.
409000493201',2017-10-10,BBPS SETMNT FOR DT 101020,,2017-10-10,282299.66,,773543.5499999989,.
409000493201',2017-10-11,FDRL/INTERNAL FUND TRANSFE,,2017-10-11,,300000.0,1073543.5499999989,.
409000493201',2017-10-11,BBPS SETMNT FOR DT 111020,,2017-10-11,114192.42,,959351.1299999988,.
409000493201',2017-10-12,BBPS SETMNT FOR DT 121020,,2017-10-12,115110.46,,844240.6699999989,.
409000493201',2017-10-13,BBPS SETMNT FOR DT 131020,,2017-10-13,176862.77,,667377.8999999989,.
409000493201',2017-10-13,FDRL/INTERNAL FUND TRANSFE,,2017-10-13,,300000.0,967377.8999999989,.
409000493201',2017-10-13,FDRL/INTERNAL FUND TRANSFE,,2017-10-13,,300000.0,1267377.899999999,.
409000493201',2017-10-16,BBPS SETMNT FOR DT 161020,,2017-10-16,338660.26,,928717.639999999,.
409000493201',2017-10-17,BBPS SETMNT FOR DT 171020,,2017-10-17,197665.59,,731052.049999999,.
409000493201',2017-10-17,FDRL/INTERNAL FUND TRANSFE,,2017-10-17,,200000.0,931052.049999999,.
409000493201',2017-10-17,FDRL/INTERNAL FUND TRANSFE,,2017-10-17,,300000.0,1231052.0499999989,.
409000493201',2017-10-18,BBPS SETMNT FOR DT 181020,,2017-10-18,147757.43,,1083294.619999999,.
409000493201',2017-10-18,FDRL/INTERNAL FUND TRANSFE,,2017-10-18,,200000.0,1283294.619999999,.
409000493201',2017-10-18,FDRL/INTERNAL FUND TRANSFE,,2017-10-18,,300000.0,1583294.619999999,.
409000493201',2017-10-19,BBPS SETMNT FOR DT 191020,,2017-10-19,118763.54,,1464531.079999999,.
409000493201',2017-10-20,BBPS SETMNT FOR DT 201020,,2017-10-20,36239.71,,1428291.369999999,.
409000493201',2017-10-21,BBPS SETMNT FOR DT 211020,,2017-10-21,61013.3,,1367278.069999999,.
409000493201',2017-10-23,BBPS SETMNT FOR DT 231020,,2017-10-23,154823.14,,1212454.9299999988,.
409000493201',2017-10-24,BBPS SETMNT FOR DT 241020,,2017-10-24,201777.25,,1010677.6799999988,.
409000493201',2017-10-25,FDRL/INTERNAL FUND TRANSFE,,2017-10-25,,200000.0,1210677.6799999988,.
409000493201',2017-10-25,BBPS SETMNT FOR DT 251020,,2017-10-25,289604.87,,921072.8099999988,.
409000493201',2017-10-26,BBPS SETMNT FOR DT 261020,,2017-10-26,203242.03,,717830.7799999987,.
409000493201',2017-10-26,FDRL/INTERNAL FUND TRANSFE,,2017-10-26,,300000.0,1017830.7799999987,.
409000493201',2017-10-27,BBPS SETMNT FOR DT 271020,,2017-10-27,98594.43,,919236.3499999987,.
409000493201',2017-10-27,FDRL/INTERNAL FUND TRANSFE,,2017-10-27,,200000.0,1119236.3499999987,.
409000493201',2017-10-27,FDRL/INTERNAL FUND TRANSFE,,2017-10-27,,300000.0,1419236.3499999987,.
409000493201',2017-10-27,FDRL/INTERNAL FUND TRANSFE,,2017-10-27,,300000.0,1719236.3499999987,.
409000493201',2017-10-30,BBPS SETMNT FOR DT 301020,,2017-10-30,322374.79,,1396861.5599999987,.
409000493201',2017-10-31,BBPS SETMNT FOR DT 311020,,2017-10-31,148633.99,,1248227.5699999987,.
409000493201',2017-11-01,BBPS SETMNT FOR DT 011120,,2017-11-01,131475.17,,1116752.3999999987,.
409000493201',2017-11-02,BBPS SETMNT FOR DT 021120,,2017-11-02,126718.38,,990034.0199999987,.
409000493201',2017-11-02,FDRL/INTERNAL FUND TRANSFE,,2017-11-02,,300000.0,1290034.0199999986,.
409000493201',2017-11-03,BBPS SETMNT FOR DT 031120,,2017-11-03,111962.51,,1178071.5099999986,.
409000493201',2017-11-03,FDRL/INTERNAL FUND TRANSFE,,2017-11-03,,300000.0,1478071.5099999986,.
409000493201',2017-11-04,BBPS SETMNT FOR DT 041120,,2017-11-04,110902.77,,1367168.7399999986,.
409000493201',2017-11-06,BBPS SETMNT FOR DT 061120,,2017-11-06,150019.78,,1217148.9599999986,.
409000493201',2017-11-07,BBPS SETMNT FOR DT 071120,,2017-11-07,147817.96,,1069330.9999999986,.
409000493201',2017-11-08,BBPS SETMNT FOR DT 081120,,2017-11-08,159473.08,,909857.9199999986,.
409000493201',2017-11-09,BBPS SETMNT FOR DT 091120,,2017-11-09,131508.96,,778348.9599999987,.
409000493201',2017-11-09,FDRL/INTERNAL FUND TRANSFE,,2017-11-09,,300000.0,1078348.9599999986,.
409000493201',2017-11-10,BBPS SETMNT FOR DT 101120,,2017-11-10,156605.52,,921743.4399999985,.
409000493201',2017-11-10,FDRL/INTERNAL FUND TRANSFE,,2017-11-10,,300000.0,1221743.4399999985,.
409000493201',2017-11-13,BBPS SETMNT FOR DT 131120,,2017-11-13,367421.58,,854321.8599999985,.
409000493201',2017-11-13,FDRL/INTERNAL FUND TRANSFE,,2017-11-13,,300000.0,1154321.8599999985,.
409000493201',2017-11-14,BBPS SETMNT FOR DT 141120,,2017-11-14,231316.89,,923004.9699999985,.
409000493201',2017-11-15,FDRL/INTERNAL FUND TRANSFE,,2017-11-15,,200000.0,1123004.9699999983,.
409000493201',2017-11-15,FDRL/INTERNAL FUND TRANSFE,,2017-11-15,,200000.0,1323004.9699999983,.
409000493201',2017-11-15,BBPS SETMNT FOR DT 151120,,2017-11-15,209879.95,,1113125.0199999984,.
409000493201',2017-11-16,BBPS SETMNT FOR DT 151120,,2017-11-16,134194.84,,978930.1799999984,.
409000493201',2017-11-17,BBPS SETMNT FOR DT 171120,,2017-11-17,92084.66,,886845.5199999984,.
409000493201',2017-11-17,FDRL/INTERNAL FUND TRANSFE,,2017-11-17,,200000.0,1086845.5199999984,.
409000493201',2017-11-17,FDRL/INTERNAL FUND TRANSFE,,2017-11-17,,200000.0,1286845.5199999984,.
409000493201',2017-11-18,BBPS SETMNT FOR DT 181120,,2017-11-18,196560.06,,1090285.4599999983,.
409000493201',2017-11-20,BBPS SETMNT FOR DT 201120,,2017-11-20,212645.91,,877639.5499999983,.
409000493201',2017-11-20,FDRL/INTERNAL FUND TRANSFE,,2017-11-20,,300000.0,1177639.5499999984,.
409000493201',2017-11-20,FDRL/INTERNAL FUND TRANSFE,,2017-11-20,,200000.0,1377639.5499999984,.
409000493201',2017-11-20,BBPS CERTIFICATE FEE,,2017-11-20,472000.0,,905639.5499999984,.
409000493201',2017-11-21,BBPS SETMNT FOR DT 211120,,2017-11-21,128651.14,,776988.4099999984,.
409000493201',2017-11-21,FDRL/INTERNAL FUND TRANSFE,,2017-11-21,,300000.0,1076988.4099999983,.
409000493201',2017-11-22,BBPS SETMNT FOR DT 221120,,2017-11-22,146827.17,,930161.2399999982,.
409000493201',2017-11-23,BBPS SETMNT FOR DT 231120,,2017-11-23,171906.2,,758255.0399999982,.
409000493201',2017-11-24,FDRL/INTERNAL FUND TRANSFE,,2017-11-24,,200000.0,958255.0399999982,.
409000493201',2017-11-24,FDRL/INTERNAL FUND TRANSFE,,2017-11-24,,200000.0,1158255.0399999982,.
409000493201',2017-11-24,BBPS SETMNT FOR DT 241120,,2017-11-24,75972.29,,1082282.7499999981,.
409000493201',2017-11-27,BBPS SETMNT FOR DT 271120,,2017-11-27,402695.51,,679587.2399999981,.
409000493201',2017-11-27,FDRL/INTERNAL FUND TRANSFE,,2017-11-27,,300000.0,979587.2399999981,.
409000493201',2017-11-28,BBPS SETMNT FOR DT 281120,,2017-11-28,256117.48,,723469.7599999981,.
409000493201',2017-11-28,FDRL/INTERNAL FUND TRANSFE,,2017-11-28,,300000.0,1023469.7599999981,.
409000493201',2017-11-29,BBPS SETMNT FOR DT 291120,,2017-11-29,112778.71,,910691.0499999982,.
409000493201',2017-11-30,BBPS SETMNT FOR DT 301120,,2017-11-30,82700.97,,827990.0799999982,.
409000493201',2017-12-01,BBPS SETMNT FOR DT 011220,,2017-12-01,97833.76,,730156.3199999982,.
409000493201',2017-12-02,BBPS SETMNT FOR DT 021220,,2017-12-02,100187.2,,629969.1199999982,.
409000493201',2017-12-02,FDRL/INTERNAL FUND TRANSFE,,2017-12-02,,200000.0,829969.1199999982,.
409000493201',2017-12-02,FDRL/INTERNAL FUND TRANSFE,,2017-12-02,,200000.0,1029969.1199999982,.
409000493201',2017-12-04,BBPS SETMNT FOR DT 041220,,2017-12-04,138532.32,,891436.7999999982,.
409000493201',2017-12-05,FDRL/INTERNAL FUND TRANSFE,,2017-12-05,,300000.0,1191436.7999999982,.
409000493201',2017-12-05,BBPS SETMNT FOR DT 051220,,2017-12-05,144026.13,,1047410.6699999982,.
409000493201',2017-12-05,FDRL/INTERNAL FUND TRANSFE,,2017-12-05,,300000.0,1347410.669999998,.
409000493201',2017-12-06,BBPS SETMNT FOR DT 061220,,2017-12-06,119401.28,,1228009.389999998,.
409000493201',2017-12-07,BBPS SETMNT FOR DT 071220,,2017-12-07,127675.25,,1100334.139999998,.
409000493201',2017-12-08,BBPS SETMNT FOR DT 081220,,2017-12-08,209118.73,,891215.409999998,.
409000493201',2017-12-08,FDRL/INTERNAL FUND TRANSFE,,2017-12-08,,200000.0,1091215.409999998,.
409000493201',2017-12-08,FDRL/INTERNAL FUND TRANSFE,,2017-12-08,,200000.0,1291215.409999998,.
409000493201',2017-12-11,BBPS SETMNT FOR DT 111220,,2017-12-11,472783.03,,818432.379999998,.
409000493201',2017-12-12,BBPS SETMNT FOR DT 121220,,2017-12-12,237356.27,,581076.109999998,.
409000493201',2017-12-12,FDRL/INTERNAL FUND TRANSFE,,2017-12-12,,300000.0,881076.109999998,.
409000493201',2017-12-13,BBPS SETMNT FOR DT 131220,,2017-12-13,186908.67,,694167.439999998,.
409000493201',2017-12-14,BBPS SETMNT FOR DT 141220,,2017-12-14,182323.36,,511844.079999998,.
409000493201',2017-12-14,FDRL/INTERNAL FUND TRANSFE,,2017-12-14,,200000.0,711844.079999998,.
409000493201',2017-12-14,FDRL/INTERNAL FUND TRANSFE,,2017-12-14,,200000.0,911844.079999998,.
409000493201',2017-12-15,BBPS SETMNT FOR DT 151220,,2017-12-15,184047.01,,727797.069999998,.
409000493201',2017-12-15,FDRL/INTERNAL FUND TRANSFE,,2017-12-15,,300000.0,1027797.069999998,.
409000493201',2017-12-15,FDRL/INTERNAL FUND TRANSFE,,2017-12-15,,200000.0,1227797.069999998,.
409000493201',2017-12-16,BBPS SETMNT FOR DT 161220,,2017-12-16,118422.18,,1109374.889999998,.
409000493201',2017-12-18,FDRL/INTERNAL FUND TRANSFE,,2017-12-18,,200000.0,1309374.889999998,.
409000493201',2017-12-18,FDRL/INTERNAL FUND TRANSFE,,2017-12-18,,200000.0,1509374.889999998,.
409000493201',2017-12-18,BBPS SETMNT FOR DT 181220,,2017-12-18,216222.65,,1293152.2399999981,.
409000493201',2017-12-19,BBPS SETMNT FOR DT 191220,,2017-12-19,250413.01,,1042739.2299999981,.
409000493201',2017-12-20,BBPS SETMNT FOR DT 201220,,2017-12-20,169273.67,,873465.5599999981,.
409000493201',2017-12-21,BBPS SETMNT FOR DT 211220,,2017-12-21,256321.71,,617143.8499999981,.
409000493201',2017-12-22,FDRL/INTERNAL FUND TRANSFE,,2017-12-22,,200000.0,817143.8499999981,.
409000493201',2017-12-22,FDRL/INTERNAL FUND TRANSFE,,2017-12-22,,300000.0,1117143.8499999982,.
409000493201',2017-12-22,BBPS SETMNT FOR DT 211220,,2017-12-22,183516.69,,933627.1599999983,.
409000493201',2017-12-26,FDRL/INTERNAL FUND TRANSFE,,2017-12-26,,300000.0,1233627.1599999983,.
409000493201',2017-12-26,FDRL/INTERNAL FUND TRANSFE,,2017-12-26,,300000.0,1533627.1599999983,.
409000493201',2017-12-26,BBPS SETMNT FOR DT 261220,,2017-12-26,487006.45,,1046620.7099999983,.
409000493201',2017-12-27,FDRL/INTERNAL FUND TRANSFE,,2017-12-27,,200000.0,1246620.7099999983,.
409000493201',2017-12-27,FDRL/INTERNAL FUND TRANSFE,,2017-12-27,,200000.0,1446620.7099999983,.
409000493201',2017-12-27,BBPS SETMNT FOR DT 271220,,2017-12-27,175551.7,,1271069.0099999984,.
409000493201',2017-12-28,BBPS SETMNT FOR DT 281201,,2017-12-28,171619.0,,1099450.0099999984,.
409000493201',2017-12-29,BBPS SETMNT FOR DT 291220,,2017-12-29,140789.63,,958660.3799999984,.
409000493201',2017-12-29,FDRL/INTERNAL FUND TRANSFE,,2017-12-29,,200000.0,1158660.3799999985,.
409000493201',2017-12-29,FDRL/INTERNAL FUND TRANSFE,,2017-12-29,,300000.0,1458660.3799999985,.
409000493201',2017-12-29,FDRL/INTERNAL FUND TRANSFE,,2017-12-29,,200000.0,1658660.3799999985,.
409000493201',2017-12-30,BBPS SETMNT FOR DT 301220,,2017-12-30,82142.95,,1576517.4299999985,.
409000493201',2018-01-01,BBPS SETMNT FOR DT 010120,,2018-01-01,199758.22,,1376759.2099999986,.
409000493201',2018-01-02,BBPS SETMNT FOR DT 020120,,2018-01-02,61493.58,,1315265.6299999985,.
409000493201',2018-01-02,FDRL/INTERNAL FUND TRANSFE,,2018-01-02,,200000.0,1515265.6299999985,.
409000493201',2018-01-02,FDRL/INTERNAL FUND TRANSFE,,2018-01-02,,200000.0,1715265.6299999985,.
409000493201',2018-01-03,BBPS SETMNT FOR DT 030120,,2018-01-03,131874.52,,1583391.1099999985,.
409000493201',2018-01-04,BBPS SETMNT FOR DT 040120,,2018-01-04,107971.83,,1475419.2799999984,.
409000493201',2018-01-05,BBPS SETMNT FOR DT 050120,,2018-01-05,119145.09,,1356274.1899999983,.
409000493201',2018-01-06,BBPS SETMNT FOR DT 060120,,2018-01-06,115908.12,,1240366.0699999984,.
409000493201',2018-01-08,BBPS SETMNT FOR DT 080120,,2018-01-08,174434.5,,1065931.5699999984,.
409000493201',2018-01-08,FDRL/INTERNAL FUND TRANSFE,,2018-01-08,,200000.0,1265931.5699999984,.
409000493201',2018-01-08,FDRL/INTERNAL FUND TRANSFE,,2018-01-08,,200000.0,1465931.5699999984,.
409000493201',2018-01-09,BBPS SETMNT FOR DT 090012,,2018-01-09,165694.99,,1300236.5799999984,.
409000493201',2018-01-10,BBPS SETMNT FOR DT 100120,,2018-01-10,187584.02,,1112652.5599999984,.
409000493201',2018-01-11,BBPS SETMNT FOR DT 110120,,2018-01-11,124081.29,,988571.2699999984,.
409000493201',2018-01-12,BBPS SETMNT FOR DT 120120,,2018-01-12,175473.28,,813097.9899999984,.
409000493201',2018-01-12,FDRL/INTERNAL FUND TRANSFE,,2018-01-12,,300000.0,1113097.9899999984,.
409000493201',2018-01-12,FDRL/INTERNAL FUND TRANSFE,,2018-01-12,,300000.0,1413097.9899999984,.
409000493201',2018-01-15,BBPS SETMNT FOR DT 150120,,2018-01-15,239083.95,,1174014.0399999984,.
409000493201',2018-01-16,BBPS SETMNT FOR DT 160120,,2018-01-16,199639.98,,974374.0599999984,.
409000493201',2018-01-17,BBPS SETMNT FOR DT 170120,,2018-01-17,184162.48,,790211.5799999984,.
409000493201',2018-01-17,FDRL/INTERNAL FUND TRANSFE,,2018-01-17,,300000.0,1090211.5799999984,.
409000493201',2018-01-18,BBPS SETMNT FOR DT 180120,,2018-01-18,164097.27,,926114.3099999984,.
409000493201',2018-01-19,BBPS SETMNT FOR DT 190120,,2018-01-19,160649.42,,765464.8899999984,.
409000493201',2018-01-19,FDRL/INTERNAL FUND TRANSFE,,2018-01-19,,200000.0,965464.8899999984,.
409000493201',2018-01-19,FDRL/INTERNAL FUND TRANSFE,,2018-01-19,,300000.0,1265464.8899999983,.
409000493201',2018-01-20,BBPS SETMNT FOR DT 200120,,2018-01-20,193939.03,,1071525.8599999982,.
409000493201',2018-01-22,BBPS SETMNT FOR DT 220120,,2018-01-22,153880.37,,917645.4899999982,.
409000493201',2018-01-23,BBPS SETMNT FOR DT 230120,,2018-01-23,104333.66,,813311.8299999982,.
409000493201',2018-01-23,FDRL/INTERNAL FUND TRANSFE,,2018-01-23,,300000.0,1113311.8299999982,.
409000493201',2018-01-24,BBPS SETMNT FOR DT 240120,,2018-01-24,137310.84,,976000.9899999982,.
409000493201',2018-01-25,BBPS SETMNT FOR DT 250120,,2018-01-25,108268.42,,867732.5699999982,.
409000493201',2018-01-25,FDRL/INTERNAL FUND TRANSFE,,2018-01-25,,300000.0,1167732.5699999982,.
409000493201',2018-01-25,FDRL/INTERNAL FUND TRANSFE,,2018-01-25,,300000.0,1467732.5699999982,.
409000493201',2018-01-29,BBPS SETMNT FOR DT 290120,,2018-01-29,252550.92,,1215181.6499999983,.
409000493201',2018-01-30,BBPS SETMNT FOR DT 300120,,2018-01-30,117287.45,,1097894.1999999983,.
409000493201',2018-01-31,BBPS SETMNT FOR DT 310120,,2018-01-31,82482.93,,1015411.2699999984,.
409000493201',2018-02-01,BBPS SETMNT FOR DT 010220,,2018-02-01,78571.0,,936840.2699999984,.
409000493201',2018-02-02,BBPS SETMNT FOR DT 020220,,2018-02-02,87199.44,,849640.8299999984,.
409000493201',2018-02-02,FDRL/INTERNAL FUND TRANSFE,,2018-02-02,,200000.0,1049640.8299999984,.
409000493201',2018-02-02,FDRL/INTERNAL FUND TRANSFE,,2018-02-02,,300000.0,1349640.8299999984,.
409000493201',2018-02-03,BBPS SETMNT FOR DT 030220,,2018-02-03,38505.91,,1311134.9199999985,.
409000493201',2018-02-05,BBPS SETMNT FOR DT 050220,,2018-02-05,70066.41,,1241068.5099999986,.
409000493201',2018-02-06,BBPS DT 06022018,,2018-02-06,87969.6,,1153098.9099999985,.
409000493201',2018-02-07,BBPS DT 07022018,,2018-02-07,91827.28,,1061271.6299999985,.
409000493201',2018-02-08,BBPS DT 08022018,,2018-02-08,55919.43,,1005352.1999999984,.
409000493201',2018-02-09,BBPS DT 09022018,,2018-02-09,153450.94,,851901.2599999984,.
409000493201',2018-02-09,FDRL/INTERNAL FUND TRANSFE,,2018-02-09,,200000.0,1051901.2599999984,.
409000493201',2018-02-09,FDRL/INTERNAL FUND TRANSFE,,2018-02-09,,300000.0,1351901.2599999984,.
409000493201',2018-02-12,BBPS DT 12022018,,2018-02-12,171840.28,,1180060.9799999984,.
409000493201',2018-02-13,BBPS DT 13022018,,2018-02-13,37837.59,,1142223.3899999983,.
409000493201',2018-02-14,BBPS DT 14022018,,2018-02-14,29484.1,,1112739.2899999982,.
409000493201',2018-02-15,BBPS DT 15022018,,2018-02-15,61110.96,,1051628.3299999982,.
409000493201',2018-02-16,BBPS DT 16022018,,2018-02-16,102212.77,,949415.5599999982,.
409000493201',2018-02-16,FDRL/INTERNAL FUND TRANSFE,,2018-02-16,,300000.0,1249415.5599999982,.
409000493201',2018-02-17,BBPS DT 17022018,,2018-02-17,107049.16,,1142366.3999999983,.
409000493201',2018-02-19,BBPS DT 19022018,,2018-02-19,88031.13,,1054335.2699999982,.
409000493201',2018-02-20,BBPS DT 20022018,,2018-02-20,80144.06,,974191.2099999981,.
409000493201',2018-02-21,BBPS DT 21022018,,2018-02-21,134293.53,,839897.6799999981,.
409000493201',2018-02-22,BBPS DT 22022018,,2018-02-22,100015.35,,739882.3299999981,.
409000493201',2018-02-22,FDRL/INTERNAL FUND TRANSFE,,2018-02-22,,300000.0,1039882.3299999981,.
409000493201',2018-02-22,FDRL/INTERNAL FUND TRANSFE,,2018-02-22,,200000.0,1239882.3299999982,.
409000493201',2018-02-23,BBPS DT 23022018,,2018-02-23,110202.4,,1129679.9299999983,.
409000493201',2018-02-26,BBPS DT 26022018,,2018-02-26,94909.73,,1034770.1999999983,.
409000493201',2018-02-27,BBPS DT 27022018,,2018-02-27,83883.09,,950887.1099999984,.
409000493201',2018-02-28,BBPS DT 28022018,,2018-02-28,53685.02,,897202.0899999983,.
409000493201',2018-03-01,BBPS DT 01032018,,2018-03-01,92260.68,,804941.4099999983,.
409000493201',2018-03-01,FDRL/INTERNAL FUND TRANSFE,,2018-03-01,,300000.0,1104941.4099999983,.
409000493201',2018-03-01,FDRL/INTERNAL FUND TRANSFE,,2018-03-01,,200000.0,1304941.4099999983,.
409000493201',2018-03-02,BBPS DT 02032018,,2018-03-02,22018.4,,1282923.0099999984,.
409000493201',2018-03-03,BBPS DT 03032018,,2018-03-03,,35851.19,1318774.1999999983,.
409000493201',2018-03-05,BBPS DT 05032018,,2018-03-05,77952.12,,1240822.0799999982,.
409000493201',2018-03-06,BBPS DT 06032018,,2018-03-06,78194.25,,1162627.8299999982,.
409000493201',2018-03-07,BBPS SETTELET DTD 07.03.2,,2018-03-07,133276.73,,1029351.0999999982,.
409000493201',2018-03-08,BBPS DT 08032018,,2018-03-08,208169.53,,821181.5699999982,.
409000493201',2018-03-09,BBPS DT 09032018,,2018-03-09,205372.21,,615809.3599999982,.
409000493201',2018-03-09,FDRL/INTERNAL FUND TRANSFE,,2018-03-09,,200000.0,815809.3599999982,.
409000493201',2018-03-09,FDRL/INTERNAL FUND TRANSFE,,2018-03-09,,200000.0,1015809.3599999982,.
409000493201',2018-03-12,FDRL/INTERNAL FUND TRANSFE,,2018-03-12,,200000.0,1215809.3599999982,.
409000493201',2018-03-12,BBPS DT 12032018,,2018-03-12,587655.98,,628153.3799999983,.
409000493201',2018-03-12,FDRL/INTERNAL FUND TRANSFE,,2018-03-12,,200000.0,828153.3799999983,.
409000493201',2018-03-12,FDRL/INTERNAL FUND TRANSFE,,2018-03-12,,300000.0,1128153.3799999983,.
409000493201',2018-03-13,BBPS DT 13032018,,2018-03-13,232615.36,,895538.0199999983,.
409000493201',2018-03-14,BBPS DT 14032018,,2018-03-14,169248.39,,726289.6299999983,.
409000493201',2018-03-14,FDRL/INTERNAL FUND TRANSFE,,2018-03-14,,300000.0,1026289.6299999983,.
409000493201',2018-03-15,BBPS DT 15032018,,2018-03-15,181965.87,,844323.7599999983,.
409000493201',2018-03-16,BBPS DT 16032018,,2018-03-16,64069.0,,780254.7599999983,.
409000493201',2018-03-16,FDRL/INTERNAL FUND TRANSFE,,2018-03-16,,200000.0,980254.7599999983,.
409000493201',2018-03-16,FDRL/INTERNAL FUND TRANSFE,,2018-03-16,,300000.0,1280254.7599999984,.
409000493201',2018-03-17,BBPS DT 17032018,,2018-03-17,121924.84,,1158329.9199999983,.
409000493201',2018-03-19,BBPS DT 19032018,,2018-03-19,43998.98,,1114330.9399999983,.
409000493201',2018-03-20,BBPS DT 20032018,,2018-03-20,226245.3,,888085.6399999983,.
409000493201',2018-03-20,FDRL/INTERNAL FUND TRANSFE,,2018-03-20,,200000.0,1088085.6399999983,.
409000493201',2018-03-21,BBPS DT 21032018,,2018-03-21,174291.75,,913793.8899999983,.
409000493201',2018-03-21,BBPS  DT 12022018,,2018-03-21,50650.62,,863143.2699999983,.
409000493201',2018-03-21,REV BBPS  DT 12022018,,2018-03-21,,171840.28,1034983.5499999983,.
409000493201',2018-03-22,BBPS DT 22032018,,2018-03-22,99571.0,,935412.5499999983,.
409000493201',2018-03-23,BBPS DT 23032018,,2018-03-23,68100.91,,867311.6399999983,.
409000493201',2018-03-23,FDRL/INTERNAL FUND TRANSFE,,2018-03-23,,200000.0,1067311.6399999983,.
409000493201',2018-03-26,BBPS DT 26032018,,2018-03-26,138542.03,,928769.6099999982,.
409000493201',2018-03-27,BBPS DT 27032018,,2018-03-27,117114.79,,811654.8199999982,.
409000493201',2018-03-27,FDRL/INTERNAL FUND TRANSFE,,2018-03-27,,200000.0,1011654.8199999982,.
409000493201',2018-03-28,BBPS DT 28032018,,2018-03-28,168011.64,,843643.1799999982,.
409000493201',2018-03-29,BBPS DT 29032018,,2018-03-29,117919.02,,725724.1599999982,.
409000493201',2018-03-29,FDRL/INTERNAL FUND TRANSFE,,2018-03-29,,300000.0,1025724.1599999982,.
409000493201',2018-03-29,FDRL/INTERNAL FUND TRANSFE,,2018-03-29,,200000.0,1225724.1599999983,.
409000493201',2018-03-31,FDRL/INTERNAL FUND TRANSFE,,2018-03-31,,200000.0,1425724.1599999983,.
409000493201',2018-03-31,BBPS DT 31032018,,2018-03-31,213036.21,,1212687.9499999983,.
409000493201',2018-04-03,BBPS DT 03042018,,2018-04-03,62142.89,,1150545.0599999984,.
409000493201',2018-04-03,BBPS DT 02042018,,2018-04-03,54010.29,,1096534.7699999984,.
409000493201',2018-04-04,BBPS DT 04042018,,2018-04-04,40282.34,,1056252.4299999983,.
409000493201',2018-04-05,BBPS DT 05042018,,2018-04-05,118388.47,,937863.9599999983,.
409000493201',2018-04-05,FDRL/INTERNAL FUND TRANSFE,,2018-04-05,,200000.0,1137863.9599999983,.
409000493201',2018-04-06,BBPS DT 06042018,,2018-04-06,123743.72,,1014120.2399999984,.
409000493201',2018-04-07,BBPS DT 07042018,,2018-04-07,197932.71,,816187.5299999984,.
409000493201',2018-04-09,BBPS DT 09042018,,2018-04-09,235573.75,,580613.7799999984,.
409000493201',2018-04-09,FDRL/INTERNAL FUND TRANSFE,,2018-04-09,,300000.0,880613.7799999984,.
409000493201',2018-04-09,FDRL/INTERNAL FUND TRANSFE,,2018-04-09,,300000.0,1180613.7799999984,.
409000493201',2018-04-10,BBPS DT 10042018,,2018-04-10,247145.7,,933468.0799999984,.
409000493201',2018-04-11,BBPS DT 11042018,,2018-04-11,161435.3,,772032.7799999984,.
409000493201',2018-04-11,FDRL/INTERNAL FUND TRANSFE,,2018-04-11,,300000.0,1072032.7799999984,.
409000493201',2018-04-12,BBPS DT 12042018,,2018-04-12,199217.29,,872815.4899999984,.
409000493201',2018-04-12,FDRL/INTERNAL FUND TRANSFE,,2018-04-12,,300000.0,1172815.4899999984,.
409000493201',2018-04-13,BBPS DT 13042018,,2018-04-13,191239.47,,981576.0199999984,.
409000493201',2018-04-13,FDRL/INTERNAL FUND TRANSFE,,2018-04-13,,200000.0,1181576.0199999984,.
409000493201',2018-04-13,FDRL/INTERNAL FUND TRANSFE,,2018-04-13,,200000.0,1381576.0199999984,.
409000493201',2018-04-16,BBPS DT 16042018,,2018-04-16,76266.87,,1305309.1499999985,.
409000493201',2018-04-16,BBPS DT 15042018,,2018-04-16,133355.43,,1171953.7199999986,.
409000493201',2018-04-16,BBPS DT 14042018,,2018-04-16,100657.31,,1071296.4099999985,.
409000493201',2018-04-17,BBPS SETTELET DTD 17.04.2,,2018-04-17,237804.3,,833492.1099999985,.
409000493201',2018-04-17,FDRL/INTERNAL FUND TRANSFE,,2018-04-17,,200000.0,1033492.1099999985,.
409000493201',2018-04-18,BBPS DT 18042018,,2018-04-18,307704.52,,725787.5899999985,.
409000493201',2018-04-18,FDRL/INTERNAL FUND TRANSFE,,2018-04-18,,200000.0,925787.5899999985,.
409000493201',2018-04-18,FDRL/INTERNAL FUND TRANSFE,,2018-04-18,,300000.0,1225787.5899999985,.
409000493201',2018-04-19,BBPS DT 19042018,,2018-04-19,242028.32,,983759.2699999984,.
409000493201',2018-04-20,BBPS DT 20042018,,2018-04-20,240151.47,,743607.7999999984,.
409000493201',2018-04-21,BBPS DT 21042018,,2018-04-21,153156.83,,590450.9699999985,.
409000493201',2018-04-21,FDRL/INTERNAL FUND TRANSFE,,2018-04-21,,300000.0,890450.9699999985,.
409000493201',2018-04-21,FDRL/INTERNAL FUND TRANSFE,,2018-04-21,,300000.0,1190450.9699999983,.
409000493201',2018-04-23,BBPS DT 22042018,,2018-04-23,142263.54,,1048187.4299999983,.
409000493201',2018-04-23,BBPS DT 23042018,,2018-04-23,106937.58,,941249.8499999983,.
409000493201',2018-04-24,BBPS DT 24042018,,2018-04-24,212480.4,,728769.4499999983,.
409000493201',2018-04-24,FDRL/INTERNAL FUND TRANSFE,,2018-04-24,,300000.0,1028769.4499999983,.
409000493201',2018-04-24,FDRL/INTERNAL FUND TRANSFE,,2018-04-24,,200000.0,1228769.4499999983,.
409000493201',2018-04-24,FDRL/INTERNAL FUND TRANSFE,,2018-04-24,,200000.0,1428769.4499999983,.
409000493201',2018-04-25,BBPS DT 25042018,,2018-04-25,188141.79,,1240627.6599999983,.
409000493201',2018-04-26,BBPS DT 26042018,,2018-04-26,123185.81,,1117441.8499999982,.
409000493201',2018-04-27,BBPS DT 27042018,,2018-04-27,164119.79,,953322.0599999982,.
409000493201',2018-04-27,FDRL/INTERNAL FUND TRANSFE,,2018-04-27,,300000.0,1253322.0599999982,.
409000493201',2018-04-27,FDRL/INTERNAL FUND TRANSFE,,2018-04-27,,300000.0,1553322.0599999982,.
409000493201',2018-04-27,Indiaforensic BBPS GURANATEE FEE,,2018-04-27,500000.0,,1053322.0599999982,.
409000493201',2018-04-30,BBPS DT 28042018,,2018-04-30,160888.2,,892433.8599999982,.
409000493201',2018-04-30,BBPS DT 29042018,,2018-04-30,157810.46,,734623.3999999983,.
409000493201',2018-04-30,BBPS DT 30042018,,2018-04-30,57084.32,,677539.0799999983,.
409000493201',2018-04-30,FDRL/INTERNAL FUND TRANSFE,,2018-04-30,,200000.0,877539.0799999983,.
409000493201',2018-05-01,BBPS DT 01052018,,2018-05-01,154816.5,,722722.5799999983,.
409000493201',2018-05-01,FDRL/INTERNAL FUND TRANSFE,,2018-05-01,,200000.0,922722.5799999983,.
409000493201',2018-05-01,FDRL/INTERNAL FUND TRANSFE,,2018-05-01,,200000.0,1122722.5799999982,.
409000493201',2018-05-02,BBPS DT 02052018,,2018-05-02,183929.92,,938792.6599999982,.
409000493201',2018-05-03,BBPS DT 03052018,,2018-05-03,187650.1,,751142.5599999982,.
409000493201',2018-05-03,FDRL/INTERNAL FUND TRANSFE,,2018-05-03,,300000.0,1051142.5599999982,.
409000493201',2018-05-04,BBPS DT 04052018,,2018-05-04,139069.5,,912073.0599999982,.
409000493201',2018-05-04,FDRL/INTERNAL FUND TRANSFE,,2018-05-04,,200000.0,1112073.0599999982,.
409000493201',2018-05-04,FDRL/INTERNAL FUND TRANSFE,,2018-05-04,,300000.0,1412073.0599999982,.
409000493201',2018-05-05,BBPS DT 05052018,,2018-05-05,107985.24,,1304087.8199999982,.
409000493201',2018-05-07,BBPS DT 06052018,,2018-05-07,190194.7,,1113893.1199999982,.
409000493201',2018-05-07,BBPS DT 07052018,,2018-05-07,68538.04,,1045355.0799999982,.
409000493201',2018-05-08,BBPS DT 08052018,,2018-05-08,242380.79,,802974.2899999982,.
409000493201',2018-05-08,FDRL/INTERNAL FUND TRANSFE,,2018-05-08,,300000.0,1102974.2899999982,.
409000493201',2018-05-09,BBPS DT 09052018,,2018-05-09,129549.64,,973424.6499999982,.
409000493201',2018-05-09,FDRL/INTERNAL FUND TRANSFE,,2018-05-09,,300000.0,1273424.649999998,.
409000493201',2018-05-10,BBPS DT 10052018,,2018-05-10,82525.95,,1190898.699999998,.
409000493201',2018-05-11,BBPS DT 11052018,,2018-05-11,77162.26,,1113736.439999998,.
409000493201',2018-05-14,FDRL/INTERNAL FUND TRANSFE,,2018-05-14,,300000.0,1413736.439999998,.
409000493201',2018-05-14,BBPS DT 12052018,,2018-05-14,11483.23,,1402253.209999998,.
409000493201',2018-05-14,BBPS DT 13052018,,2018-05-14,,22479.51,1424732.719999998,.
409000493201',2018-05-14,BBPS DT 14052018,,2018-05-14,,109368.29,1534101.0099999981,.
409000493201',2018-05-15,BBPS DT 15052018,,2018-05-15,141740.47,,1392360.5399999982,.
409000493201',2018-05-16,BBPS DT 16052018,,2018-05-16,7367.22,,1384993.3199999982,.
409000493201',2018-05-17,BBPS DT 17052018,,2018-05-17,,13011.68,1398004.9999999981,.
409000493201',2018-05-19,BBPS DT 19052018,,2018-05-19,,20256.89,1418261.889999998,.
409000493201',2018-05-19,BBPS DT 18052018,,2018-05-19,39858.43,,1378403.459999998,.
409000493201',2018-05-21,BBPS DT 20052018,,2018-05-21,,17961.93,1396365.389999998,.
409000493201',2018-05-21,BBPS DT 21052018,,2018-05-21,,41666.35,1438031.7399999981,.
409000493201',2018-05-22,BBPS DT 22052018,,2018-05-22,90671.52,,1347360.219999998,.
409000493201',2018-05-23,BBPS DT 23052018,,2018-05-23,153131.62,,1194228.5999999982,.
409000493201',2018-05-24,BBPS DT 25052018,,2018-05-24,84937.59,,1109291.0099999981,.
409000493201',2018-05-25,BBPS DT 25052018,,2018-05-25,127374.04,,981916.9699999981,.
409000493201',2018-05-28,BBPS DT 26052018,,2018-05-28,131055.59,,850861.3799999981,.
409000493201',2018-05-28,BBPS DT 27052018,,2018-05-28,51500.8,,799360.5799999981,.
409000493201',2018-05-28,BBPS DT 28052018,,2018-05-28,,53022.28,852382.8599999981,.
409000493201',2018-05-28,FDRL/INTERNAL FUND TRANSFE,,2018-05-28,,300000.0,1152382.859999998,.
409000493201',2018-05-29,BBPS DT 26052018,,2018-05-29,142369.35,,1010013.509999998,.
409000493201',2018-05-30,BBPS DT 30052018,,2018-05-30,110513.7,,899499.8099999981,.
409000493201',2018-05-30,FDRL/INTERNAL FUND TRANSFE,,2018-05-30,,300000.0,1199499.8099999982,.
409000493201',2018-05-31,BBPS DT 31052018,,2018-05-31,115854.87,,1083644.939999998,.
409000493201',2018-06-01,BBPS DT 01062018,,2018-06-01,34285.36,,1049359.579999998,.
409000493201',2018-06-02,BBPS DT 02062018,,2018-06-02,65093.04,,984266.5399999979,.
409000493201',2018-06-04,BBPS DT 03062018,,2018-06-04,38019.06,,946247.4799999979,.
409000493201',2018-06-04,BBPS DT 04062018,,2018-06-04,,14181.98,960429.4599999979,.
409000493201',2018-06-05,BBPS DT 05062018,,2018-06-05,78982.56,,881446.8999999978,.
409000493201',2018-06-06,BBPS DT 06062018,,2018-06-06,64415.11,,817031.7899999978,.
409000493201',2018-06-07,BBPS DT 07062018,,2018-06-07,97510.32,,719521.4699999979,.
409000493201',2018-06-08,BBPS DT 08062018,,2018-06-08,25366.64,,694154.8299999979,.
409000493201',2018-06-11,FDRL/INTERNAL FUND TRANSFE,,2018-06-11,,300000.0,994154.8299999979,.
409000493201',2018-06-11,FDRL/INTERNAL FUND TRANSFE,,2018-06-11,,300000.0,1294154.8299999977,.
409000493201',2018-06-11,BBPS DT 09062018,,2018-06-11,27920.62,,1266234.2099999976,.
409000493201',2018-06-11,BBPS DT 10062018,,2018-06-11,8112.82,,1258121.3899999976,.
409000493201',2018-06-11,BBPS DT 11062018,,2018-06-11,,82132.09,1340253.4799999977,.
409000493201',2018-06-12,BBPS DT 12062018,,2018-06-12,29859.18,,1310394.2999999977,.
409000493201',2018-06-13,BBPS DT 13062018,,2018-06-13,16905.35,,1293488.9499999976,.
409000493201',2018-06-14,BBPS DT 14062018,,2018-06-14,39815.49,,1253673.4599999976,.
409000493201',2018-06-15,BBPS DT 15062018,,2018-06-15,30196.44,,1223477.0199999977,.
409000493201',2018-06-18,BBPS DT 16062018,,2018-06-18,12958.25,,1210518.7699999977,.
409000493201',2018-06-18,BBPS DT 17062018,,2018-06-18,,43963.21,1254481.9799999977,.
409000493201',2018-06-18,BBPS DT 18062018,,2018-06-18,,53656.53,1308138.5099999977,.
409000493201',2018-06-19,BBPS DT 19062018,,2018-06-19,180907.04,,1127231.4699999976,.
409000493201',2018-06-20,BBPS DT 20062018,,2018-06-20,146123.98,,981107.4899999977,.
409000493201',2018-06-21,BBPS DT 21062018,,2018-06-21,71360.1,,909747.3899999977,.
409000493201',2018-06-22,BBPS DT 22062018,,2018-06-22,34623.77,,875123.6199999977,.
409000493201',2018-06-22,FDRL/INTERNAL FUND TRANSFE,,2018-06-22,,200000.0,1075123.6199999978,.
409000493201',2018-06-25,BBPS DT 23062018,,2018-06-25,24246.1,,1050877.5199999977,.
409000493201',2018-06-25,BBPS DT 24062018,,2018-06-25,26719.16,,1024158.3599999977,.
409000493201',2018-06-25,BBPS DT 25062018,,2018-06-25,,55573.29,1079731.6499999976,.
409000493201',2018-06-26,BBPS DT 26062018,,2018-06-26,48110.56,,1031621.0899999975,.
409000493201',2018-06-27,BBPS DT 27062018,,2018-06-27,63907.21,,967713.8799999976,.
409000493201',2018-06-28,BBPS DT 28062018,,2018-06-28,23085.44,,944628.4399999976,.
409000493201',2018-06-28,FDRL/INTERNAL FUND TRANSFE,,2018-06-28,,200000.0,1144628.4399999976,.
409000493201',2018-06-29,BBPS DT 29062018,,2018-06-29,3341.29,,1141287.1499999976,.
409000493201',2018-06-30,BBPS DT 30062018,,2018-06-30,12252.0,,1129035.1499999976,.
409000493201',2018-07-02,BBPS DT 01072018,,2018-07-02,22571.88,,1106463.2699999977,.
409000493201',2018-07-02,BBPS DT 02072018,,2018-07-02,,55900.4,1162363.6699999976,.
409000493201',2018-07-03,BBPS DT 03072018,,2018-07-03,,44892.38,1207256.0499999975,.
409000493201',2018-07-04,BBPS DT 04072018,,2018-07-04,6904.87,,1200351.1799999974,.
409000493201',2018-07-05,BBPS DT 05072018,,2018-07-05,,17198.35,1217549.5299999975,.
409000493201',2018-07-06,BBPS DT 06072018,,2018-07-06,29872.95,,1187676.5799999975,.
409000493201',2018-07-07,BBPS DT 07072018,,2018-07-07,,12990.47,1200667.0499999975,.
409000493201',2018-07-09,BBPS DT 09072018,,2018-07-09,,67657.57,1268324.6199999976,.
409000493201',2018-07-09,BBPS DT 08072018,,2018-07-09,29077.09,,1239247.5299999975,.
409000493201',2018-07-10,BBPS DT 10072018,,2018-07-10,90684.03,,1148563.4999999974,.
409000493201',2018-07-11,BBPS DT 11072018,,2018-07-11,66435.79,,1082127.7099999974,.
409000493201',2018-07-12,BBPS DT 12072018,,2018-07-12,121795.12,,960332.5899999974,.
409000493201',2018-07-13,BBPS DT 13072018,,2018-07-13,41636.56,,918696.0299999975,.
409000493201',2018-07-13,FDRL/INTERNAL FUND TRANSFE,,2018-07-13,,300000.0,1218696.0299999975,.
409000493201',2018-07-16,BBPS DT 14072018,,2018-07-16,53279.64,,1165416.3899999976,.
409000493201',2018-07-16,BBPS DT 15072018,,2018-07-16,,3521.67,1168938.0599999975,.
409000493201',2018-07-16,BBPS DT 16072018,,2018-07-16,,100682.1,1269620.1599999976,.
409000493201',2018-07-17,BBPS DT 17072018,,2018-07-17,100369.8,,1169250.3599999975,.
409000493201',2018-07-18,BBPS DT 18072018,,2018-07-18,76026.55,,1093223.8099999975,.
409000493201',2018-07-19,BBPS DT 19072018,,2018-07-19,30494.01,,1062729.7999999975,.
409000493201',2018-07-20,BBPS DT 20072018,,2018-07-20,90799.39,,971930.4099999975,.
409000493201',2018-07-21,BBPS DT 21072018,,2018-07-21,,21731.12,993661.5299999975,.
409000493201',2018-07-23,BBPS DT 22072018,,2018-07-23,,33830.77,1027492.2999999975,.
409000493201',2018-07-23,BBPS DT 23072018,,2018-07-23,,3260.67,1030752.9699999975,.
409000493201',2018-07-23,BBPS DT 23072018,,2018-07-23,,49973.88,1080726.8499999975,.
409000493201',2018-07-24,BBPS DT 24072018,,2018-07-24,,17711.45,1098438.2999999975,.
409000493201',2018-07-25,BBPS DT 25072018,,2018-07-25,97234.02,,1001204.2799999975,.
409000493201',2018-07-26,BBPS DT 26072018,,2018-07-26,22302.35,,978901.9299999975,.
409000493201',2018-07-27,BBPS DT 27072018,,2018-07-27,,10227.38,989129.3099999975,.
409000493201',2018-07-30,BBPS DT 28072018,,2018-07-30,,33190.68,1022319.9899999975,.
409000493201',2018-07-30,BBPS DT 29072018,,2018-07-30,4625.14,,1017694.8499999975,.
409000493201',2018-07-30,BBPS DT 30072018,,2018-07-30,,71337.37,1089032.2199999974,.
409000493201',2018-07-31,BBPS DT 31072018,,2018-07-31,29089.53,,1059942.6899999974,.
409000493201',2018-08-01,BBPS DT 01082018,,2018-08-01,30347.75,,1029594.9399999974,.
409000493201',2018-08-02,BBPS DT 02082018,,2018-08-02,,20224.88,1049819.8199999973,.
409000493201',2018-08-03,BBPS DT 03082018,,2018-08-03,4795.33,,1045024.4899999973,.
409000493201',2018-08-04,BBPS DT 04082018,,2018-08-04,14728.37,,1030296.1199999973,.
409000493201',2018-08-06,BBPS DT 05082018,,2018-08-06,,62024.88,1092320.9999999972,.
409000493201',2018-08-06,BBPS DT 06082018,,2018-08-06,,66966.06,1159287.0599999973,.
409000493201',2018-08-07,BBPS DT 07082018,,2018-08-07,35934.87,,1123352.1899999972,.
409000493201',2018-08-08,BBPS DT 08082018,,2018-08-08,10667.64,,1112684.5499999973,.
409000493201',2018-08-09,BBPS DT 09082018,,2018-08-09,,5322.89,1118007.4399999972,.
409000493201',2018-08-10,BBPS DT 10082018,,2018-08-10,,10564.32,1128571.7599999972,.
409000493201',2018-08-13,BBPS DT 11082018,,2018-08-13,,53362.07,1181933.8299999973,.
409000493201',2018-08-13,BBPS DT 12082018,,2018-08-13,,151788.62,1333722.4499999974,.
409000493201',2018-08-13,BBPS DT 13082018,,2018-08-13,,7164.58,1340887.0299999975,.
409000493201',2018-08-14,BBPS DT 14082018,,2018-08-14,,6597.22,1347484.2499999974,.
409000493201',2018-08-16,BBPS DT 15082018,,2018-08-16,,30456.56,1377940.8099999975,.
409000493201',2018-08-16,BBPS DT 16082018,,2018-08-16,,156813.87,1534754.6799999974,.
409000493201',2018-08-17,BBPS DT 17082018,,2018-08-17,,94982.32,1629736.9999999974,.
409000493201',2018-08-18,BBPS DT 18082018,,2018-08-18,,77676.77,1707413.7699999975,.
409000493201',2018-08-20,BBPS DT 19082018,,2018-08-20,,54826.71,1762240.4799999974,.
409000493201',2018-08-20,BBPS DT 20082018,,2018-08-20,,176705.41,1938945.8899999973,.
409000493201',2018-08-21,BBPS DT 21082018,,2018-08-21,,39601.83,1978547.7199999974,.
409000493201',2018-08-23,BBPS DT 22082018,,2018-08-23,,137436.94,2115984.6599999974,.
409000493201',2018-08-23,BBPS DT 23082018,,2018-08-23,,114273.52,2230258.1799999974,.
409000493201',2018-08-23,TRF TO  Indiaforensic SERVICES I,,2018-08-23,1000000.0,,1230258.1799999974,.
409000493201',2018-08-24,BBPS DT 24082018,,2018-08-24,,65456.4,1295714.5799999973,.
409000493201',2018-08-27,BBPS DT 25082018,,2018-08-27,,89601.49,1385316.0699999973,.
409000493201',2018-08-27,BBPS DT 26082018,,2018-08-27,,113986.27,1499302.3399999973,.
409000493201',2018-08-27,BBPS DT 27082018,,2018-08-27,,137139.75,1636442.0899999973,.
409000493201',2018-08-28,BBPS DT 28082018,,2018-08-28,,58964.84,1695406.9299999974,.
409000493201',2018-08-29,BBPS DT 29082018,,2018-08-29,,71493.16,1766900.0899999973,.
409000493201',2018-08-30,BBPS DT 30082018,,2018-08-30,64428.81,,1702471.2799999972,.
409000493201',2018-08-31,BBPS DT 31082018,,2018-08-31,,8238.05,1710709.3299999973,.
409000493201',2018-09-01,BBPS DT 01092018,,2018-09-01,,93996.73,1804706.0599999973,.
409000493201',2018-09-03,BBPS DT 02092018,,2018-09-03,,159127.05,1963833.1099999973,.
409000493201',2018-09-03,BBPS DT 03092018,,2018-09-03,,233904.54,2197737.649999997,.
409000493201',2018-09-03,TRF TO  Indiaforensic SERVICES I,,2018-09-03,1000000.0,,1197737.649999997,.
409000493201',2018-09-04,BBPS DT 04092018,,2018-09-04,,148802.0,1346539.649999997,.
409000493201',2018-09-05,BBPS DT 05092018,,2018-09-05,,79407.4,1425947.049999997,.
409000493201',2018-09-06,BBPS DT 06092018,,2018-09-06,,102541.01,1528488.059999997,.
409000493201',2018-09-07,BBPS DT 07092018,,2018-09-07,,121975.46,1650463.519999997,.
409000493201',2018-09-07,TRF TO  Indiaforensic SERVICES I,,2018-09-07,1000000.0,,650463.519999997,.
409000493201',2018-09-10,BBPS DT 08092018,,2018-09-10,,68254.49,718718.009999997,.
409000493201',2018-09-10,BBPS DT 09092018,,2018-09-10,,179898.57,898616.579999997,.
409000493201',2018-09-10,BBPS DT 10092018,,2018-09-10,,102201.02,1000817.5999999971,.
409000493201',2018-09-11,BBPS DT 11092018,,2018-09-11,62249.74,,938567.8599999971,.
409000493201',2018-09-12,BBPS DT 12092018,,2018-09-12,,80279.07,1018846.9299999971,.
409000493201',2018-09-13,BBPS DT 13092018,,2018-09-13,,60012.23,1078859.1599999971,.
409000493201',2018-09-14,BBPS DT 14092018,,2018-09-14,,125122.85,1203982.0099999972,.
409000493201',2018-09-15,BBPS DT 15092018,,2018-09-15,,120905.14,1324887.149999997,.
409000493201',2018-09-17,BBPS DT 17092018,,2018-09-17,938.84,,1323948.309999997,.
409000493201',2018-09-17,BBPS DT 16092018,,2018-09-17,,113977.87,1437926.179999997,.
409000493201',2018-09-17,TRF TO  Indiaforensic SERVICES I,,2018-09-17,900000.0,,537926.1799999969,.
409000493201',2018-09-18,BBPS DT 18092018,,2018-09-18,6542.73,,531383.4499999969,.
409000493201',2018-09-19,BBPS DT 19092018,,2018-09-19,,156502.39,687885.8399999969,.
409000493201',2018-09-20,BBPS DT 20092018,,2018-09-20,,161689.32,849575.1599999969,.
409000493201',2018-09-21,BBPS DT 21092018,,2018-09-21,,192331.28,1041906.4399999969,.
409000493201',2018-09-24,BBPS DT 23092018,,2018-09-24,100527.62,,941378.8199999969,.
409000493201',2018-09-24,BBPS DT 22092018,,2018-09-24,,13361.85,954740.6699999969,.
409000493201',2018-09-24,BBPS DT 24092018,,2018-09-24,63048.84,,891691.8299999969,.
409000493201',2018-09-25,BBPS DT 25092018,,2018-09-25,202530.64,,689161.1899999969,.
409000493201',2018-09-26,BBPS DT 26092018,,2018-09-26,,49876.46,739037.6499999969,.
409000493201',2018-09-27,BBPS DT 27092018,,2018-09-27,,67155.84,806193.4899999968,.
409000493201',2018-09-28,BBPS  DT 28092018,,2018-09-28,,277871.07,1084064.5599999968,.
409000493201',2018-09-28,TRF TO  Indiaforensic SERVICES I,,2018-09-28,500000.0,,584064.5599999968,.
409000493201',2018-09-29,FDRL/INTERNAL FUND TRANSFE,,2018-09-29,,100000.0,684064.5599999968,.
409000493201',2018-09-29,BBPS  DT 29092018,,2018-09-29,127682.12,,556382.4399999968,.
409000493201',2018-10-01,BBPS  DT 30092018,,2018-10-01,,244133.61,800516.0499999968,.
409000493201',2018-10-01,BBPS  DT 01102018,,2018-10-01,,254293.54,1054809.5899999968,.
409000493201',2018-10-03,BBPS DT 02102018,,2018-10-03,,202370.4,1257179.9899999967,.
409000493201',2018-10-03,BBPS DT 03102018,,2018-10-03,,314101.5,1571281.4899999967,.
409000493201',2018-10-04,BBPS DT 04102018,,2018-10-04,,233096.74,1804378.2299999967,.
409000493201',2018-10-04,TRF TO  Indiaforensic SERVICES I,,2018-10-04,1000000.0,,804378.2299999967,.
409000493201',2018-10-05,BBPS DT 05102018,,2018-10-05,,250778.13,1055156.3599999966,.
409000493201',2018-10-05,TRF TO  Indiaforensic SERVICES I,,2018-10-05,400000.0,,655156.3599999966,.
409000493201',2018-10-06,BBPS DT 06102018,,2018-10-06,,235850.74,891007.0999999966,.
409000493201',2018-10-08,BBPS DT 07102018,,2018-10-08,,276293.62,1167300.7199999965,.
409000493201',2018-10-08,BBPS DT 08102018,,2018-10-08,,358259.54,1525560.2599999965,.
409000493201',2018-10-09,BBPS DT 09102018,,2018-10-09,,130070.96,1655631.2199999965,.
409000493201',2018-10-09,TRF TO  Indiaforensic SERVICES I,,2018-10-09,800000.0,,855631.2199999965,.
409000493201',2018-10-10,BBPS DT 10102018,,2018-10-10,,200021.22,1055652.4399999965,.
409000493201',2018-10-11,BBPS DT 11102018,,2018-10-11,,242343.57,1297996.0099999965,.
409000493201',2018-10-11,TRF TO  Indiaforensic SERVICES I,,2018-10-11,600000.0,,697996.0099999965,.
409000493201',2018-10-12,BBPS DT 12102018,,2018-10-12,,263821.96,961817.9699999965,.
409000493201',2018-10-15,BBPS DT 13102018,,2018-10-15,,324167.89,1285985.8599999966,.
409000493201',2018-10-15,BBPS DT 14102018,,2018-10-15,,303093.88,1589079.7399999965,.
409000493201',2018-10-15,BBPS DT 15102018,,2018-10-15,,322041.12,1911120.8599999966,.
409000493201',2018-10-15,TRF TO  Indiaforensic SERVICES I,,2018-10-15,1000000.0,,911120.8599999966,.
409000493201',2018-10-16,BBPS DT 16102018,,2018-10-16,,151770.46,1062891.3199999966,.
409000493201',2018-10-17,BBPS DT 17102018,,2018-10-17,,267790.01,1330681.3299999966,.
409000493201',2018-10-17,TRF TO  Indiaforensic SERVICES I,,2018-10-17,500000.0,,830681.3299999966,.
409000493201',2018-10-18,BBPS DT 18102018,,2018-10-18,,253166.77,1083848.0999999966,.
409000493201',2018-10-18,TRF TO  Indiaforensic SERVICES I,,2018-10-18,400000.0,,683848.0999999966,.
409000493201',2018-10-19,BBPS DT 19102018,,2018-10-19,,336915.95,1020764.0499999966,.
409000493201',2018-10-20,BBPS DT 20102018,,2018-10-20,,349274.16,1370038.2099999965,.
409000493201',2018-10-22,BBPS DT 21102018,,2018-10-22,,307784.5,1677822.7099999965,.
409000493201',2018-10-22,BBPS DT 22102018,,2018-10-22,,416939.17,2094761.8799999964,.
409000493201',2018-10-22,TRF TO  Indiaforensic SERVICES I,,2018-10-22,1300000.0,,794761.8799999964,.
409000493201',2018-10-23,BBPS DT 23102018,,2018-10-23,,267929.89,1062691.7699999963,.
409000493201',2018-10-24,BBPS DT 24102018,,2018-10-24,,76371.19,1139062.9599999962,.
409000493201',2018-10-25,BBPS DT 25102018,,2018-10-25,,295669.35,1434732.3099999963,.
409000493201',2018-10-25,TRF TO  Indiaforensic SERVICES I,,2018-10-25,600000.0,,834732.3099999963,.
409000493201',2018-10-26,BBPS DT 26102018,,2018-10-26,,126310.53,961042.8399999964,.
409000493201',2018-10-29,BBPS DT 27102018,,2018-10-29,,198833.67,1159876.5099999963,.
409000493201',2018-10-29,BBPS DT 28102018,,2018-10-29,,282479.1,1442355.6099999961,.
409000493201',2018-10-29,BBPS DT 29102018,,2018-10-29,,330885.85,1773241.4599999962,.
409000493201',2018-10-29,TRF TO  Indiaforensic SERVICES I,,2018-10-29,1000000.0,,773241.4599999962,.
409000493201',2018-10-30,BBPS DT 30102018,,2018-10-30,,15113.17,788354.6299999963,.
409000493201',2018-10-31,BBPS DT 31102018,,2018-10-31,,57953.44,846308.0699999963,.
409000493201',2018-11-01,BBPS DT 01112018,,2018-11-01,,290256.64,1136564.7099999962,.
409000493201',2018-11-02,BBPS DT 02112018,,2018-11-02,,355637.06,1492201.7699999963,.
409000493201',2018-11-03,BBPS DT 03112018,,2018-11-03,,282568.29,1774770.0599999963,.
409000493201',2018-11-05,BBPS DT 04112018,,2018-11-05,,354950.17,2129720.2299999963,.
409000493201',2018-11-05,BBPS DT 05112018,,2018-11-05,,545436.19,2675156.419999996,.
409000493201',2018-11-06,BBPS DT 06112018,,2018-11-06,,182964.6,2858121.0199999963,.
409000493201',2018-11-06,TRF TO  Indiaforensic SERVICES I,,2018-11-06,2000000.0,,858121.0199999963,.
409000493201',2018-11-07,BBPS DT 07112018,,2018-11-07,,471757.52,1329878.5399999963,.
409000493201',2018-11-08,BBPS DT 08112018,,2018-11-08,,375507.73,1705386.2699999963,.
409000493201',2018-11-09,BBPS DT 09112018,,2018-11-09,,506473.63,2211859.899999996,.
409000493201',2018-11-12,BBPS DT 10112018,,2018-11-12,,352561.1,2564420.9999999963,.
409000493201',2018-11-12,BBPS DT 11112018,,2018-11-12,,290327.23,2854748.2299999963,.
409000493201',2018-11-12,BBPS DT 12112018,,2018-11-12,,419224.8,3273973.029999996,.
409000493201',2018-11-12,TRF TO  Indiaforensic SERVICES I,,2018-11-12,2500000.0,,773973.0299999961,.
409000493201',2018-11-13,BBPS DT 13112008,,2018-11-13,,163109.39,937082.4199999961,.
409000493201',2018-11-14,BBPS DT 14112008,,2018-11-14,,370836.7,1307919.1199999962,.
409000493201',2018-11-14,TRF TO  Indiaforensic SERVICES I,,2018-11-14,500000.0,,807919.1199999962,.
409000493201',2018-11-15,BBPS DT 15112008,,2018-11-15,,375417.76,1183336.8799999962,.
409000493201',2018-11-15,TRF TO  Indiaforensic SERVICES I,,2018-11-15,500000.0,,683336.8799999962,.
409000493201',2018-11-16,BBPS DT 16112008,,2018-11-16,,379555.15,1062892.029999996,.
409000493201',2018-11-16,TRF TO  Indiaforensic SERVICES I,,2018-11-16,500000.0,,562892.0299999961,.
409000493201',2018-11-17,BBPS DT 17112008,,2018-11-17,,322009.05,884901.0799999961,.
409000493201',2018-11-19,BBPS DT 18112018,,2018-11-19,,500434.76,1385335.8399999961,.
409000493201',2018-11-19,BBPS DT 19112018,,2018-11-19,,481280.06,1866615.8999999962,.
409000493201',2018-11-20,BBPS DT 20112008,,2018-11-20,,436410.64,2303026.5399999963,.
409000493201',2018-11-20,TRF TO  Indiaforensic SERVICES I,,2018-11-20,1700000.0,,603026.5399999963,.
409000493201',2018-11-21,BBPS DT 21112008,,2018-11-21,,295177.19,898203.7299999963,.
409000493201',2018-11-22,BBPS DT 22112008,,2018-11-22,,426704.94,1324908.6699999962,.
409000493201',2018-11-22,TRF TO  Indiaforensic SERVICES I,,2018-11-22,600000.0,,724908.6699999962,.
409000493201',2018-11-23,BBPS DT 23112008,,2018-11-23,,423446.49,1148355.1599999962,.
409000493201',2018-11-26,BBPS DT 24112018,,2018-11-26,,398309.17,1546664.329999996,.
409000493201',2018-11-26,BBPS DT 25112018,,2018-11-26,,313533.71,1860198.039999996,.
409000493201',2018-11-26,BBPS DT 26112018,,2018-11-26,,463841.24,2324039.279999996,.
409000493201',2018-11-26,TRF TO  Indiaforensic SERVICES I,,2018-11-26,1700000.0,,624039.2799999961,.
409000493201',2018-11-27,BBPS DT 27112008,,2018-11-27,,288502.17,912541.449999996,.
409000493201',2018-11-28,BBPS DT 28112008,,2018-11-28,,260361.75,1172903.199999996,.
409000493201',2018-11-29,BBPS DT 29112008,,2018-11-29,,426237.52,1599140.719999996,.
409000493201',2018-11-29,TRF TO  Indiaforensic SERVICES I,,2018-11-29,1000000.0,,599140.719999996,.
409000493201',2018-11-30,BBPS DT 30112008,,2018-11-30,,335997.77,935138.489999996,.
409000493201',2018-12-01,BBPS DT 01122008,,2018-12-01,,268923.12,1204061.6099999961,.
409000493201',2018-12-03,BBPS DT 02122008,,2018-12-03,,271416.97,1475478.579999996,.
409000493201',2018-12-03,BBPS DT 03122008,,2018-12-03,,291149.66,1766628.239999996,.
409000493201',2018-12-03,TRF TO  Indiaforensic SERVICES I,,2018-12-03,1200000.0,,566628.239999996,.
409000493201',2018-12-04,BBPS DT 04122008,,2018-12-04,,360370.52,926998.759999996,.
409000493201',2018-12-05,BBPS DT 05122008,,2018-12-05,,315346.66,1242345.419999996,.
409000493201',2018-12-05,FDRL/INTERNAL FUND TRANSFE,,2018-12-05,,200000.0,1442345.419999996,.
409000493201',2018-12-05,FDRL/INTERNAL FUND TRANSFE,,2018-12-05,,300000.0,1742345.419999996,.
409000493201',2018-12-05,TRF TO  Indiaforensic SERVICES I,,2018-12-05,500000.0,,1242345.419999996,.
409000493201',2018-12-06,BBPS DT 06122008,,2018-12-06,,403296.6,1645642.0199999958,.
409000493201',2018-12-07,BBPS DT 06122008,,2018-12-07,,615753.17,2261395.1899999958,.
409000493201',2018-12-07,TRF TO  Indiaforensic SERVICES I,,2018-12-07,1500000.0,,761395.1899999958,.
409000493201',2018-12-10,BBPS DT 08122018,,2018-12-10,,515462.82,1276858.0099999958,.
409000493201',2018-12-10,BBPS DT 09122018,,2018-12-10,,193681.75,1470539.7599999958,.
409000493201',2018-12-10,BBPS DT 10122018,,2018-12-10,,439890.04,1910429.7999999959,.
409000493201',2018-12-10,TRF TO  Indiaforensic SERVICES I,,2018-12-10,1200000.0,,710429.7999999959,.
409000493201',2018-12-11,BBPS DT 11122008,,2018-12-11,,245690.74,956120.5399999958,.
409000493201',2018-12-12,BBPS DT 12122018,,2018-12-12,,361675.89,1317796.429999996,.
409000493201',2018-12-13,BBPS DT 13122008,,2018-12-13,,126219.22,1444015.649999996,.
409000493201',2018-12-13,TRF TO  Indiaforensic SERVICES I,,2018-12-13,800000.0,,644015.649999996,.
409000493201',2018-12-14,BBPS DT 14122018,,2018-12-14,,467994.77,1112010.419999996,.
409000493201',2018-12-15,BBPS DT 15122018,,2018-12-15,,474113.93,1586124.349999996,.
409000493201',2018-12-17,BBPS DT 17122018,,2018-12-17,,518230.79,2104355.139999996,.
409000493201',2018-12-17,BBPS DT 16122018,,2018-12-17,,512680.61,2617035.749999996,.
409000493201',2018-12-17,TRF TO  Indiaforensic SERVICES I,,2018-12-17,2000000.0,,617035.7499999958,.
409000493201',2018-12-18,BBPS DT 18122018,,2018-12-18,,148602.58,765638.3299999958,.
409000493201',2018-12-19,BBPS DT 19122018,,2018-12-19,,193871.01,959509.3399999958,.
409000493201',2018-12-20,BBPS DT 20122018,,2018-12-20,2547.6,,956961.7399999958,.
409000493201',2018-12-20,BBPS DT 20122018,,2018-12-20,,183822.29,1140784.0299999958,.
409000493201',2018-12-20,TRF TO  Indiaforensic SERVICES I,,2018-12-20,500000.0,,640784.0299999958,.
409000493201',2018-12-21,BBPS DT 21122018,,2018-12-21,,86250.63,727034.6599999958,.
409000493201',2018-12-24,BBPS DT 23122018,,2018-12-24,182440.81,,544593.8499999959,.
409000493201',2018-12-24,BBPS DT 22122018,,2018-12-24,3261.88,,541331.9699999959,.
409000493201',2018-12-24,FDRL/INTERNAL FUND TRANSFE,,2018-12-24,,100000.0,641331.9699999959,.
409000493201',2018-12-24,BBPS DT24122018  IMPS GL,,2018-12-24,99820.78,,541511.1899999959,.
409000493201',2018-12-26,FDRL/INTERNAL FUND TRANSFE,,2018-12-26,,300000.0,841511.1899999959,.
409000493201',2018-12-26,FDRL/INTERNAL FUND TRANSFE,,2018-12-26,,300000.0,1141511.1899999958,.
409000493201',2018-12-26,BBPS DT 26122018,,2018-12-26,214821.75,,926689.4399999958,.
409000493201',2018-12-26,BBPS DT 25122018,,2018-12-26,242437.03,,684252.4099999957,.
409000493201',2018-12-27,FDRL/INTERNAL FUND TRANSFE,,2018-12-27,,100000.0,784252.4099999957,.
409000493201',2018-12-27,BBPS DT 27122018,,2018-12-27,209147.76,,575104.6499999957,.
409000493201',2018-12-28,FDRL/INTERNAL FUND TRANSFE,,2018-12-28,,200000.0,775104.6499999957,.
409000493201',2018-12-28,BBPS DT 28122018,,2018-12-28,200080.84,,575023.8099999957,.
409000493201',2018-12-28,FDRL/INTERNAL FUND TRANSFE,,2018-12-28,,300000.0,875023.8099999957,.
409000493201',2018-12-29,BBPS DT 29122018,,2018-12-29,146825.27,,728198.5399999957,.
409000493201',2018-12-31,FDRL/INTERNAL FUND TRANSFE,,2018-12-31,,100000.0,828198.5399999957,.
409000493201',2018-12-31,BBPS DT 30122018,,2018-12-31,117494.93,,710703.6099999957,.
409000493201',2018-12-31,BBPS DT 31122018,,2018-12-31,50376.69,,660326.9199999957,.
409000493201',2018-12-31,FDRL/INTERNAL FUND TRANSFE,,2018-12-31,,200000.0,860326.9199999957,.
409000493201',2019-01-01,BBPS DT 01012019,,2019-01-01,160965.27,,699361.6499999957,.
409000493201',2019-01-02,BBPS DT 02012019,,2019-01-02,38298.74,,661062.9099999957,.
409000493201',2019-01-03,FDRL/INTERNAL FUND TRANSFE,,2019-01-03,,100000.0,761062.9099999957,.
409000493201',2019-01-03,BBPS DT 03012019,,2019-01-03,94509.56,,666553.3499999957,.
409000493201',2019-01-04,FDRL/INTERNAL FUND TRANSFE,,2019-01-04,,100000.0,766553.3499999957,.
409000493201',2019-01-04,FDRL/INTERNAL FUND TRANSFE,,2019-01-04,,200000.0,966553.3499999957,.
409000493201',2019-01-04,BBPS DT 04012019,,2019-01-04,124836.9,,841716.4499999956,.
409000493201',2019-01-05,BBPS DT 05012019,,2019-01-05,82438.52,,759277.9299999956,.
409000493201',2019-01-07,BBPS DT 06012019,,2019-01-07,146158.69,,613119.2399999956,.
409000493201',2019-01-07,BBPS DT 07012019,,2019-01-07,90624.51,,522494.72999999556,.
409000493201',2019-01-07,FDRL/INTERNAL FUND TRANSFE,,2019-01-07,,100000.0,622494.7299999956,.
409000493201',2019-01-08,FDRL/INTERNAL FUND TRANSFE,,2019-01-08,,200000.0,822494.7299999956,.
409000493201',2019-01-08,BBPS DT 08012019,,2019-01-08,200263.25,,622231.4799999956,.
409000493201',2019-01-09,BBPS DT 09012019,,2019-01-09,155967.41,,466264.0699999955,.
409000493201',2019-01-09,FDRL/INTERNAL FUND TRANSFE,,2019-01-09,,200000.0,666264.0699999955,.
409000493201',2019-01-10,BBPS DT 10012019,,2019-01-10,130922.36,,535341.7099999955,.
409000493201',2019-01-10,FDRL/INTERNAL FUND TRANSFE,,2019-01-10,,100000.0,635341.7099999955,.
409000493201',2019-01-10,FDRL/INTERNAL FUND TRANSFE,,2019-01-10,,100000.0,735341.7099999955,.
409000493201',2019-01-11,BBPS DT 05012019,,2019-01-11,125569.82,,609771.8899999955,.
409000493201',2019-01-14,FDRL/INTERNAL FUND TRANSFE,,2019-01-14,,200000.0,809771.8899999955,.
409000493201',2019-01-14,BBPS DT 12012019,,2019-01-14,86420.15,,723351.7399999955,.
409000493201',2019-01-14,BBPS DT 13012019,,2019-01-14,89563.51,,633788.2299999954,.
409000493201',2019-01-14,BBPS DT 14012019,,2019-01-14,78829.57,,554958.6599999955,.
409000493201',2019-01-14,FDRL/INTERNAL FUND TRANSFE,,2019-01-14,,200000.0,754958.6599999955,.
409000493201',2019-01-15,BBPS DT 15012019,,2019-01-15,216993.16,,537965.4999999955,.
409000493201',2019-01-15,FDRL/INTERNAL FUND TRANSFE,,2019-01-15,,300000.0,837965.4999999955,.
409000493201',2019-01-16,BBPS DT 16012019,,2019-01-16,191929.33,,646036.1699999955,.
409000493201',2019-01-17,BBPS DT 17012019,,2019-01-17,126215.9,,519820.2699999955,.
409000493201',2019-01-17,FDRL/INTERNAL FUND TRANSFE,,2019-01-17,,300000.0,819820.2699999955,.
409000493201',2019-01-18,BBPS DT 18012019,,2019-01-18,130791.71,,689028.5599999955,.
409000493201',2019-01-19,BBPS DT 19012019,,2019-01-19,192484.66,,496543.8999999955,.
409000493201',2019-01-19,FDRL/INTERNAL FUND TRANSFE,,2019-01-19,,300000.0,796543.8999999955,.
409000493201',2019-01-21,BBPS DT 20012019,,2019-01-21,102723.8,,693820.0999999954,.
409000493201',2019-01-21,BBPS DT 21012019,,2019-01-21,89496.01,,604324.0899999954,.
409000493201',2019-01-22,FDRL/INTERNAL FUND TRANSFE,,2019-01-22,,300000.0,904324.0899999954,.
409000493201',2019-01-22,BBPS DT 22012019,,2019-01-22,264718.05,,639606.0399999954,.
409000493201',2019-01-22,FDRL/INTERNAL FUND TRANSFE,,2019-01-22,,300000.0,939606.0399999954,.
409000493201',2019-01-23,BBPS DT 23012019,,2019-01-23,203288.12,,736317.9199999954,.
409000493201',2019-01-23,FDRL/INTERNAL FUND TRANSFE,,2019-01-23,,200000.0,936317.9199999954,.
409000493201',2019-01-24,BBPS DT 24012019,,2019-01-24,210283.26,,726034.6599999954,.
409000493201',2019-01-24,FDRL/INTERNAL FUND TRANSFE,,2019-01-24,,200000.0,926034.6599999954,.
409000493201',2019-01-25,BBPS DT 25012019,,2019-01-25,160068.63,,765966.0299999954,.
409000493201',2019-01-28,BBPS DT 26012019,,2019-01-28,184208.33,,581757.6999999954,.
409000493201',2019-01-28,BBPS DT 27012019,,2019-01-28,70743.08,,511014.6199999954,.
409000493201',2019-01-28,BBPS DT 28012019,,2019-01-28,40666.41,,470348.2099999954,.
409000493201',2019-01-28,FDRL/INTERNAL FUND TRANSFE,,2019-01-28,,200000.0,670348.2099999954,.
409000493201',2019-01-29,FDRL/INTERNAL FUND TRANSFE,,2019-01-29,,200000.0,870348.2099999954,.
409000493201',2019-01-29,BBPS DT 29012019,,2019-01-29,356676.85,,513671.35999999545,.
409000493201',2019-01-29,FDRL/INTERNAL FUND TRANSFE,,2019-01-29,,200000.0,713671.3599999954,.
409000493201',2019-01-30,BBPS DT 30012019,,2019-01-30,241598.45,,472072.90999999543,.
409000493201',2019-01-30,FDRL/INTERNAL FUND TRANSFE,,2019-01-30,,200000.0,672072.9099999955,.
409000493201',2019-01-31,FDRL/INTERNAL FUND TRANSFE,,2019-01-31,,100000.0,772072.9099999955,.
409000493201',2019-01-31,BBPS DT 31012019,,2019-01-31,207386.49,,564686.4199999955,.
409000493201',2019-01-31,FDRL/INTERNAL FUND TRANSFE,,2019-01-31,,200000.0,764686.4199999955,.
409000493201',2019-02-01,BBPS DT 01022019,,2019-02-01,194258.69,,570427.7299999956,.
409000493201',2019-02-01,FDRL/INTERNAL FUND TRANSFE,,2019-02-01,,200000.0,770427.7299999956,.
409000493201',2019-02-02,BBPS DT 02022019,,2019-02-02,99147.7,,671280.0299999956,.
409000493201',2019-02-04,BBPS DT 03022019,,2019-02-04,96122.11,,575157.9199999956,.
409000493201',2019-02-04,BBPS DT 04022019,,2019-02-04,32352.14,,542805.7799999956,.
409000493201',2019-02-05,FDRL/INTERNAL FUND TRANSFE,,2019-02-05,,100000.0,642805.7799999956,.
409000493201',2019-02-05,FDRL/INTERNAL FUND TRANSFE,,2019-02-05,,200000.0,842805.7799999956,.
409000493201',2019-02-05,BBPS DT 05022019,,2019-02-05,181443.09,,661362.6899999956,.
409000493201',2019-02-05,FDRL/INTERNAL FUND TRANSFE,,2019-02-05,,200000.0,861362.6899999956,.
409000493201',2019-02-06,BBPS DT 06022019,,2019-02-06,216238.51,,645124.1799999956,.
409000493201',2019-02-06,FDRL/INTERNAL FUND TRANSFE,,2019-02-06,,300000.0,945124.1799999956,.
409000493201',2019-02-07,BBPS DT 07022019,,2019-02-07,171418.15,,773706.0299999956,.
409000493201',2019-02-08,BBPS DT 08022019,,2019-02-08,149942.6,,623763.4299999956,.
409000493201',2019-02-08,FDRL/INTERNAL FUND TRANSFE,,2019-02-08,,300000.0,923763.4299999956,.
409000493201',2019-02-11,BBPS DT 09022019,,2019-02-11,110277.09,,813486.3399999957,.
409000493201',2019-02-11,BBPS DT 10022019,,2019-02-11,80808.84,,732677.4999999957,.
409000493201',2019-02-11,BBPS DT 11022019,,2019-02-11,33114.8,,699562.6999999956,.
409000493201',2019-02-12,BBPS DT 12022019,,2019-02-12,116967.69,,582595.0099999956,.
409000493201',2019-02-12,FDRL/INTERNAL FUND TRANSFE,,2019-02-12,,100000.0,682595.0099999956,.
409000493201',2019-02-13,BBPS DT 13022019,,2019-02-13,90749.23,,591845.7799999956,.
409000493201',2019-02-13,FDRL/INTERNAL FUND TRANSFE,,2019-02-13,,100000.0,691845.7799999956,.
409000493201',2019-02-14,BBPS DT 14022019,,2019-02-14,96638.52,,595207.2599999956,.
409000493201',2019-02-14,FDRL/INTERNAL FUND TRANSFE,,2019-02-14,,100000.0,695207.2599999956,.
409000493201',2019-02-15,BBPS DT 15022019,,2019-02-15,132416.61,,562790.6499999956,.
409000493201',2019-02-15,FDRL/INTERNAL FUND TRANSFE,,2019-02-15,,100000.0,662790.6499999956,.
409000493201',2019-02-16,BBPS DT 16022019,,2019-02-16,199604.27,,463186.3799999956,.
409000493201',2019-02-16,FDRL/INTERNAL FUND TRANSFE,,2019-02-16,,100000.0,563186.3799999956,.
409000493201',2019-02-18,FDRL/INTERNAL FUND TRANSFE,,2019-02-18,,300000.0,863186.3799999956,.
409000493201',2019-02-18,BBPS DT 17022019,,2019-02-18,109270.49,,753915.8899999956,.
409000493201',2019-02-18,BBPS DT 18022019,,2019-02-18,57932.84,,695983.0499999956,.
409000493201',2019-02-19,BBPS DT 19022019,,2019-02-19,181484.83,,514498.21999999566,.
409000493201',2019-02-20,FDRL/INTERNAL FUND TRANSFE,,2019-02-20,,100000.0,614498.2199999957,.
409000493201',2019-02-20,FDRL/INTERNAL FUND TRANSFE,,2019-02-20,,100000.0,714498.2199999957,.
409000493201',2019-02-20,BBPS DT 20022019,,2019-02-20,145202.42,,569295.7999999956,.
409000493201',2019-02-20,FDRL/INTERNAL FUND TRANSFE,,2019-02-20,,100000.0,669295.7999999956,.
409000493201',2019-02-21,BBPS DT 21022019,,2019-02-21,165058.25,,504237.5499999956,.
409000493201',2019-02-21,FDRL/INTERNAL FUND TRANSFE,,2019-02-21,,300000.0,804237.5499999956,.
409000493201',2019-02-22,BBPS DT 22022019,,2019-02-22,61442.29,,742795.2599999956,.
409000493201',2019-02-25,FDRL/INTERNAL FUND TRANSFE,,2019-02-25,,100000.0,842795.2599999956,.
409000493201',2019-02-25,BBPS DT 23022019,,2019-02-25,85626.32,,757168.9399999955,.
409000493201',2019-02-25,BBPS DT 24022019,,2019-02-25,78877.02,,678291.9199999955,.
409000493201',2019-02-25,BBPS DT 25022019,,2019-02-25,19145.05,,659146.8699999955,.
409000493201',2019-02-25,FDRL/INTERNAL FUND TRANSFE,,2019-02-25,,100000.0,759146.8699999955,.
409000493201',2019-02-26,BBPS DT 26022019,,2019-02-26,80664.07,,678482.7999999954,.
409000493201',2019-02-26,BBPS TDS @2% OCT 18 VIJAY,,2019-02-26,2.7,,678480.0999999954,.
409000493201',2019-02-27,BBPS DT 27022019,,2019-02-27,135504.16,,542975.9399999954,.
409000493201',2019-02-27,FDRL/INTERNAL FUND TRANSFE,,2019-02-27,,200000.0,742975.9399999954,.
409000493201',2019-02-28,BBPS DT 28022019,,2019-02-28,92031.56,,650944.3799999955,.
409000493201',2019-03-01,BBPS DT 01032019,,2019-03-01,118475.77,,532468.6099999954,.
409000493201',2019-03-02,FDRL/INTERNAL FUND TRANSFE,,2019-03-02,,300000.0,832468.6099999954,.
409000493201',2019-03-02,BBPS DT 02032019,,2019-03-02,16440.61,,816027.9999999955,.
409000493201',2019-03-04,BBPS DT 03032019,,2019-03-04,59110.48,,756917.5199999955,.
409000493201',2019-03-04,BBPS DT 04032019,,2019-03-04,3002.37,,753915.1499999955,.
409000493201',2019-03-05,BBPS DT 05032019,,2019-03-05,10331.83,,743583.3199999955,.
