Account No,DATE,TRANSACTION DETAILS,CHQ.NO.,VALUE DATE,WITHDRAWAL AMT,DEPOSIT AMT,BALANCE AMT,.
409000438620',2016-02-25,GOLD LABEL INVESTMENTS (P,,2016-02-25,,544800000.0,-1514640.0199998617,.
409000438620',2016-02-26,TRF TO  Indiaforensic SERVICES I,,2016-02-26,100000000.0,,-101514640.01999986,.
409000438620',2016-02-29,NEFT/FDRL401249529/Indiaforensic,,2016-02-29,,15000000.0,-86514640.01999986,.
409000438620',2016-02-29,NEFT/FDRL401249530/Indiaforensic,,2016-02-29,,15000000.0,-71514640.01999986,.
409000438620',2016-02-29,NEFT/FDRL401249531/Indiaforensic,,2016-02-29,,15000000.0,-56514640.01999986,.
409000438620',2016-02-29,NEFT/FDRL401249532/Indiaforensic,,2016-02-29,,15000000.0,-41514640.01999986,.
409000438620',2016-02-29,NEFT/FDRL401249533/Indiaforensic,,2016-02-29,,15000000.0,-26514640.01999986,.
409000438620',2016-02-29,NEFT/FDRL401249534/Indiaforensic,,2016-02-29,,15000000.0,-11514640.019999862,.
409000438620',2016-02-29,NEFT/FDRL401249590/Indiaforensic,,2016-02-29,,10000000.0,-1514640.0199998617,.
409000438620',2016-03-04,TRF TO  Indiaforensic SERVICES I,,2016-03-04,15000000.0,,-16514640.019999862,.
409000438620',2016-03-04,TRF TO  Indiaforensic SERVICES I,,2016-03-04,15000000.0,,-31514640.01999986,.
409000438620',2016-03-07,TRF TO Indiaforensic SERVICES IN,,2016-03-07,15000000.0,,-46514640.01999986,.
409000438620',2016-03-07,TRF TO Indiaforensic SERVICES IN,,2016-03-07,15000000.0,,-61514640.01999986,.
409000438620',2016-03-07,TRF TO Indiaforensic SERVICES IN,,2016-03-07,15000000.0,,-76514640.01999986,.
409000438620',2016-03-08,TRF TO  Indiaforensic SERVICES I,,2016-03-08,1900000.0,,-78414640.01999986,.
409000438620',2016-03-08,RTGS CHARGES AND STAX/RAT,,2016-03-08,28.63,,-78414668.64999986,.
409000438620',2016-03-08,RTGS/YESBH16068986176/Indfor,,2016-03-08,15000000.0,,-93414668.64999986,.
409000438620',2016-03-08,RTGS CHARGES AND STAX/RAT,,2016-03-08,28.63,,-93414697.27999985,.
409000438620',2016-03-08,RTGS/YESBH16068986261/Indfor,,2016-03-08,15000000.0,,-108414697.27999985,.
409000438620',2016-03-08,YOURSELF FOR M Joshi,,2016-03-08,400000000.0,,-508414697.27999985,.
409000438620',2016-03-11,TRF TO Indiaforensic SERVICES IN,,2016-03-11,15000000.0,,-523414697.27999985,.
409000438620',2016-03-11,TRF TO Indiaforensic SERVICES IN,,2016-03-11,15000000.0,,-538414697.2799999,.
409000438620',2016-03-11,TRF TO Indiaforensic SERVICES IN,,2016-03-11,7000000.0,,-545414697.2799999,.
409000438620',2016-03-11,709002333825 : Closure Pr,,2016-03-11,,100000000.0,-445414697.27999985,.
409000438620',2016-03-11,709002333849 : Closure Pr,,2016-03-11,,100000000.0,-345414697.27999985,.
409000438620',2016-03-11,TRF TO  Varaad Chiney,,2016-03-11,200000000.0,,-545414697.2799999,.
409000438620',2016-03-14,RTGS/ICICH16074260960/Indfor,,2016-03-14,,15000000.0,-530414697.27999985,.
409000438620',2016-03-14,RTGS/ICICH16074260949/Indfor,,2016-03-14,,15000000.0,-515414697.27999985,.
409000438620',2016-03-14,RTGS/ICICH16074260996/Indfor,,2016-03-14,,15000000.0,-500414697.27999985,.
409000438620',2016-03-14,RTGS/ICICH16074261000/Indfor,,2016-03-14,,15000000.0,-485414697.27999985,.
409000438620',2016-03-14,RTGS/ICICH16074260975/Indfor,,2016-03-14,,15000000.0,-470414697.27999985,.
409000438620',2016-03-14,RTGS/ICICH16074260989/Indfor,,2016-03-14,,15000000.0,-455414697.27999985,.
409000438620',2016-03-14,NEFT/FDRL401353407/Indiaforensic,,2016-03-14,,15000000.0,-440414697.27999985,.
409000438620',2016-03-14,NEFT/FDRL401353408/Indiaforensic,,2016-03-14,,15000000.0,-425414697.27999985,.
409000438620',2016-03-15,TRF TO  Indiaforensic SERVICES I,,2016-03-15,15000000.0,,-440414697.27999985,.
409000438620',2016-03-15,TRF TO  Indiaforensic SERVICES I,,2016-03-15,15000000.0,,-455414697.27999985,.
409000438620',2016-03-15,TRF TO  Indiaforensic SERVICES I,,2016-03-15,15000000.0,,-470414697.27999985,.
409000438620',2016-03-15,TRF TO  Indiaforensic SERVICES I,,2016-03-15,15000000.0,,-485414697.27999985,.
409000438620',2016-03-15,TRF TO  Indiaforensic SERVICES I,,2016-03-15,15000000.0,,-500414697.27999985,.
409000438620',2016-03-15,TRF TO  Indiaforensic SERVICES I,,2016-03-15,15000000.0,,-515414697.27999985,.
409000438620',2016-03-15,TRF TO  Indiaforensic SERVICES I,,2016-03-15,15000000.0,,-530414697.27999985,.
409000438620',2016-03-15,TRF TO  Indiaforensic SERVICES I,,2016-03-15,15000000.0,,-545414697.2799999,.
409000438620',2016-03-18,Repayment credit [7090023,,2016-03-18,,100150685.0,-445264012.27999985,.
409000438620',2016-03-18,Repayment credit [7090023,,2016-03-18,,100150685.0,-345113327.27999985,.
409000438620',2016-03-18,TRF TO  Varaad Chinye,,2016-03-18,200000000.0,,-545113327.2799999,.
409000438620',2016-07-15,Indiaforensic AEPS NPCI WDL SET,,2016-07-15,,62.0,-545113265.2799999,.
409000438620',2016-07-15,Indiaforensic AEPS NPCI WDL SET,,2016-07-15,,26.0,-545113239.2799999,.
409000438620',2016-07-15,Indiaforensic AEPS NPCI WDL SET,,2016-07-15,,114.0,-545113125.2799999,.
409000438620',2016-07-15,Indiaforensic AEPS NPCI WDL SET,,2016-07-15,,1.0,-545113124.2799999,.
409000438620',2016-07-15,Indiaforensic AEPS NPCI WDL SET,,2016-07-15,,100.0,-545113024.2799999,.
409000438620',2016-07-15,Indiaforensic AEPS NPCI WDL SET,,2016-07-15,,5100.0,-545107924.2799999,.
409000438620',2016-07-15,Indiaforensic AEPS NPCI WDL SET,,2016-07-15,,3300.0,-545104624.2799999,.
409000438620',2016-07-15,Indiaforensic AEPS NPCI WDL SET,,2016-07-15,,10.0,-545104614.2799999,.
409000438620',2016-07-15,Indiaforensic AEPS NPCI WDL SET,,2016-07-15,,2010.0,-545102604.2799999,.
409000438620',2016-07-15,Indiaforensic AEPS NPCI WDL SET,,2016-07-15,,4200.0,-545098404.2799999,.
409000438620',2016-07-15,Indiaforensic AEPS NPCI WDL SET,,2016-07-15,,10.0,-545098394.2799999,.
409000438620',2016-07-15,Indiaforensic AEPS NPCI WDL SET,,2016-07-15,,6978.0,-545091416.2799999,.
409000438620',2016-07-15,Indiaforensic AEPS NPCI WDL SET,,2016-07-15,,2000.0,-545089416.2799999,.
409000438620',2016-07-15,Indiaforensic AEPS NPCI WDL SET,,2016-07-15,,22000.0,-545067416.2799999,.
409000438620',2016-07-15,Indiaforensic AEPS NPCI WDL SET,,2016-07-15,,21190.0,-545046226.2799999,.
409000438620',2016-07-15,Indiaforensic AEPS NPCI WDL SET,,2016-07-15,,22010.0,-545024216.2799999,.
409000438620',2016-07-15,Indiaforensic AEPS NPCI WDL SET,,2016-07-15,,47410.0,-544976806.2799999,.
409000438620',2016-07-15,Indiaforensic AEPS NPCI DEP SET,,2016-07-15,39.0,,-544976845.2799999,.
409000438620',2016-07-15,Indiaforensic AEPS NPCI DEP SET,,2016-07-15,134.0,,-544976979.2799999,.
409000438620',2016-07-15,Indiaforensic AEPS NPCI DEP SET,,2016-07-15,2.0,,-544976981.2799999,.
409000438620',2016-07-15,Indiaforensic AEPS NPCI DEP SET,,2016-07-15,100.0,,-544977081.2799999,.
409000438620',2016-07-15,Indiaforensic AEPS NPCI DEP SET,,2016-07-15,100.0,,-544977181.2799999,.
409000438620',2016-07-15,Indiaforensic AEPS NPCI DEP SET,,2016-07-15,10000.0,,-544987181.2799999,.
409000438620',2016-07-15,Indiaforensic AEPS NPCI DEP SET,,2016-07-15,15000.0,,-545002181.2799999,.
409000438620',2016-07-15,Indiaforensic AEPS NPCI DEP SET,,2016-07-15,11419.0,,-545013600.2799999,.
409000438620',2016-07-15,Indiaforensic AEPS NPCI DEP SET,,2016-07-15,8478.0,,-545022078.2799999,.
409000438620',2016-07-15,Indiaforensic AEPS NPCI DEP SET,,2016-07-15,9500.0,,-545031578.2799999,.
409000438620',2016-07-15,Indiaforensic AEPS NPCI DEP SET,,2016-07-15,5000.0,,-545036578.2799999,.
409000438620',2016-07-15,Indiaforensic AEPS NPCI DEP SET,,2016-07-15,10.0,,-545036588.2799999,.
409000438620',2016-07-15,Indiaforensic AEPS NPCI DEP SET,,2016-07-15,2210.0,,-545038798.2799999,.
409000438620',2016-07-15,Indiaforensic AEPS NPCI DEP SET,,2016-07-15,17100.0,,-545055898.2799999,.
409000438620',2016-07-15,AEPS Indiaforensic INCOME 1506,,2016-07-15,,23.75,-545055874.5299999,.
409000438620',2016-07-15,AEPS Indiaforensic S TAX 1506,,2016-07-15,,3.56,-545055870.9699999,.
409000438620',2016-07-15,AEPS Indiaforensic INCOME 1606,,2016-07-15,,23.5,-545055847.4699999,.
409000438620',2016-07-15,AEPS Indiaforensic S TAX 1606,,2016-07-15,,3.53,-545055843.9399999,.
409000438620',2016-07-15,AEPS Indiaforensic INCOME 2106,,2016-07-15,,21.5,-545055822.4399999,.
409000438620',2016-07-15,AEPS Indiaforensic S TAX 2106,,2016-07-15,,3.23,-545055819.2099999,.
409000438620',2016-07-15,AEPS Indiaforensic INCOME 2206,,2016-07-15,,19.5,-545055799.7099999,.
409000438620',2016-07-15,AEPS Indiaforensic S TAX 2206,,2016-07-15,,2.93,-545055796.78,.
409000438620',2016-07-15,AEPS Indiaforensic INCOME 2506,,2016-07-15,,10.75,-545055786.03,.
409000438620',2016-07-15,AEPS Indiaforensic S TAX 2506,,2016-07-15,,1.61,-545055784.42,.
409000438620',2016-07-15,AEPS Indiaforensic INCOME 0207,,2016-07-15,,28.25,-545055756.17,.
409000438620',2016-07-15,AEPS Indiaforensic S TAX 0207,,2016-07-15,,4.24,-545055751.93,.
409000438620',2016-07-15,AEPS Indiaforensic INCOME 0307,,2016-07-15,,26.25,-545055725.68,.
409000438620',2016-07-15,AEPS Indiaforensic S TAX 0307,,2016-07-15,,3.94,-545055721.7399999,.
409000438620',2016-07-15,AEPS Indiaforensic INCOME 0407,,2016-07-15,,32.5,-545055689.2399999,.
409000438620',2016-07-15,AEPS Indiaforensic S TAX 0407,,2016-07-15,,4.88,-545055684.3599999,.
409000438620',2016-07-15,AEPS Indiaforensic INCOME 0507,,2016-07-15,,22.1,-545055662.2599999,.
409000438620',2016-07-15,AEPS Indiaforensic S TAX 0507,,2016-07-15,,3.32,-545055658.9399998,.
409000438620',2016-07-15,AEPS Indiaforensic INCOME 0607,,2016-07-15,,60.5,-545055598.4399998,.
409000438620',2016-07-15,AEPS Indiaforensic S TAX 0607,,2016-07-15,,9.08,-545055589.3599998,.
409000438620',2016-07-15,AEPS Indiaforensic INCOME 0807,,2016-07-15,,65.5,-545055523.8599998,.
409000438620',2016-07-15,AEPS Indiaforensic S TAX 0807,,2016-07-15,,9.83,-545055514.0299997,.
409000438620',2016-07-15,AEPS Indiaforensic INCOME 0907,,2016-07-15,,106.88,-545055407.1499997,.
409000438620',2016-07-15,AEPS Indiaforensic S TAX 0907,,2016-07-15,,16.03,-545055391.1199998,.
409000438620',2016-07-15,AEPS Indiaforensic INCOME 1007,,2016-07-15,,41.25,-545055349.8699998,.
409000438620',2016-07-15,AEPS Indiaforensic S TAX 1007,,2016-07-15,,6.19,-545055343.6799997,.
409000438620',2016-07-15,AEPS Indiaforensic INCOME 1107,,2016-07-15,,173.4,-545055170.2799997,.
409000438620',2016-07-15,AEPS Indiaforensic S TAX 1107,,2016-07-15,,26.01,-545055144.2699997,.
409000438620',2016-07-15,AEPS Indiaforensic INCOME 1207,,2016-07-15,,111.25,-545055033.0199997,.
409000438620',2016-07-15,AEPS Indiaforensic S TAX 1207,,2016-07-15,,16.69,-545055016.3299997,.
409000438620',2016-07-15,AEPS Indiaforensic INCOME 1307,,2016-07-15,,152.25,-545054864.0799997,.
409000438620',2016-07-15,AEPS Indiaforensic S TAX 1307,,2016-07-15,,22.84,-545054841.2399997,.
409000438620',2016-07-15,AEPS Indiaforensic INCOME 140716,,2016-07-15,,311.15,-545054530.0899997,.
409000438620',2016-07-15,AEPS Indiaforensic S TAX 140716,,2016-07-15,,46.67,-545054483.4199997,.
409000438620',2016-07-16,Indiaforensic AEPS NPCI DEP SET,,2016-07-16,19822.0,,-545074305.4199997,.
409000438620',2016-07-16,Indiaforensic AEPS NPCI WDL SET,,2016-07-16,,37309.0,-545036996.4199997,.
409000438620',2016-07-16,AEPS Indiaforensic INCOME 150716,,2016-07-16,,274.95,-545036721.4699997,.
409000438620',2016-07-16,AEPS Indiaforensic S TAX 150716,,2016-07-16,,41.24,-545036680.2299997,.
409000438620',2016-07-18,Indiaforensic AEPS NPCI WDL SET,,2016-07-18,,44489.0,-544992191.2299997,.
409000438620',2016-07-18,Indiaforensic AEPS NPCI WDL SET,,2016-07-18,,66710.0,-544925481.2299997,.
409000438620',2016-07-18,Indiaforensic AEPS NPCI DEP SET,,2016-07-18,36500.0,,-544961981.2299997,.
409000438620',2016-07-18,Indiaforensic AEPS NPCI DEP SET,,2016-07-18,5560.0,,-544967541.2299997,.
409000438620',2016-07-18,AEPS Indiaforensic INCOME 160716,,2016-07-18,,289.4,-544967251.8299997,.
409000438620',2016-07-18,AEPS Indiaforensic S TAX 160716,,2016-07-18,,43.41,-544967208.4199997,.
409000438620',2016-07-18,AEPS Indiaforensic INCOME 170716,,2016-07-18,,301.9,-544966906.5199997,.
409000438620',2016-07-18,AEPS Indiaforensic S TAX 170716,,2016-07-18,,45.29,-544966861.2299998,.
409000438620',2016-07-19,Indiaforensic AEPS NPCI WDL SET,,2016-07-19,,35254.0,-544931607.2299998,.
409000438620',2016-07-19,AEPS Indiaforensic INCOME 180716,,2016-07-19,,271.35,-544931335.8799998,.
409000438620',2016-07-19,AEPS Indiaforensic S TAX 180716,,2016-07-19,,40.7,-544931295.1799997,.
409000438620',2016-07-19,Indiaforensic AEPS NPCI DEP SET,,2016-07-19,16619.0,,-544947914.1799997,.
409000438620',2016-07-20,Indiaforensic AEPS NPCI DEP SET,,2016-07-20,28017.0,,-544975931.1799997,.
409000438620',2016-07-20,Indiaforensic AEPS NPCI WDL SET,,2016-07-20,,56315.0,-544919616.1799997,.
409000438620',2016-07-20,AEPS Indiaforensic INCOME 190716,,2016-07-20,,545.25,-544919070.9299997,.
409000438620',2016-07-20,AEPS Indiaforensic S TAX 190716,,2016-07-20,,81.79,-544918989.1399997,.
409000438620',2016-07-21,AEPS Indiaforensic INCOME 200716,,2016-07-21,,376.35,-544918612.7899997,.
409000438620',2016-07-21,AEPS Indiaforensic S TAX 200716,,2016-07-21,,56.45,-544918556.3399997,.
409000438620',2016-07-21,Indiaforensic AEPS NPCI DEP SET,,2016-07-21,23950.0,,-544942506.3399997,.
409000438620',2016-07-21,Indiaforensic AEPS NPCI WDL SET,,2016-07-21,,80092.0,-544862414.3399997,.
409000438620',2016-07-22,Indiaforensic AEPS NPCI WDL SET,,2016-07-22,,45231.0,-544817183.3399997,.
409000438620',2016-07-22,Indiaforensic AEPS NPCI DEP SET,,2016-07-22,43382.0,,-544860565.3399997,.
409000438620',2016-07-22,AEPS Indiaforensic INCOME 210716,,2016-07-22,,417.75,-544860147.5899997,.
409000438620',2016-07-22,AEPS Indiaforensic S TAX 210716,,2016-07-22,,62.66,-544860084.9299997,.
409000438620',2016-07-25,Indiaforensic AEPS NPCI WDL SET,,2016-07-25,,87439.0,-544772645.9299997,.
409000438620',2016-07-25,Indiaforensic AEPS NPCI WDL SET,,2016-07-25,,64050.0,-544708595.9299997,.
409000438620',2016-07-25,Indiaforensic AEPS NPCI WDL SET,,2016-07-25,,52450.0,-544656145.9299997,.
409000438620',2016-07-25,Indiaforensic AEPS NPCI DEP SET,,2016-07-25,43091.0,,-544699236.9299997,.
409000438620',2016-07-25,Indiaforensic AEPS NPCI DEP SET,,2016-07-25,24400.0,,-544723636.9299997,.
409000438620',2016-07-25,Indiaforensic AEPS NPCI DEP SET,,2016-07-25,28300.0,,-544751936.9299997,.
409000438620',2016-07-25,AEPS Indiaforensic INCOME 220716,,2016-07-25,,521.1,-544751415.8299997,.
409000438620',2016-07-25,AEPS Indiaforensic S TAX 220716,,2016-07-25,,78.17,-544751337.6599997,.
409000438620',2016-07-25,AEPS Indiaforensic INCOME 230716,,2016-07-25,,224.0,-544751113.6599997,.
409000438620',2016-07-25,AEPS Indiaforensic S TAX 230716,,2016-07-25,,33.6,-544751080.0599997,.
409000438620',2016-07-25,AEPS Indiaforensic INCOME 240716,,2016-07-25,,323.9,-544750756.1599997,.
409000438620',2016-07-25,AEPS Indiaforensic S TAX 240716,,2016-07-25,,48.59,-544750707.5699997,.
409000438620',2016-07-26,Indiaforensic AEPS NPCI DEP SET,,2016-07-26,10500.0,,-544761207.5699997,.
409000438620',2016-07-26,AEPS Indiaforensic INCOME 250716,,2016-07-26,,149.75,-544761057.8199997,.
409000438620',2016-07-26,AEPS Indiaforensic S TAX 250716,,2016-07-26,,22.46,-544761035.3599997,.
409000438620',2016-07-26,Indiaforensic AEPS NPCI WDL SET,,2016-07-26,,18025.0,-544743010.3599997,.
409000438620',2016-07-27,Indiaforensic AEPS NPCI WDL SET,,2016-07-27,,34070.0,-544708940.3599997,.
409000438620',2016-07-27,Indiaforensic AEPS NPCI DEP SET,,2016-07-27,28100.0,,-544737040.3599997,.
409000438620',2016-07-27,AEPS Indiaforensic INCOME 260716,,2016-07-27,,325.8,-544736714.5599997,.
409000438620',2016-07-27,AEPS Indiaforensic S TAX 260716,,2016-07-27,,48.87,-544736665.6899997,.
409000438620',2016-07-28,Indiaforensic AEPS NPCI DEP SET,,2016-07-28,26269.0,,-544762934.6899997,.
409000438620',2016-07-28,Indiaforensic AEPS NPCI WDL SET,,2016-07-28,,44300.0,-544718634.6899997,.
409000438620',2016-07-28,AEPS Indiaforensic INCOME 270716,,2016-07-28,,321.85,-544718312.8399997,.
409000438620',2016-07-28,AEPS Indiaforensic S TAX 270716,,2016-07-28,,48.28,-544718264.5599997,.
409000438620',2016-07-28,TRF TO  Indiaforensic SERVICES I,,2016-07-28,1500000.0,,-546218264.5599997,.
409000438620',2016-07-29,Indiaforensic AEPS NPCI WDL SET,,2016-07-29,,81100.0,-546137164.5599997,.
409000438620',2016-07-29,Indiaforensic AEPS NPCI DEP SET,,2016-07-29,5720.0,,-546142884.5599997,.
409000438620',2016-07-29,AEPS Indiaforensic INCOME 280716,,2016-07-29,,324.47,-546142560.0899997,.
409000438620',2016-07-29,AEPS Indiaforensic S TAX 280716,,2016-07-29,,48.67,-546142511.4199997,.
409000438620',2016-07-30,Indiaforensic AEPS NPCI WDL SET,,2016-07-30,,108100.0,-546034411.4199997,.
409000438620',2016-07-30,Indiaforensic AEPS NPCI DEP SET,,2016-07-30,15980.0,,-546050391.4199997,.
409000438620',2016-07-30,AEPS Indiaforensic INCOME 290716,,2016-07-30,,469.18,-546049922.2399998,.
409000438620',2016-07-30,AEPS Indiaforensic S TAX 290716,,2016-07-30,,70.38,-546049851.8599998,.
409000438620',2016-08-01,Indiaforensic AEPS NPCI DEP SET,,2016-08-01,29771.0,,-546079622.8599998,.
409000438620',2016-08-01,Indiaforensic AEPS NPCI DEP SET,,2016-08-01,45070.0,,-546124692.8599998,.
409000438620',2016-08-01,Indiaforensic AEPS NPCI WDL SET,,2016-08-01,,127015.0,-545997677.8599998,.
409000438620',2016-08-01,Indiaforensic AEPS NPCI WDL SET,,2016-08-01,,54851.0,-545942826.8599998,.
409000438620',2016-08-01,AEPS Indiaforensic INCOME 300716,,2016-08-01,,760.42,-545942066.4399998,.
409000438620',2016-08-01,AEPS Indiaforensic S TAX 300716,,2016-08-01,,114.06,-545941952.3799999,.
409000438620',2016-08-01,AEPS Indiaforensic INCOME 310716,,2016-08-01,,558.04,-545941394.3399999,.
409000438620',2016-08-01,AEPS Indiaforensic S TAX 310716,,2016-08-01,,83.71,-545941310.6299999,.
409000438620',2016-08-02,Indiaforensic AEPS NPCI WDL SET,,2016-08-02,,104929.0,-545836381.6299999,.
409000438620',2016-08-02,Indiaforensic AEPS NPCI DEP SET,,2016-08-02,42099.0,,-545878480.6299999,.
409000438620',2016-08-02,AEPS Indiaforensic INCOME 010816,,2016-08-02,,847.1,-545877633.5299999,.
409000438620',2016-08-02,AEPS Indiaforensic S TAX 010816,,2016-08-02,,127.07,-545877506.4599998,.
409000438620',2016-08-03,Indiaforensic AEPS NPCI WDL SET,,2016-08-03,,54700.0,-545822806.4599998,.
409000438620',2016-08-03,Indiaforensic AEPS NPCI DEP SET,,2016-08-03,27170.0,,-545849976.4599998,.
409000438620',2016-08-03,AEPS Indiaforensic INCOME 020816,,2016-08-03,,554.08,-545849422.3799998,.
409000438620',2016-08-03,AEPS Indiaforensic S TAX 020816,,2016-08-03,,83.11,-545849339.2699997,.
409000438620',2016-08-04,Indiaforensic AEPS NPCI WDL SET,,2016-08-04,,61500.0,-545787839.2699997,.
409000438620',2016-08-04,Indiaforensic AEPS NPCI DEP SET,,2016-08-04,70650.0,,-545858489.2699997,.
409000438620',2016-08-04,AEPS Indiaforensic INCOME 030816,,2016-08-04,,644.3,-545857844.9699998,.
409000438620',2016-08-04,AEPS Indiaforensic S TAX 030816,,2016-08-04,,96.65,-545857748.3199998,.
409000438620',2016-08-05,Indiaforensic AEPS NPCI WDL SET,,2016-08-05,,132283.0,-545725465.3199998,.
409000438620',2016-08-05,Indiaforensic AEPS NPCI DEP SET,,2016-08-05,70750.0,,-545796215.3199998,.
409000438620',2016-08-05,AEPS Indiaforensic INCOME 040816,,2016-08-05,,1188.0,-545795027.3199998,.
409000438620',2016-08-05,AEPS Indiaforensic S TAX 040816,,2016-08-05,,178.2,-545794849.1199998,.
409000438620',2016-08-06,Indiaforensic AEPS NPCI WDL SET,,2016-08-06,,461874.0,-545332975.1199998,.
409000438620',2016-08-06,Indiaforensic AEPS NPCI DEP SET,,2016-08-06,94410.0,,-545427385.1199998,.
409000438620',2016-08-06,AEPS Indiaforensic INCOME 050816,,2016-08-06,,3245.57,-545424139.5499997,.
409000438620',2016-08-06,AEPS Indiaforensic S TAX 050816,,2016-08-06,,486.84,-545423652.7099997,.
409000438620',2016-08-08,Indiaforensic AEPS NPCI DEP SET,,2016-08-08,68100.0,,-545491752.7099997,.
409000438620',2016-08-08,Indiaforensic AEPS NPCI DEP SET,,2016-08-08,41100.0,,-545532852.7099997,.
409000438620',2016-08-08,Indiaforensic AEPS NPCI WDL SET,,2016-08-08,,238536.0,-545294316.7099997,.
409000438620',2016-08-08,Indiaforensic AEPS NPCI WDL SET,,2016-08-08,,121375.0,-545172941.7099997,.
409000438620',2016-08-08,AEPS Indiaforensic INCOME 060816,,2016-08-08,,1416.31,-545171525.3999997,.
409000438620',2016-08-08,AEPS Indiaforensic S TAX 060816,,2016-08-08,,212.45,-545171312.9499997,.
409000438620',2016-08-08,AEPS Indiaforensic INCOME 070816,,2016-08-08,,899.83,-545170413.1199996,.
409000438620',2016-08-08,AEPS Indiaforensic S TAX 070816,,2016-08-08,,134.97,-545170278.1499996,.
409000438620',2016-08-09,Indiaforensic AEPS NPCI DEP SET,,2016-08-09,72510.0,,-545242788.1499996,.
409000438620',2016-08-09,Indiaforensic AEPS NPCI WDL SET,,2016-08-09,,274746.0,-544968042.1499996,.
409000438620',2016-08-09,AEPS Indiaforensic INCOME 080816,,2016-08-09,,1992.35,-544966049.7999996,.
409000438620',2016-08-09,AEPS Indiaforensic S TAX 080816,,2016-08-09,,298.85,-544965750.9499996,.
409000438620',2016-08-10,Indiaforensic AEPS NPCI DEP SET,,2016-08-10,56200.0,,-545021950.9499996,.
409000438620',2016-08-10,Indiaforensic AEPS NPCI WDL SET,,2016-08-10,,186330.0,-544835620.9499996,.
409000438620',2016-08-10,AEPS Indiaforensic INCOME 090816,,2016-08-10,,1261.2,-544834359.7499995,.
409000438620',2016-08-10,AEPS Indiaforensic S TAX 090816,,2016-08-10,,189.18,-544834170.5699996,.
409000438620',2016-08-11,Indiaforensic AEPS NPCI WDL SET,,2016-08-11,,137000.0,-544697170.5699996,.
409000438620',2016-08-11,Indiaforensic AEPS NPCI DEP SET,,2016-08-11,138185.0,,-544835355.5699996,.
409000438620',2016-08-11,AEPS Indiaforensic INCOME 100816,,2016-08-11,,1162.7,-544834192.8699995,.
409000438620',2016-08-11,AEPS Indiaforensic S TAX 100816,,2016-08-11,,174.41,-544834018.4599996,.
409000438620',2016-08-12,AEPS Indiaforensic INCOME 110816,,2016-08-12,,2071.3,-544831947.1599996,.
409000438620',2016-08-12,AEPS Indiaforensic S TAX 110816,,2016-08-12,,310.7,-544831636.4599996,.
409000438620',2016-08-12,Indiaforensic AEPS NPCI WDL SET,,2016-08-12,,257588.0,-544574048.4599996,.
409000438620',2016-08-12,Indiaforensic AEPS NPCI DEP SET,,2016-08-12,152700.0,,-544726748.4599996,.
409000438620',2016-08-12,TRF TO  Indiaforensic SERVICES I,,2016-08-12,1000000.0,,-545726748.4599996,.
409000438620',2016-08-16,AEPS Indiaforensic INCOME 120816,,2016-08-16,,1761.4,-545724987.0599996,.
409000438620',2016-08-16,AEPS Indiaforensic S TAX 120816,,2016-08-16,,264.21,-545724722.8499995,.
409000438620',2016-08-16,AEPS Indiaforensic INCOME 130816,,2016-08-16,,857.12,-545723865.7299995,.
409000438620',2016-08-16,AEPS Indiaforensic S TAX 130816,,2016-08-16,,128.57,-545723737.1599995,.
409000438620',2016-08-16,AEPS Indiaforensic INCOME 140816,,2016-08-16,,670.65,-545723066.5099995,.
409000438620',2016-08-16,AEPS Indiaforensic S TAX 140816,,2016-08-16,,100.6,-545722965.9099995,.
409000438620',2016-08-16,AEPS Indiaforensic INCOME 150816,,2016-08-16,,458.8,-545722507.1099995,.
409000438620',2016-08-16,AEPS Indiaforensic S TAX 150816,,2016-08-16,,68.82,-545722438.2899995,.
409000438620',2016-08-16,Indiaforensic AEPS NPCI WDL SET,,2016-08-16,,213097.0,-545509341.2899995,.
409000438620',2016-08-16,Indiaforensic AEPS NPCI WDL SET,,2016-08-16,,110266.0,-545399075.2899995,.
409000438620',2016-08-16,Indiaforensic AEPS NPCI WDL SET,,2016-08-16,,77924.0,-545321151.2899995,.
409000438620',2016-08-16,Indiaforensic AEPS NPCI WDL SET,,2016-08-16,,73800.0,-545247351.2899995,.
409000438620',2016-08-16,Indiaforensic AEPS NPCI DEP SET,,2016-08-16,198310.0,,-545445661.2899995,.
409000438620',2016-08-16,Indiaforensic AEPS NPCI DEP SET,,2016-08-16,86800.0,,-545532461.2899995,.
409000438620',2016-08-16,Indiaforensic AEPS NPCI DEP SET,,2016-08-16,36400.0,,-545568861.2899995,.
409000438620',2016-08-16,Indiaforensic AEPS NPCI DEP SET,,2016-08-16,18900.0,,-545587761.2899995,.
409000438620',2016-08-18,Indiaforensic AEPS NPCI WDL SET,,2016-08-18,,149352.0,-545438409.2899995,.
409000438620',2016-08-18,Indiaforensic AEPS NPCI WDL SET,,2016-08-18,,108194.0,-545330215.2899995,.
409000438620',2016-08-18,Indiaforensic AEPS NPCI DEP SET,,2016-08-18,62400.0,,-545392615.2899995,.
409000438620',2016-08-18,Indiaforensic AEPS NPCI DEP SET,,2016-08-18,117120.0,,-545509735.2899995,.
409000438620',2016-08-18,AEPS Indiaforensic INCOME 160816,,2016-08-18,,1084.61,-545508650.6799995,.
409000438620',2016-08-18,AEPS Indiaforensic S TAX 160816,,2016-08-18,,162.69,-545508487.9899994,.
409000438620',2016-08-18,AEPS Indiaforensic INCOME 170816,,2016-08-18,,869.05,-545507618.9399995,.
409000438620',2016-08-18,AEPS Indiaforensic S TAX 170816,,2016-08-18,,130.36,-545507488.5799994,.
409000438620',2016-08-19,Indiaforensic AEPS NPCI DEP SET,,2016-08-19,103286.0,,-545610774.5799994,.
409000438620',2016-08-19,Indiaforensic AEPS NPCI WDL SET,,2016-08-19,,106603.0,-545504171.5799994,.
409000438620',2016-08-19,AEPS Indiaforensic INCOME 180816,,2016-08-19,,845.52,-545503326.0599995,.
409000438620',2016-08-19,AEPS Indiaforensic S TAX 180816,,2016-08-19,,126.83,-545503199.2299994,.
409000438620',2016-08-20,AEPS Indiaforensic INCOME 190816,,2016-08-20,,1035.39,-545502163.8399994,.
409000438620',2016-08-20,AEPS Indiaforensic S TAX 190816,,2016-08-20,,155.31,-545502008.5299995,.
409000438620',2016-08-20,Indiaforensic AEPS NPCI WDL SET,,2016-08-20,,148289.0,-545353719.5299995,.
409000438620',2016-08-20,Indiaforensic AEPS NPCI DEP SET,,2016-08-20,137000.0,,-545490719.5299995,.
409000438620',2016-08-22,AEPS Indiaforensic INCOME 200816,,2016-08-22,,431.55,-545490287.9799995,.
409000438620',2016-08-22,AEPS Indiaforensic S TAX 200816,,2016-08-22,,64.73,-545490223.2499995,.
409000438620',2016-08-22,AEPS Indiaforensic INCOME 210816,,2016-08-22,,441.49,-545489781.7599995,.
409000438620',2016-08-22,AEPS Indiaforensic S TAX 210816,,2016-08-22,,66.22,-545489715.5399995,.
409000438620',2016-08-22,Indiaforensic AEPS NPCI WDL SET,,2016-08-22,,33440.0,-545456275.5399995,.
409000438620',2016-08-22,Indiaforensic AEPS NPCI WDL SET,,2016-08-22,,111111.0,-545345164.5399995,.
409000438620',2016-08-22,Indiaforensic AEPS NPCI DEP SET,,2016-08-22,38210.0,,-545383374.5399995,.
409000438620',2016-08-22,Indiaforensic AEPS NPCI DEP SET,,2016-08-22,23800.0,,-545407174.5399995,.
409000438620',2016-08-23,AEPS Indiaforensic INCOME 220816,,2016-08-23,,768.48,-545406406.0599995,.
409000438620',2016-08-23,AEPS Indiaforensic S TAX 220816,,2016-08-23,,115.27,-545406290.7899995,.
409000438620',2016-08-23,Indiaforensic AEPS NPCI WDL SET,,2016-08-23,,117087.0,-545289203.7899995,.
409000438620',2016-08-23,Indiaforensic AEPS NPCI DEP SET,,2016-08-23,79251.0,,-545368454.7899995,.
409000438620',2016-08-24,Indiaforensic AEPS NPCI WDL SET,,2016-08-24,,135949.0,-545232505.7899995,.
409000438620',2016-08-24,Indiaforensic AEPS NPCI DEP SET,,2016-08-24,39672.0,,-545272177.7899995,.
409000438620',2016-08-24,AEPS Indiaforensic INCOME 230816,,2016-08-24,,990.63,-545271187.1599995,.
409000438620',2016-08-24,AEPS Indiaforensic S TAX 230816,,2016-08-24,,148.59,-545271038.5699995,.
409000438620',2016-08-25,AEPS Indiaforensic INCOME 240816,,2016-08-25,,722.6,-545270315.9699994,.
409000438620',2016-08-25,AEPS Indiaforensic S TAX 240816,,2016-08-25,,108.39,-545270207.5799994,.
409000438620',2016-08-25,Indiaforensic AEPS NPCI WDL SET,,2016-08-25,,75614.0,-545194593.5799994,.
409000438620',2016-08-25,Indiaforensic AEPS NPCI DEP SET,,2016-08-25,68810.0,,-545263403.5799994,.
409000438620',2016-08-26,AEPS Indiaforensic INCOME 250816,,2016-08-26,,469.55,-545262934.0299995,.
409000438620',2016-08-26,AEPS Indiaforensic S TAX 250816,,2016-08-26,,70.43,-545262863.5999995,.
409000438620',2016-08-26,Indiaforensic AEPS NPCI DEP SET,,2016-08-26,33602.0,,-545296465.5999995,.
409000438620',2016-08-26,Indiaforensic AEPS NPCI WDL SET,,2016-08-26,,79450.0,-545217015.5999995,.
409000438620',2016-08-29,AEPS Indiaforensic INCOME 260816,,2016-08-29,,697.15,-545216318.4499996,.
409000438620',2016-08-29,AEPS Indiaforensic S TAX 260816,,2016-08-29,,104.57,-545216213.8799995,.
409000438620',2016-08-29,AEPS Indiaforensic INCOME 270816,,2016-08-29,,663.67,-545215550.2099996,.
409000438620',2016-08-29,AEPS Indiaforensic S TAX 270816,,2016-08-29,,99.55,-545215450.6599996,.
409000438620',2016-08-29,AEPS Indiaforensic INCOME 280816,,2016-08-29,,320.92,-545215129.7399997,.
409000438620',2016-08-29,AEPS Indiaforensic S TAX 280816,,2016-08-29,,48.14,-545215081.5999997,.
409000438620',2016-08-29,Indiaforensic AEPS NPCI DEP SET,,2016-08-29,57000.0,,-545272081.5999997,.
409000438620',2016-08-29,Indiaforensic AEPS NPCI DEP SET,,2016-08-29,174585.0,,-545446666.5999997,.
409000438620',2016-08-29,Indiaforensic AEPS NPCI DEP SET,,2016-08-29,17000.0,,-545463666.5999997,.
409000438620',2016-08-29,Indiaforensic AEPS NPCI WDL SET,,2016-08-29,,147720.0,-545315946.5999997,.
409000438620',2016-08-29,Indiaforensic AEPS NPCI WDL SET,,2016-08-29,,63220.0,-545252726.5999997,.
409000438620',2016-08-29,Indiaforensic AEPS NPCI WDL SET,,2016-08-29,,49864.0,-545202862.5999997,.
409000438620',2016-08-30,AEPS Indiaforensic INCOME 290816,,2016-08-30,,713.75,-545202148.8499997,.
409000438620',2016-08-30,AEPS Indiaforensic S TAX 290816,,2016-08-30,,107.06,-545202041.7899997,.
409000438620',2016-08-30,Indiaforensic AEPS NPCI WDL SET,,2016-08-30,,84025.0,-545118016.7899997,.
409000438620',2016-08-30,Indiaforensic AEPS NPCI DEP SET,,2016-08-30,66700.0,,-545184716.7899997,.
409000438620',2016-08-31,AEPS Indiaforensic INCOME 300816,,2016-08-31,,1152.52,-545183564.2699997,.
409000438620',2016-08-31,AEPS Indiaforensic S TAX 300816,,2016-08-31,,172.88,-545183391.3899997,.
409000438620',2016-08-31,Indiaforensic AEPS NPCI DEP SET,,2016-08-31,57360.0,,-545240751.3899997,.
409000438620',2016-08-31,Indiaforensic AEPS NPCI WDL SET,,2016-08-31,,220049.0,-545020702.3899997,.
409000438620',2016-09-01,AEPS Indiaforensic INCOME 310816,,2016-09-01,,877.7,-545019824.6899997,.
409000438620',2016-09-01,AEPS Indiaforensic S TAX 310816,,2016-09-01,,131.66,-545019693.0299997,.
409000438620',2016-09-01,Indiaforensic AEPS NPCI WDL SET,,2016-09-01,,127006.0,-544892687.0299997,.
409000438620',2016-09-01,Indiaforensic AEPS NPCI DEP SET,,2016-09-01,158810.0,,-545051497.0299997,.
409000438620',2016-09-02,AEPS Indiaforensic INCOME 010916,,2016-09-02,,947.56,-545050549.4699998,.
409000438620',2016-09-02,AEPS Indiaforensic S TAX 010916,,2016-09-02,,142.13,-545050407.3399998,.
409000438620',2016-09-02,Indiaforensic AEPS NPCI WDL SET,,2016-09-02,,149034.0,-544901373.3399998,.
409000438620',2016-09-02,Indiaforensic AEPS NPCI DEP SET,,2016-09-02,123800.0,,-545025173.3399998,.
409000438620',2016-09-03,Indiaforensic AEPS NPCI WDL SET,,2016-09-03,,139366.0,-544885807.3399998,.
409000438620',2016-09-03,Indiaforensic AEPS NPCI DEP SET,,2016-09-03,68480.0,,-544954287.3399998,.
409000438620',2016-09-03,AEPS Indiaforensic INCOME 020916,,2016-09-03,,946.57,-544953340.7699997,.
409000438620',2016-09-03,AEPS Indiaforensic S TAX 020916,,2016-09-03,,141.98,-544953198.7899997,.
409000438620',2016-09-06,AEPS Indiaforensic INCOME 030916,,2016-09-06,,973.15,-544952225.6399997,.
409000438620',2016-09-06,AEPS Indiaforensic S TAX 030916,,2016-09-06,,145.97,-544952079.6699997,.
409000438620',2016-09-06,AEPS Indiaforensic INCOME 040916,,2016-09-06,,326.16,-544951753.5099998,.
409000438620',2016-09-06,AEPS Indiaforensic S TAX 040916,,2016-09-06,,48.92,-544951704.5899998,.
409000438620',2016-09-06,AEPS Indiaforensic INCOME 050916,,2016-09-06,,840.2,-544950864.3899997,.
409000438620',2016-09-06,AEPS Indiaforensic S TAX 050916,,2016-09-06,,126.03,-544950738.3599998,.
409000438620',2016-09-06,Indiaforensic AEPS NPCI WDL SET,,2016-09-06,,164492.0,-544786246.3599998,.
409000438620',2016-09-06,Indiaforensic AEPS NPCI DEP SET,,2016-09-06,39810.0,,-544826056.3599998,.
409000438620',2016-09-06,Indiaforensic AEPS NPCI DEP SET,,2016-09-06,29110.0,,-544855166.3599998,.
409000438620',2016-09-06,Indiaforensic AEPS NPCI WDL SET,,2016-09-06,,44256.0,-544810910.3599998,.
409000438620',2016-09-06,Indiaforensic AEPS NPCI WDL SET,,2016-09-06,,150374.0,-544660536.3599998,.
409000438620',2016-09-06,Indiaforensic AEPS NPCI DEP SET,,2016-09-06,74300.0,,-544734836.3599998,.
409000438620',2016-09-07,AEPS Indiaforensic INCOME 060916,,2016-09-07,,1419.7,-544733416.6599997,.
409000438620',2016-09-07,AEPS Indiaforensic S TAX 060916,,2016-09-07,,212.96,-544733203.6999997,.
409000438620',2016-09-07,Indiaforensic AEPS NPCI WDL SET,,2016-09-07,,231453.0,-544501750.6999997,.
409000438620',2016-09-07,Indiaforensic AEPS NPCI DEP SET,,2016-09-07,106885.0,,-544608635.6999997,.
409000438620',2016-09-08,AEPS Indiaforensic INCOME 070916,,2016-09-08,,1034.65,-544607601.0499997,.
409000438620',2016-09-08,AEPS Indiaforensic S TAX 070916,,2016-09-08,,155.2,-544607445.8499997,.
409000438620',2016-09-08,Indiaforensic AEPS NPCI DEP SET,,2016-09-08,56109.0,,-544663554.8499997,.
409000438620',2016-09-08,Indiaforensic AEPS NPCI WDL SET,,2016-09-08,,173986.0,-544489568.8499997,.
409000438620',2016-09-09,AEPS Indiaforensic INCOME 080916,,2016-09-09,,1082.49,-544488486.3599997,.
409000438620',2016-09-09,AEPS Indiaforensic S TAX 080916,,2016-09-09,,162.37,-544488323.9899997,.
409000438620',2016-09-09,Indiaforensic AEPS NPCI DEP SET,,2016-09-09,130725.0,,-544619048.9899997,.
409000438620',2016-09-09,Indiaforensic AEPS NPCI WDL SET,,2016-09-09,,179554.0,-544439494.9899997,.
409000438620',2016-09-12,AEPS Indiaforensic INCOME 090916,,2016-09-12,,1430.02,-544438064.9699997,.
409000438620',2016-09-12,AEPS Indiaforensic S TAX 090916,,2016-09-12,,214.5,-544437850.4699997,.
409000438620',2016-09-12,AEPS Indiaforensic INCOME 100916,,2016-09-12,,588.51,-544437261.9599997,.
409000438620',2016-09-12,AEPS Indiaforensic S TAX 100916,,2016-09-12,,88.28,-544437173.6799997,.
409000438620',2016-09-12,AEPS Indiaforensic INCOME 110916,,2016-09-12,,1166.56,-544436007.1199998,.
409000438620',2016-09-12,AEPS Indiaforensic S TAX 110916,,2016-09-12,,174.98,-544435832.1399997,.
409000438620',2016-09-12,Indiaforensic AEPS NPCI WDL SET,,2016-09-12,,332230.0,-544103602.1399997,.
409000438620',2016-09-12,Indiaforensic AEPS NPCI DEP SET,,2016-09-12,135527.0,,-544239129.1399997,.
409000438620',2016-09-12,Indiaforensic AEPS NPCI DEP SET,,2016-09-12,14400.0,,-544253529.1399997,.
409000438620',2016-09-12,Indiaforensic AEPS NPCI WDL SET,,2016-09-12,,94022.0,-544159507.1399997,.
409000438620',2016-09-12,Indiaforensic AEPS NPCI WDL SET,,2016-09-12,,152354.0,-544007153.1399997,.
409000438620',2016-09-12,Indiaforensic AEPS NPCI DEP SET,,2016-09-12,29644.0,,-544036797.1399997,.
409000438620',2016-09-12,TRF TO  Indiaforensic SERVICES I,,2016-09-12,2000000.0,,-546036797.1399997,.
409000438620',2016-09-14,AEPS Indiaforensic INCOME 120916,,2016-09-14,,1827.98,-546034969.1599997,.
409000438620',2016-09-14,AEPS Indiaforensic S TAX 120916,,2016-09-14,,274.2,-546034694.9599997,.
409000438620',2016-09-14,AEPS Indiaforensic INCOME 130916,,2016-09-14,,386.72,-546034308.2399997,.
409000438620',2016-09-14,AEPS Indiaforensic S TAX 130916,,2016-09-14,,58.01,-546034250.2299997,.
409000438620',2016-09-14,Indiaforensic AEPS NPCI WDL SET,,2016-09-14,,282813.0,-545751437.2299997,.
409000438620',2016-09-14,Indiaforensic AEPS NPCI DEP SET,,2016-09-14,37767.0,,-545789204.2299997,.
409000438620',2016-09-14,Indiaforensic AEPS NPCI DEP SET,,2016-09-14,152800.0,,-545942004.2299997,.
409000438620',2016-09-14,Indiaforensic AEPS NPCI WDL SET,,2016-09-14,,62554.0,-545879450.2299997,.
409000438620',2016-09-15,AEPS Indiaforensic INCOME 140916,,2016-09-15,,961.13,-545878489.0999997,.
409000438620',2016-09-15,AEPS Indiaforensic S TAX 140916,,2016-09-15,,144.17,-545878344.9299997,.
409000438620',2016-09-15,Indiaforensic AEPS NPCI DEP SET,,2016-09-15,125310.0,,-546003654.9299997,.
409000438620',2016-09-15,Indiaforensic AEPS NPCI WDL SET,,2016-09-15,,139968.0,-545863686.9299997,.
409000438620',2016-09-16,AEPS Indiaforensic INCOME 150916,,2016-09-16,,930.87,-545862756.0599997,.
409000438620',2016-09-16,AEPS Indiaforensic S TAX 150916,,2016-09-16,,139.63,-545862616.4299997,.
409000438620',2016-09-16,Indiaforensic AEPS NPCI DEP SET,,2016-09-16,110465.0,,-545973081.4299997,.
409000438620',2016-09-16,Indiaforensic AEPS NPCI WDL SET,,2016-09-16,,157492.0,-545815589.4299997,.
409000438620',2016-09-17,AEPS Indiaforensic INCOME 160916,,2016-09-17,,1437.2,-545814152.2299997,.
409000438620',2016-09-17,AEPS Indiaforensic S TAX 160916,,2016-09-17,,215.58,-545813936.6499996,.
409000438620',2016-09-17,Indiaforensic AEPS NPCI DEP SET,,2016-09-17,174060.0,,-545987996.6499996,.
409000438620',2016-09-17,Indiaforensic AEPS NPCI WDL SET,,2016-09-17,,192508.0,-545795488.6499996,.
409000438620',2016-09-19,AEPS Indiaforensic INCOME 170916,,2016-09-19,,2050.77,-545793437.8799996,.
409000438620',2016-09-19,AEPS Indiaforensic S TAX 170916,,2016-09-19,,307.62,-545793130.2599996,.
409000438620',2016-09-19,AEPS Indiaforensic INCOME 180916,,2016-09-19,,801.91,-545792328.3499997,.
409000438620',2016-09-19,AEPS Indiaforensic S TAX 180916,,2016-09-19,,120.29,-545792208.0599997,.
409000438620',2016-09-19,Indiaforensic AEPS NPCI WDL SET,,2016-09-19,,188080.0,-545604128.0599997,.
409000438620',2016-09-19,Indiaforensic AEPS NPCI WDL SET,,2016-09-19,,69670.0,-545534458.0599997,.
409000438620',2016-09-19,Indiaforensic AEPS NPCI DEP SET,,2016-09-19,186604.0,,-545721062.0599997,.
409000438620',2016-09-19,Indiaforensic AEPS NPCI DEP SET,,2016-09-19,60950.0,,-545782012.0599997,.
409000438620',2016-09-20,AEPS Indiaforensic INCOME 190916,,2016-09-20,,1604.86,-545780407.1999997,.
409000438620',2016-09-20,AEPS Indiaforensic S TAX 190916,,2016-09-20,,240.73,-545780166.4699997,.
409000438620',2016-09-20,Indiaforensic AEPS NPCI WDL SET,,2016-09-20,,303053.0,-545477113.4699997,.
409000438620',2016-09-20,Indiaforensic AEPS NPCI DEP SET,,2016-09-20,115390.0,,-545592503.4699997,.
409000438620',2016-09-21,AEPS Indiaforensic INCOME 200916,,2016-09-21,,1256.8,-545591246.6699997,.
409000438620',2016-09-21,AEPS Indiaforensic S TAX 200916,,2016-09-21,,188.52,-545591058.1499997,.
409000438620',2016-09-21,Indiaforensic AEPS NPCI DEP SET,,2016-09-21,144950.0,,-545736008.1499997,.
409000438620',2016-09-21,Indiaforensic AEPS NPCI WDL SET,,2016-09-21,,165037.0,-545570971.1499997,.
409000438620',2016-09-22,Indiaforensic AEPS NPCI WDL SET,,2016-09-22,,145329.0,-545425642.1499997,.
409000438620',2016-09-22,Indiaforensic AEPS NPCI DEP SET,,2016-09-22,143433.0,,-545569075.1499997,.
409000438620',2016-09-22,AEPS Indiaforensic INCOME 210916,,2016-09-22,,1143.69,-545567931.4599997,.
409000438620',2016-09-22,AEPS Indiaforensic S TAX 210916,,2016-09-22,,171.55,-545567759.9099997,.
409000438620',2016-09-23,AEPS Indiaforensic INCOME 220916,,2016-09-23,,1324.08,-545566435.8299997,.
409000438620',2016-09-23,AEPS Indiaforensic S TAX 220916,,2016-09-23,,198.61,-545566237.2199997,.
409000438620',2016-09-23,Indiaforensic AEPS NPCI WDL SET,,2016-09-23,,193230.0,-545373007.2199997,.
409000438620',2016-09-23,Indiaforensic AEPS NPCI DEP SET,,2016-09-23,120950.0,,-545493957.2199997,.
409000438620',2016-09-26,AEPS Indiaforensic INCOME 230916,,2016-09-26,,1787.3,-545492169.9199997,.
409000438620',2016-09-26,AEPS Indiaforensic S TAX 230916,,2016-09-26,,268.1,-545491901.8199997,.
409000438620',2016-09-26,AEPS Indiaforensic INCOME 240916,,2016-09-26,,1066.76,-545490835.0599997,.
409000438620',2016-09-26,AEPS Indiaforensic S TAX 240916,,2016-09-26,,160.01,-545490675.0499997,.
409000438620',2016-09-26,AEPS Indiaforensic INCOME 250916,,2016-09-26,,909.7,-545489765.3499997,.
409000438620',2016-09-26,AEPS Indiaforensic S TAX 250916,,2016-09-26,,136.46,-545489628.8899996,.
409000438620',2016-09-26,Indiaforensic AEPS NPCI WDL SET,,2016-09-26,,180589.0,-545309039.8899996,.
409000438620',2016-09-26,Indiaforensic AEPS NPCI DEP SET,,2016-09-26,130300.0,,-545439339.8899996,.
409000438620',2016-09-26,Indiaforensic AEPS NPCI DEP SET,,2016-09-26,126848.0,,-545566187.8899996,.
409000438620',2016-09-26,Indiaforensic AEPS NPCI DEP SET,,2016-09-26,129228.0,,-545695415.8899996,.
409000438620',2016-09-26,Indiaforensic AEPS NPCI WDL SET,,2016-09-26,,259664.0,-545435751.8899996,.
409000438620',2016-09-26,Indiaforensic AEPS NPCI WDL SET,,2016-09-26,,204314.0,-545231437.8899996,.
409000438620',2016-09-27,Indiaforensic AEPS NPCI DEP SET,,2016-09-27,110630.0,,-545342067.8899996,.
409000438620',2016-09-27,Indiaforensic AEPS NPCI WDL SET,,2016-09-27,,215374.0,-545126693.8899996,.
409000438620',2016-09-27,AEPS Indiaforensic INCOME 260916,,2016-09-27,,1435.81,-545125258.0799997,.
409000438620',2016-09-27,AEPS Indiaforensic S TAX 260916,,2016-09-27,,215.37,-545125042.7099997,.
409000438620',2016-09-28,AEPS Indiaforensic INCOME 270916,,2016-09-28,,1600.95,-545123441.7599996,.
409000438620',2016-09-28,AEPS Indiaforensic S TAX 270916,,2016-09-28,,240.14,-545123201.6199996,.
409000438620',2016-09-28,AEPS Indiaforensic INCOME 170916,,2016-09-28,2.25,,-545123203.8699996,.
409000438620',2016-09-28,AEPS Indiaforensic S TAX 170916,,2016-09-28,0.34,,-545123204.2099997,.
409000438620',2016-09-28,Indiaforensic AEPS NPCI DEP SET,,2016-09-28,169648.0,,-545292852.2099997,.
409000438620',2016-09-28,Indiaforensic AEPS NPCI WDL SET,,2016-09-28,,272820.0,-545020032.2099997,.
409000438620',2016-09-29,AEPS Indiaforensic INCOME 280916,,2016-09-29,,1030.13,-545019002.0799997,.
409000438620',2016-09-29,AEPS Indiaforensic S TAX 280916,,2016-09-29,,154.52,-545018847.5599997,.
409000438620',2016-09-29,Indiaforensic AEPS NPCI DEP SET,,2016-09-29,87541.0,,-545106388.5599997,.
409000438620',2016-09-29,Indiaforensic AEPS NPCI WDL SET,,2016-09-29,,192377.0,-544914011.5599997,.
409000438620',2016-09-30,AEPS Indiaforensic INCOME 290916,,2016-09-30,,813.63,-544913197.9299997,.
409000438620',2016-09-30,AEPS Indiaforensic S TAX 290916,,2016-09-30,,122.04,-544913075.8899997,.
409000438620',2016-09-30,Indiaforensic AEPS NPCI WDL SET,,2016-09-30,,144812.0,-544768263.8899997,.
409000438620',2016-09-30,Indiaforensic AEPS NPCI DEP SET,,2016-09-30,69401.0,,-544837664.8899997,.
409000438620',2016-09-30,TRF TO  Indiaforensic SERVICES I,,2016-09-30,1300000.0,,-546137664.8899997,.
409000438620',2016-10-01,AEPS Indiaforensic INCOME 300916,,2016-10-01,,1021.0,-546136643.8899997,.
409000438620',2016-10-01,AEPS Indiaforensic S TAX 300916,,2016-10-01,,153.15,-546136490.7399998,.
409000438620',2016-10-01,Indiaforensic AEPS NPCI DEP SET,,2016-10-01,73010.0,,-546209500.7399998,.
409000438620',2016-10-01,Indiaforensic AEPS NPCI WDL SET,,2016-10-01,,253032.0,-545956468.7399998,.
409000438620',2016-10-03,AEPS Indiaforensic INCOME 011016,,2016-10-03,,1883.65,-545954585.0899998,.
409000438620',2016-10-03,AEPS Indiaforensic S TAX 011016,,2016-10-03,,282.55,-545954302.5399998,.
409000438620',2016-10-03,AEPS Indiaforensic INCOME 021016,,2016-10-03,,954.76,-545953347.7799999,.
409000438620',2016-10-03,AEPS Indiaforensic S TAX 021016,,2016-10-03,,143.21,-545953204.5699998,.
409000438620',2016-10-03,Indiaforensic AEPS NPCI DEP SET,,2016-10-03,100955.0,,-546054159.5699998,.
409000438620',2016-10-03,Indiaforensic AEPS NPCI WDL SET,,2016-10-03,,131109.0,-545923050.5699998,.
409000438620',2016-10-03,Indiaforensic AEPS NPCI WDL SET,,2016-10-03,,346296.0,-545576754.5699998,.
409000438620',2016-10-03,Indiaforensic AEPS NPCI DEP SET,,2016-10-03,160060.0,,-545736814.5699998,.
409000438620',2016-10-04,AEPS Indiaforensic INCOME 031016,,2016-10-04,,1237.32,-545735577.2499998,.
409000438620',2016-10-04,AEPS Indiaforensic S TAX 031016,,2016-10-04,,185.6,-545735391.6499997,.
409000438620',2016-10-04,Indiaforensic AEPS NPCI DEP SET,,2016-10-04,62447.0,,-545797838.6499997,.
409000438620',2016-10-04,Indiaforensic AEPS NPCI WDL SET,,2016-10-04,,183296.0,-545614542.6499997,.
409000438620',2016-10-05,AEPS Indiaforensic INCOME 041016,,2016-10-05,,1443.59,-545613099.0599997,.
409000438620',2016-10-05,AEPS Indiaforensic S TAX 041016,,2016-10-05,,216.54,-545612882.5199997,.
409000438620',2016-10-05,Indiaforensic AEPS NPCI DEP SET,,2016-10-05,209598.0,,-545822480.5199997,.
409000438620',2016-10-05,Indiaforensic AEPS NPCI WDL SET,,2016-10-05,,288796.0,-545533684.5199997,.
409000438620',2016-10-06,AEPS Indiaforensic INCOME 051016,,2016-10-06,,1795.26,-545531889.2599998,.
409000438620',2016-10-06,AEPS Indiaforensic S TAX 051016,,2016-10-06,,269.29,-545531619.9699998,.
409000438620',2016-10-06,Indiaforensic AEPS NPCI WDL SET,,2016-10-06,,315890.0,-545215729.9699998,.
409000438620',2016-10-06,Indiaforensic AEPS NPCI DEP SET,,2016-10-06,203150.0,,-545418879.9699998,.
409000438620',2016-10-07,AEPS Indiaforensic INCOME 061016,,2016-10-07,,1377.49,-545417502.4799998,.
409000438620',2016-10-07,AEPS Indiaforensic S TAX 061016,,2016-10-07,,206.62,-545417295.8599998,.
409000438620',2016-10-07,Indiaforensic AEPS NPCI WDL SET,,2016-10-07,,263106.0,-545154189.8599998,.
409000438620',2016-10-07,Indiaforensic AEPS NPCI DEP SET,,2016-10-07,161682.0,,-545315871.8599998,.
409000438620',2016-10-07,TRF TO  Indiaforensic SERVICES I,,2016-10-07,950000.0,,-546265871.8599998,.
409000438620',2016-10-10,AEPS Indiaforensic INCOME 071016,,2016-10-10,,1879.74,-546263992.1199998,.
409000438620',2016-10-10,AEPS Indiaforensic S TAX 071016,,2016-10-10,,281.96,-546263710.1599997,.
409000438620',2016-10-10,AEPS Indiaforensic INCOME 081016,,2016-10-10,,1408.93,-546262301.2299998,.
409000438620',2016-10-10,AEPS Indiaforensic S TAX 081016,,2016-10-10,,211.34,-546262089.8899997,.
409000438620',2016-10-10,AEPS Indiaforensic INCOME 091016,,2016-10-10,,1324.71,-546260765.1799997,.
409000438620',2016-10-10,AEPS Indiaforensic S TAX 091016,,2016-10-10,,198.71,-546260566.4699997,.
409000438620',2016-10-10,Indiaforensic AEPS NPCI WDL SET,,2016-10-10,,425680.0,-545834886.4699997,.
409000438620',2016-10-10,Indiaforensic AEPS NPCI WDL SET,,2016-10-10,,375222.0,-545459664.4699997,.
409000438620',2016-10-10,Indiaforensic AEPS NPCI WDL SET,,2016-10-10,,231906.0,-545227758.4699997,.
409000438620',2016-10-10,Indiaforensic AEPS NPCI DEP SET,,2016-10-10,131871.0,,-545359629.4699997,.
409000438620',2016-10-10,Indiaforensic AEPS NPCI DEP SET,,2016-10-10,128221.0,,-545487850.4699997,.
409000438620',2016-10-10,Indiaforensic AEPS NPCI DEP SET,,2016-10-10,126428.0,,-545614278.4699997,.
409000438620',2016-10-13,AEPS Indiaforensic INCOME 101016,,2016-10-13,,1568.19,-545612710.2799996,.
409000438620',2016-10-13,AEPS Indiaforensic S TAX 101016,,2016-10-13,,235.23,-545612475.0499996,.
409000438620',2016-10-13,AEPS Indiaforensic INCOME 111016,,2016-10-13,,682.34,-545611792.7099996,.
409000438620',2016-10-13,AEPS Indiaforensic S TAX 111016,,2016-10-13,,102.35,-545611690.3599995,.
409000438620',2016-10-13,AEPS Indiaforensic INCOME 121016,,2016-10-13,,486.82,-545611203.5399995,.
409000438620',2016-10-13,AEPS Indiaforensic S TAX 121016,,2016-10-13,,73.02,-545611130.5199995,.
409000438620',2016-10-13,Indiaforensic AEPS NPCI WDL SET,,2016-10-13,,145955.0,-545465175.5199995,.
409000438620',2016-10-13,Indiaforensic AEPS NPCI WDL SET,,2016-10-13,,347742.0,-545117433.5199995,.
409000438620',2016-10-13,Indiaforensic AEPS NPCI DEP SET,,2016-10-13,61510.0,,-545178943.5199995,.
409000438620',2016-10-13,Indiaforensic AEPS NPCI DEP SET,,2016-10-13,107996.0,,-545286939.5199995,.
409000438620',2016-10-13,Indiaforensic AEPS NPCI WDL SET,,2016-10-13,,52947.0,-545233992.5199995,.
409000438620',2016-10-13,Indiaforensic AEPS NPCI DEP SET,,2016-10-13,50780.0,,-545284772.5199995,.
409000438620',2016-10-14,AEPS Indiaforensic INCOME 131016,,2016-10-14,,1671.54,-545283100.9799995,.
409000438620',2016-10-14,AEPS Indiaforensic S TAX 131016,,2016-10-14,,250.73,-545282850.2499995,.
409000438620',2016-10-14,Indiaforensic AEPS NPCI DEP SET,,2016-10-14,150393.0,,-545433243.2499995,.
409000438620',2016-10-14,Indiaforensic AEPS NPCI WDL SET,,2016-10-14,,405177.0,-545028066.2499995,.
409000438620',2016-10-15,AEPS Indiaforensic INCOME 141016,,2016-10-15,,1673.8,-545026392.4499996,.
409000438620',2016-10-15,AEPS Indiaforensic S TAX 141016,,2016-10-15,,251.07,-545026141.3799995,.
409000438620',2016-10-15,Indiaforensic AEPS NPCI WDL SET,,2016-10-15,,352921.0,-544673220.3799995,.
409000438620',2016-10-15,Indiaforensic AEPS NPCI DEP SET,,2016-10-15,196924.0,,-544870144.3799995,.
409000438620',2016-10-17,AEPS Indiaforensic INCOME 151016,,2016-10-17,,2743.69,-544867400.6899995,.
409000438620',2016-10-17,AEPS Indiaforensic S TAX 151016,,2016-10-17,,411.55,-544866989.1399995,.
409000438620',2016-10-17,AEPS Indiaforensic INCOME 161016,,2016-10-17,,1473.23,-544865515.9099995,.
409000438620',2016-10-17,AEPS Indiaforensic S TAX 161016,,2016-10-17,,220.98,-544865294.9299995,.
409000438620',2016-10-17,Indiaforensic AEPS NPCI WDL SET,,2016-10-17,,218220.0,-544647074.9299995,.
409000438620',2016-10-17,Indiaforensic AEPS NPCI DEP SET,,2016-10-17,149527.0,,-544796601.9299995,.
409000438620',2016-10-17,Indiaforensic AEPS NPCI WDL SET,,2016-10-17,,513111.0,-544283490.9299995,.
409000438620',2016-10-17,Indiaforensic AEPS NPCI DEP SET,,2016-10-17,382169.0,,-544665659.9299995,.
409000438620',2016-10-18,AEPS Indiaforensic INCOME 171016,,2016-10-18,,2106.25,-544663553.6799995,.
409000438620',2016-10-18,AEPS Indiaforensic S TAX 171016,,2016-10-18,,315.94,-544663237.7399994,.
409000438620',2016-10-18,Indiaforensic AEPS NPCI DEP SET,,2016-10-18,231650.0,,-544894887.7399994,.
409000438620',2016-10-18,Indiaforensic AEPS NPCI WDL SET,,2016-10-18,,403532.0,-544491355.7399994,.
409000438620',2016-10-19,AEPS Indiaforensic INCOME 181016,,2016-10-19,,2590.0,-544488765.7399994,.
409000438620',2016-10-19,AEPS Indiaforensic S TAX 181016,,2016-10-19,,388.5,-544488377.2399994,.
409000438620',2016-10-19,Indiaforensic AEPS NPCI WDL SET,,2016-10-19,,412653.0,-544075724.2399994,.
409000438620',2016-10-19,Indiaforensic AEPS NPCI DEP SET,,2016-10-19,281930.0,,-544357654.2399994,.
409000438620',2016-10-20,AEPS Indiaforensic INCOME 191016,,2016-10-20,,3847.64,-544353806.5999994,.
409000438620',2016-10-20,AEPS Indiaforensic S TAX 191016,,2016-10-20,,577.15,-544353229.4499995,.
409000438620',2016-10-20,Indiaforensic AEPS NPCI DEP SET,,2016-10-20,346370.0,,-544699599.4499995,.
409000438620',2016-10-20,Indiaforensic AEPS NPCI WDL SET,,2016-10-20,,691373.0,-544008226.4499995,.
409000438620',2016-10-21,AEPS Indiaforensic INCOME 201016,,2016-10-21,,2943.05,-544005283.3999995,.
409000438620',2016-10-21,AEPS Indiaforensic S TAX 201016,,2016-10-21,,441.46,-544004841.9399995,.
409000438620',2016-10-21,Indiaforensic AEPS NPCI WDL SET,,2016-10-21,,450631.0,-543554210.9399995,.
409000438620',2016-10-21,Indiaforensic AEPS NPCI DEP SET,,2016-10-21,424267.0,,-543978477.9399995,.
409000438620',2016-10-21,TRF TO  Indiaforensic SERVICES I,,2016-10-21,2000000.0,,-545978477.9399995,.
409000438620',2016-10-24,AEPS Indiaforensic INCOME 211016,,2016-10-24,,2306.95,-545976170.9899994,.
409000438620',2016-10-24,AEPS Indiaforensic S TAX 211016,,2016-10-24,,346.04,-545975824.9499995,.
409000438620',2016-10-24,AEPS Indiaforensic INCOME 221016,,2016-10-24,,2504.39,-545973320.5599995,.
409000438620',2016-10-24,AEPS Indiaforensic S TAX 221016,,2016-10-24,,375.66,-545972944.8999995,.
409000438620',2016-10-24,AEPS Indiaforensic INCOME 231016,,2016-10-24,,1953.02,-545970991.8799995,.
409000438620',2016-10-24,AEPS Indiaforensic S TAX 231016,,2016-10-24,,292.95,-545970698.9299995,.
409000438620',2016-10-24,Indiaforensic AEPS NPCI DEP SET,,2016-10-24,255701.0,,-546226399.9299995,.
409000438620',2016-10-24,Indiaforensic AEPS NPCI WDL SET,,2016-10-24,,334021.0,-545892378.9299995,.
409000438620',2016-10-24,Indiaforensic AEPS NPCI WDL SET,,2016-10-24,,464092.0,-545428286.9299995,.
409000438620',2016-10-24,Indiaforensic AEPS NPCI DEP SET,,2016-10-24,284973.0,,-545713259.9299995,.
409000438620',2016-10-24,Indiaforensic AEPS NPCI DEP SET,,2016-10-24,169140.0,,-545882399.9299995,.
409000438620',2016-10-24,Indiaforensic AEPS NPCI WDL SET,,2016-10-24,,212010.0,-545670389.9299995,.
409000438620',2016-10-25,AEPS Indiaforensic INCOME 241016,,2016-10-25,,2818.43,-545667571.4999995,.
409000438620',2016-10-25,AEPS Indiaforensic S TAX 241016,,2016-10-25,,422.76,-545667148.7399995,.
409000438620',2016-10-25,Indiaforensic AEPS NPCI WDL SET,,2016-10-25,,456957.0,-545210191.7399995,.
409000438620',2016-10-25,Indiaforensic AEPS NPCI DEP SET,,2016-10-25,295302.0,,-545505493.7399995,.
409000438620',2016-10-26,AEPS Indiaforensic INCOME 251016,,2016-10-26,,3251.4,-545502242.3399996,.
409000438620',2016-10-26,AEPS Indiaforensic S TAX 251016,,2016-10-26,,487.71,-545501754.6299995,.
409000438620',2016-10-26,Indiaforensic AEPS NPCI WDL SET,,2016-10-26,,682008.0,-544819746.6299995,.
409000438620',2016-10-26,Indiaforensic AEPS NPCI DEP SET,,2016-10-26,399690.0,,-545219436.6299995,.
409000438620',2016-10-27,AEPS Indiaforensic INCOME 261016,,2016-10-27,,3059.22,-545216377.4099995,.
409000438620',2016-10-27,AEPS Indiaforensic S TAX 261016,,2016-10-27,,458.88,-545215918.5299995,.
409000438620',2016-10-27,Indiaforensic AEPS NPCI DEP SET,,2016-10-27,299376.0,,-545515294.5299995,.
409000438620',2016-10-27,Indiaforensic AEPS NPCI WDL SET,,2016-10-27,,431010.0,-545084284.5299995,.
409000438620',2016-10-28,AEPS Indiaforensic INCOME 271016,,2016-10-28,,3738.98,-545080545.5499995,.
409000438620',2016-10-28,AEPS Indiaforensic S TAX 271016,,2016-10-28,,560.85,-545079984.6999995,.
409000438620',2016-10-28,Indiaforensic AEPS NPCI DEP SET,,2016-10-28,429620.0,,-545509604.6999995,.
409000438620',2016-10-28,Indiaforensic AEPS NPCI WDL SET,,2016-10-28,,560992.0,-544948612.6999995,.
409000438620',2016-10-29,AEPS Indiaforensic INCOME 281016,,2016-10-29,,3281.55,-544945331.1499995,.
409000438620',2016-10-29,AEPS Indiaforensic S TAX 281016,,2016-10-29,,492.23,-544944838.9199995,.
409000438620',2016-10-29,Indiaforensic AEPS NPCI DEP SET,,2016-10-29,316020.0,,-545260858.9199995,.
409000438620',2016-10-29,Indiaforensic AEPS NPCI WDL SET,,2016-10-29,,491177.0,-544769681.9199995,.
409000438620',2016-11-01,AEPS Indiaforensic INCOME 291016,,2016-11-01,,2942.26,-544766739.6599995,.
409000438620',2016-11-01,AEPS Indiaforensic S TAX 291016,,2016-11-01,,441.34,-544766298.3199995,.
409000438620',2016-11-01,AEPS Indiaforensic INCOME 301016,,2016-11-01,,2190.43,-544764107.8899995,.
409000438620',2016-11-01,AEPS Indiaforensic S TAX 301016,,2016-11-01,,328.56,-544763779.3299996,.
409000438620',2016-11-01,AEPS Indiaforensic INCOME 311016,,2016-11-01,,2221.01,-544761558.3199996,.
409000438620',2016-11-01,AEPS Indiaforensic S TAX 311016,,2016-11-01,,333.15,-544761225.1699996,.
409000438620',2016-11-01,Indiaforensic AEPS NPCI WDL SET,,2016-11-01,,379650.0,-544381575.1699996,.
409000438620',2016-11-01,Indiaforensic AEPS NPCI DEP SET,,2016-11-01,319905.0,,-544701480.1699996,.
409000438620',2016-11-01,Indiaforensic AEPS NPCI DEP SET,,2016-11-01,180044.0,,-544881524.1699996,.
409000438620',2016-11-01,Indiaforensic AEPS NPCI WDL SET,,2016-11-01,,294100.0,-544587424.1699996,.
409000438620',2016-11-01,Indiaforensic AEPS NPCI WDL SET,,2016-11-01,,257055.0,-544330369.1699996,.
409000438620',2016-11-01,Indiaforensic AEPS NPCI DEP SET,,2016-11-01,220201.0,,-544550570.1699996,.
409000438620',2016-11-02,AEPS Indiaforensic INCOME 011116,,2016-11-02,,1549.83,-544549020.3399996,.
409000438620',2016-11-02,AEPS Indiaforensic S TAX 011116,,2016-11-02,,232.47,-544548787.8699995,.
409000438620',2016-11-02,Indiaforensic AEPS NPCI DEP SET,,2016-11-02,133520.0,,-544682307.8699995,.
409000438620',2016-11-02,Indiaforensic AEPS NPCI WDL SET,,2016-11-02,,216813.0,-544465494.8699995,.
409000438620',2016-11-03,AEPS Indiaforensic INCOME 021116,,2016-11-03,,2036.58,-544463458.2899995,.
409000438620',2016-11-03,AEPS Indiaforensic S TAX 021116,,2016-11-03,,305.49,-544463152.7999995,.
409000438620',2016-11-03,Indiaforensic AEPS NPCI WDL SET,,2016-11-03,,262974.0,-544200178.7999995,.
409000438620',2016-11-03,Indiaforensic AEPS NPCI DEP SET,,2016-11-03,146745.0,,-544346923.7999995,.
409000438620',2016-11-04,AEPS Indiaforensic INCOME 031116,,2016-11-04,,3415.77,-544343508.0299995,.
409000438620',2016-11-04,AEPS Indiaforensic S TAX 031116,,2016-11-04,,512.37,-544342995.6599995,.
409000438620',2016-11-04,Indiaforensic AEPS NPCI WDL SET,,2016-11-04,,393765.0,-543949230.6599995,.
409000438620',2016-11-04,Indiaforensic AEPS NPCI DEP SET,,2016-11-04,304510.0,,-544253740.6599995,.
409000438620',2016-11-05,AEPS Indiaforensic INCOME 041116,,2016-11-05,,2982.05,-544250758.6099995,.
409000438620',2016-11-05,AEPS Indiaforensic S TAX 041116,,2016-11-05,,447.31,-544250311.2999996,.
409000438620',2016-11-05,Indiaforensic AEPS NPCI WDL SET,,2016-11-05,,365535.0,-543884776.2999996,.
409000438620',2016-11-05,Indiaforensic AEPS NPCI DEP SET,,2016-11-05,316565.0,,-544201341.2999996,.
409000438620',2016-11-07,AEPS Indiaforensic INCOME 051116,,2016-11-07,,2530.78,-544198810.5199996,.
409000438620',2016-11-07,AEPS Indiaforensic S TAX 051116,,2016-11-07,,379.62,-544198430.8999996,.
409000438620',2016-11-07,AEPS Indiaforensic INCOME 061116,,2016-11-07,,2491.76,-544195939.1399996,.
409000438620',2016-11-07,AEPS Indiaforensic S TAX 061116,,2016-11-07,,373.76,-544195565.3799996,.
409000438620',2016-11-07,Indiaforensic AEPS NPCI DEP SET,,2016-11-07,273412.0,,-544468977.3799996,.
409000438620',2016-11-07,Indiaforensic AEPS NPCI WDL SET,,2016-11-07,,339623.0,-544129354.3799996,.
409000438620',2016-11-07,Indiaforensic AEPS NPCI DEP SET,,2016-11-07,139400.0,,-544268754.3799996,.
409000438620',2016-11-07,Indiaforensic AEPS NPCI WDL SET,,2016-11-07,,221963.0,-544046791.3799996,.
409000438620',2016-11-08,AEPS Indiaforensic INCOME 071116,,2016-11-08,,2183.15,-544044608.2299997,.
409000438620',2016-11-08,AEPS Indiaforensic S TAX 071116,,2016-11-08,,327.47,-544044280.7599996,.
409000438620',2016-11-08,Indiaforensic AEPS NPCI DEP SET,,2016-11-08,217950.0,,-544262230.7599996,.
409000438620',2016-11-08,Indiaforensic AEPS NPCI WDL SET,,2016-11-08,,242350.0,-544019880.7599996,.
409000438620',2016-11-09,AEPS Indiaforensic INCOME 081116,,2016-11-09,,3004.07,-544016876.6899996,.
409000438620',2016-11-09,AEPS Indiaforensic S TAX 081116,,2016-11-09,,450.61,-544016426.0799996,.
409000438620',2016-11-09,Indiaforensic AEPS NPCI WDL SET,,2016-11-09,,435600.0,-543580826.0799996,.
409000438620',2016-11-09,Indiaforensic AEPS NPCI DEP SET,,2016-11-09,255088.0,,-543835914.0799996,.
409000438620',2016-11-12,AEPS Indiaforensic INCOME 111116,,2016-11-12,,876.75,-543835037.3299996,.
409000438620',2016-11-12,AEPS Indiaforensic S TAX 111116,,2016-11-12,,131.51,-543834905.8199996,.
409000438620',2016-11-12,Indiaforensic AEPS NPCI DEP SET,,2016-11-12,11920.0,,-543846825.8199996,.
409000438620',2016-11-12,Indiaforensic AEPS NPCI WDL SET,,2016-11-12,,35783.0,-543811042.8199996,.
409000438620',2016-11-15,AEPS Indiaforensic INCOME 121116,,2016-11-15,,924.1,-543810118.7199996,.
409000438620',2016-11-15,AEPS Indiaforensic S TAX 121116,,2016-11-15,,138.62,-543809980.0999995,.
409000438620',2016-11-15,AEPS Indiaforensic INCOME 131116,,2016-11-15,,1036.29,-543808943.8099996,.
409000438620',2016-11-15,AEPS Indiaforensic S TAX 131116,,2016-11-15,,155.44,-543808788.3699995,.
409000438620',2016-11-15,AEPS Indiaforensic INCOME 141116,,2016-11-15,,1195.87,-543807592.4999995,.
409000438620',2016-11-15,AEPS Indiaforensic S TAX 141116,,2016-11-15,,179.38,-543807413.1199995,.
409000438620',2016-11-15,Indiaforensic AEPS NPCI WDL SET,,2016-11-15,,77346.0,-543730067.1199995,.
409000438620',2016-11-15,Indiaforensic AEPS NPCI WDL SET,,2016-11-15,,76329.0,-543653738.1199995,.
409000438620',2016-11-15,Indiaforensic AEPS NPCI DEP SET,,2016-11-15,22450.0,,-543676188.1199995,.
409000438620',2016-11-15,Indiaforensic AEPS NPCI DEP SET,,2016-11-15,16814.0,,-543693002.1199995,.
409000438620',2016-11-15,Indiaforensic AEPS NPCI DEP SET,,2016-11-15,62320.0,,-543755322.1199995,.
409000438620',2016-11-15,Indiaforensic AEPS NPCI WDL SET,,2016-11-15,,57094.0,-543698228.1199995,.
409000438620',2016-11-16,Indiaforensic AEPS NPCI DEP SET,,2016-11-16,75990.0,,-543774218.1199995,.
409000438620',2016-11-16,Indiaforensic AEPS NPCI WDL SET,,2016-11-16,,134833.0,-543639385.1199995,.
409000438620',2016-11-16,AEPS Indiaforensic INCOME 151116,,2016-11-16,,1540.36,-543637844.7599995,.
409000438620',2016-11-16,AEPS Indiaforensic S TAX 151116,,2016-11-16,,231.05,-543637613.7099996,.
409000438620',2016-11-17,AEPS Indiaforensic INCOME 161116,,2016-11-17,,2345.09,-543635268.6199995,.
409000438620',2016-11-17,AEPS Indiaforensic S TAX 161116,,2016-11-17,,351.76,-543634916.8599995,.
409000438620',2016-11-17,Indiaforensic AEPS NPCI WDL SET,,2016-11-17,,106625.0,-543528291.8599995,.
409000438620',2016-11-17,Indiaforensic AEPS NPCI DEP SET,,2016-11-17,391272.0,,-543919563.8599995,.
409000438620',2016-11-18,AEPS Indiaforensic INCOME 171116,,2016-11-18,,3925.1,-543915638.7599995,.
409000438620',2016-11-18,AEPS Indiaforensic S TAX 171116,,2016-11-18,,588.77,-543915049.9899995,.
409000438620',2016-11-18,Indiaforensic AEPS NPCI DEP SET,,2016-11-18,938444.0,,-544853493.9899995,.
409000438620',2016-11-18,Indiaforensic AEPS NPCI WDL SET,,2016-11-18,,144364.0,-544709129.9899995,.
409000438620',2016-11-19,AEPS Indiaforensic INCOME 181116,,2016-11-19,,4523.73,-544704606.2599995,.
409000438620',2016-11-19,AEPS Indiaforensic S TAX 181116,,2016-11-19,,678.56,-544703927.6999996,.
409000438620',2016-11-19,Indiaforensic AEPS NPCI WDL SET,,2016-11-19,,134443.0,-544569484.6999996,.
409000438620',2016-11-19,Indiaforensic AEPS NPCI DEP SET,,2016-11-19,1253414.0,,-545822898.6999996,.
409000438620',2016-11-21,AEPS Indiaforensic INCOME 191116,,2016-11-21,,4320.13,-545818578.5699996,.
409000438620',2016-11-21,AEPS Indiaforensic S TAX 191116,,2016-11-21,,648.02,-545817930.5499996,.
409000438620',2016-11-21,AEPS Indiaforensic INCOME 201116,,2016-11-21,,6353.38,-545811577.1699996,.
409000438620',2016-11-21,AEPS Indiaforensic S TAX 201116,,2016-11-21,,953.01,-545810624.1599996,.
409000438620',2016-11-21,TRF FRM  Indiaforensic SERVICES,,2016-11-21,,10000000.0,-535810624.1599996,.
409000438620',2016-11-21,Indiaforensic AEPS NPCI DEP SET,,2016-11-21,1351752.0,,-537162376.1599996,.
409000438620',2016-11-21,Indiaforensic AEPS NPCI DEP SET,,2016-11-21,2017301.0,,-539179677.1599996,.
409000438620',2016-11-21,Indiaforensic AEPS NPCI WDL SET,,2016-11-21,,107893.0,-539071784.1599996,.
409000438620',2016-11-21,Indiaforensic AEPS NPCI WDL SET,,2016-11-21,,96687.0,-538975097.1599996,.
409000438620',2016-11-22,TRF FRM  Indiaforensic SERVICES,,2016-11-22,,15000000.0,-523975097.1599996,.
409000438620',2016-11-22,AEPS Indiaforensic INCOME 211116,,2016-11-22,,7715.33,-523967381.8299996,.
409000438620',2016-11-22,AEPS Indiaforensic S TAX 211116,,2016-11-22,,1157.3,-523966224.5299996,.
409000438620',2016-11-22,Indiaforensic AEPS NPCI DEP SET,,2016-11-22,2170631.0,,-526136855.5299996,.
409000438620',2016-11-22,Indiaforensic AEPS NPCI WDL SET,,2016-11-22,,177011.0,-525959844.5299996,.
409000438620',2016-11-23,AEPS Indiaforensic INCOME 221116,,2016-11-23,,7650.1,-525952194.4299996,.
409000438620',2016-11-23,AEPS Indiaforensic S TAX 221116,,2016-11-23,,1147.52,-525951046.9099996,.
409000438620',2016-11-23,Indiaforensic AEPS NPCI WDL SET,,2016-11-23,,141878.0,-525809168.9099996,.
409000438620',2016-11-23,Indiaforensic AEPS NPCI DEP SET,,2016-11-23,2020479.0,,-527829647.9099996,.
409000438620',2016-11-24,AEPS Indiaforensic INCOME 231116,,2016-11-24,,11971.28,-527817676.62999964,.
409000438620',2016-11-24,AEPS Indiaforensic S TAX 231116,,2016-11-24,,1795.69,-527815880.93999964,.
409000438620',2016-11-24,Indiaforensic AEPS NPCI WDL SET,,2016-11-24,,343195.0,-527472685.93999964,.
409000438620',2016-11-24,Indiaforensic AEPS NPCI DEP SET,,2016-11-24,3795400.0,,-531268085.93999964,.
409000438620',2016-11-25,AEPS Indiaforensic INCOME 241116,,2016-11-25,,14142.74,-531253943.19999963,.
409000438620',2016-11-25,AEPS Indiaforensic S TAX 241116,,2016-11-25,,2121.41,-531251821.7899996,.
409000438620',2016-11-25,Indiaforensic AEPS NPCI WDL SET,,2016-11-25,,401349.0,-530850472.7899996,.
409000438620',2016-11-25,Indiaforensic AEPS NPCI DEP SET,,2016-11-25,4406728.0,,-535257200.7899996,.
409000438620',2016-11-28,AEPS Indiaforensic INCOME 251116,,2016-11-28,,13015.34,-535244185.44999963,.
409000438620',2016-11-28,AEPS Indiaforensic S TAX 251116,,2016-11-28,,1952.3,-535242233.1499996,.
409000438620',2016-11-28,AEPS Indiaforensic INCOME 261116,,2016-11-28,,13226.88,-535229006.2699996,.
409000438620',2016-11-28,AEPS Indiaforensic S TAX 261116,,2016-11-28,,1984.03,-535227022.23999965,.
409000438620',2016-11-28,AEPS Indiaforensic INCOME 271116,,2016-11-28,,7445.08,-535219577.15999967,.
409000438620',2016-11-28,AEPS Indiaforensic S TAX 271116,,2016-11-28,,1116.76,-535218460.3999997,.
409000438620',2016-11-28,Indiaforensic AEPS NPCI DEP SET,,2016-11-28,4042242.0,,-539260702.3999996,.
409000438620',2016-11-28,Indiaforensic AEPS NPCI DEP SET,,2016-11-28,3865907.0,,-543126609.3999996,.
409000438620',2016-11-28,Indiaforensic AEPS NPCI DEP SET,,2016-11-28,2128995.0,,-545255604.3999996,.
409000438620',2016-11-28,Indiaforensic AEPS NPCI WDL SET,,2016-11-28,,317677.0,-544937927.3999996,.
409000438620',2016-11-28,Indiaforensic AEPS NPCI WDL SET,,2016-11-28,,288100.0,-544649827.3999996,.
409000438620',2016-11-28,Indiaforensic AEPS NPCI WDL SET,,2016-11-28,,194388.0,-544455439.3999996,.
409000438620',2016-11-29,TRF FRM  Indiaforensic SERVICES,,2016-11-29,,10000000.0,-534455439.3999996,.
409000438620',2016-11-29,AEPS Indiaforensic INCOME 281116,,2016-11-29,,4585.34,-534450854.05999964,.
409000438620',2016-11-29,AEPS Indiaforensic S TAX 281116,,2016-11-29,,687.8,-534450166.25999963,.
409000438620',2016-11-29,AEPS Indiaforensic INCOME 231116,,2016-11-29,,12831.28,-534437334.97999966,.
409000438620',2016-11-29,AEPS Indiaforensic S TAX 231116,,2016-11-29,,1924.69,-534435410.28999966,.
409000438620',2016-11-29,AEPS Indiaforensic INCOME 241116,,2016-11-29,,15181.74,-534420228.54999965,.
409000438620',2016-11-29,AEPS Indiaforensic S TAX 241116,,2016-11-29,,2277.26,-534417951.28999966,.
409000438620',2016-11-29,REV AEPS Indiaforensic INCOME 23,,2016-11-29,11971.28,,-534429922.56999964,.
409000438620',2016-11-29,REV AEPS Indiaforensic S TAX 231,,2016-11-29,1795.69,,-534431718.25999963,.
409000438620',2016-11-29,REV AEPS Indiaforensic INCOME 24,,2016-11-29,14142.74,,-534445860.99999964,.
409000438620',2016-11-29,REV AEPS Indiaforensic S TAX 241,,2016-11-29,2121.41,,-534447982.40999967,.
409000438620',2016-11-29,Indiaforensic AEPS NPCI DEP SET,,2016-11-29,813019.0,,-535261001.40999967,.
409000438620',2016-11-29,Indiaforensic AEPS NPCI WDL SET,,2016-11-29,,230294.0,-535030707.40999967,.
409000438620',2016-11-30,AEPS Indiaforensic INCOME 291116,,2016-11-30,,12393.49,-535018313.91999966,.
409000438620',2016-11-30,AEPS Indiaforensic S TAX 291116,,2016-11-30,,1859.02,-535016454.8999997,.
409000438620',2016-11-30,Indiaforensic AEPS NPCI WDL SET,,2016-11-30,,409406.0,-534607048.8999997,.
409000438620',2016-11-30,Indiaforensic AEPS NPCI DEP SET,,2016-11-30,2989547.0,,-537596595.8999996,.
409000438620',2016-12-01,AEPS Indiaforensic INCOME 301116,,2016-12-01,,12092.94,-537584502.9599996,.
409000438620',2016-12-01,AEPS Indiaforensic S TAX 301116,,2016-12-01,,1813.94,-537582689.0199995,.
409000438620',2016-12-01,Indiaforensic AEPS NPCI WDL SET,,2016-12-01,,505781.0,-537076908.0199995,.
409000438620',2016-12-01,Indiaforensic AEPS NPCI DEP SET,,2016-12-01,2059990.0,,-539136898.0199995,.
409000438620',2016-12-02,AEPS Indiaforensic INCOME 011216,,2016-12-02,,11983.7,-539124914.3199995,.
409000438620',2016-12-02,AEPS Indiaforensic S TAX 011216,,2016-12-02,,1797.56,-539123116.7599995,.
409000438620',2016-12-02,Indiaforensic AEPS NPCI DEP SET,,2016-12-02,2480295.0,,-541603411.7599995,.
409000438620',2016-12-02,Indiaforensic AEPS NPCI WDL SET,,2016-12-02,,551972.0,-541051439.7599995,.
409000438620',2016-12-03,AEPS Indiaforensic INCOME 021216,,2016-12-03,,9605.42,-541041834.3399996,.
409000438620',2016-12-03,AEPS Indiaforensic S TAX 021216,,2016-12-03,,1440.81,-541040393.5299996,.
409000438620',2016-12-03,Indiaforensic AEPS NPCI WDL SET,,2016-12-03,,543033.0,-540497360.5299996,.
409000438620',2016-12-03,Indiaforensic AEPS NPCI DEP SET,,2016-12-03,1556179.0,,-542053539.5299996,.
409000438620',2016-12-05,AEPS Indiaforensic INCOME 031216,,2016-12-05,,10752.49,-542042787.0399996,.
409000438620',2016-12-05,AEPS Indiaforensic S TAX 031216,,2016-12-05,,1612.87,-542041174.1699996,.
409000438620',2016-12-05,AEPS Indiaforensic INCOME 041216,,2016-12-05,,11866.47,-542029307.6999996,.
409000438620',2016-12-05,AEPS Indiaforensic S TAX 041216,,2016-12-05,,1779.97,-542027527.7299995,.
409000438620',2016-12-05,Indiaforensic AEPS NPCI WDL SET,,2016-12-05,,601973.0,-541425554.7299995,.
409000438620',2016-12-05,Indiaforensic AEPS NPCI WDL SET,,2016-12-05,,628950.0,-540796604.7299995,.
409000438620',2016-12-05,Indiaforensic AEPS NPCI DEP SET,,2016-12-05,1833654.0,,-542630258.7299995,.
409000438620',2016-12-05,Indiaforensic AEPS NPCI DEP SET,,2016-12-05,1776633.0,,-544406891.7299995,.
409000438620',2016-12-06,AEPS Indiaforensic INCOME 051216,,2016-12-06,,12021.61,-544394870.1199995,.
409000438620',2016-12-06,AEPS Indiaforensic S TAX 051216,,2016-12-06,,1803.24,-544393066.8799995,.
409000438620',2016-12-06,Indiaforensic AEPS NPCI WDL SET,,2016-12-06,,646029.0,-543747037.8799995,.
409000438620',2016-12-06,Indiaforensic AEPS NPCI DEP SET,,2016-12-06,2099005.0,,-545846042.8799995,.
409000438620',2016-12-07,TRF FRM  Indiaforensic SERVICES,,2016-12-07,,3000000.0,-542846042.8799995,.
409000438620',2016-12-07,AEPS Indiaforensic INCOME 061216,,2016-12-07,,11707.85,-542834335.0299995,.
409000438620',2016-12-07,AEPS Indiaforensic S TAX 061216,,2016-12-07,,1756.18,-542832578.8499995,.
409000438620',2016-12-07,Indiaforensic AEPS NPCI WDL SET,,2016-12-07,,625091.0,-542207487.8499995,.
409000438620',2016-12-07,Indiaforensic AEPS NPCI DEP SET,,2016-12-07,1882732.0,,-544090219.8499995,.
409000438620',2016-12-08,TRF FRM  Indiaforensic SERVICES,,2016-12-08,,2500000.0,-541590219.8499995,.
409000438620',2016-12-08,Indiaforensic AEPS NPCI DEP SET,,2016-12-08,1627975.0,,-543218194.8499995,.
409000438620',2016-12-08,Indiaforensic AEPS NPCI WDL SET,,2016-12-08,,722060.0,-542496134.8499995,.
409000438620',2016-12-08,AEPS Indiaforensic INCOME 071216,,2016-12-08,,11123.3,-542485011.5499996,.
409000438620',2016-12-08,AEPS Indiaforensic S TAX 071216,,2016-12-08,,1668.5,-542483343.0499996,.
409000438620',2016-12-09,Indiaforensic AEPS NPCI DEP SET,,2016-12-09,1637867.0,,-544121210.0499996,.
409000438620',2016-12-09,Indiaforensic AEPS NPCI WDL SET,,2016-12-09,,734683.0,-543386527.0499996,.
409000438620',2016-12-09,AEPS Indiaforensic INCOME 081216,,2016-12-09,,11343.97,-543375183.0799996,.
409000438620',2016-12-09,AEPS Indiaforensic S TAX 081216,,2016-12-09,,1701.6,-543373481.4799995,.
409000438620',2016-12-13,AEPS Indiaforensic INCOME 091216,,2016-12-13,,11240.37,-543362241.1099995,.
409000438620',2016-12-13,AEPS Indiaforensic S TAX 091216,,2016-12-13,,1686.06,-543360555.0499996,.
409000438620',2016-12-13,AEPS Indiaforensic INCOME 101216,,2016-12-13,,13097.15,-543347457.8999996,.
409000438620',2016-12-13,AEPS Indiaforensic S TAX 101216,,2016-12-13,,1964.57,-543345493.3299996,.
409000438620',2016-12-13,AEPS Indiaforensic INCOME 111216,,2016-12-13,,11622.84,-543333870.4899995,.
409000438620',2016-12-13,AEPS Indiaforensic S TAX 111216,,2016-12-13,,1743.43,-543332127.0599996,.
409000438620',2016-12-13,AEPS Indiaforensic INCOME 121216,,2016-12-13,,12450.04,-543319677.0199996,.
409000438620',2016-12-13,AEPS Indiaforensic S TAX 121216,,2016-12-13,,1867.51,-543317809.5099996,.
409000438620',2016-12-13,Indiaforensic AEPS NPCI WDL SET,,2016-12-13,,852884.0,-542464925.5099996,.
409000438620',2016-12-13,Indiaforensic AEPS NPCI WDL SET,,2016-12-13,,919094.0,-541545831.5099996,.
409000438620',2016-12-13,Indiaforensic AEPS NPCI WDL SET,,2016-12-13,,671377.0,-540874454.5099996,.
409000438620',2016-12-13,Indiaforensic AEPS NPCI WDL SET,,2016-12-13,,890193.0,-539984261.5099996,.
409000438620',2016-12-13,Indiaforensic AEPS NPCI DEP SET,,2016-12-13,1100999.0,,-541085260.5099996,.
409000438620',2016-12-13,Indiaforensic AEPS NPCI DEP SET,,2016-12-13,1808620.0,,-542893880.5099996,.
409000438620',2016-12-13,Indiaforensic AEPS NPCI DEP SET,,2016-12-13,1576020.0,,-544469900.5099996,.
409000438620',2016-12-13,Indiaforensic AEPS NPCI DEP SET,,2016-12-13,1492710.0,,-545962610.5099996,.
409000438620',2016-12-14,FUND TRF FROM  Indiaforensic SER,,2016-12-14,,3000000.0,-542962610.5099996,.
409000438620',2016-12-14,AEPS ACQUIRING ADJ FEES 1,,2016-12-14,17.25,,-542962627.7599996,.
409000438620',2016-12-14,AEPS Indiaforensic INCOME 131216,,2016-12-14,,17899.4,-542944728.3599997,.
409000438620',2016-12-14,AEPS Indiaforensic S TAX 131216,,2016-12-14,,2684.91,-542942043.4499997,.
409000438620',2016-12-14,Indiaforensic AEPS NPCI WDL SET,,2016-12-14,,1378294.0,-541563749.4499997,.
409000438620',2016-12-14,Indiaforensic AEPS NPCI DEP SET,,2016-12-14,1803162.0,,-543366911.4499997,.
409000438620',2016-12-15,AEPS Indiaforensic INCOME 141216,,2016-12-15,,18414.93,-543348496.5199997,.
409000438620',2016-12-15,AEPS Indiaforensic S TAX 141216,,2016-12-15,,2762.24,-543345734.2799997,.
409000438620',2016-12-15,Indiaforensic AEPS NPCI DEP SET,,2016-12-15,1652440.0,,-544998174.2799997,.
409000438620',2016-12-15,Indiaforensic AEPS NPCI WDL SET,,2016-12-15,,1672323.0,-543325851.2799997,.
409000438620',2016-12-16,AEPS Indiaforensic INCOME 151216,,2016-12-16,,21294.1,-543304557.1799997,.
409000438620',2016-12-16,AEPS Indiaforensic S TAX 151216,,2016-12-16,,3194.12,-543301363.0599997,.
409000438620',2016-12-16,Indiaforensic AEPS NPCI WDL SET,,2016-12-16,,2133919.0,-541167444.0599997,.
409000438620',2016-12-16,Indiaforensic AEPS NPCI DEP SET,,2016-12-16,1445444.0,,-542612888.0599997,.
409000438620',2016-12-17,AEPS Indiaforensic INCOME 161216,,2016-12-17,,20052.64,-542592835.4199997,.
409000438620',2016-12-17,AEPS Indiaforensic S TAX 161216,,2016-12-17,,3007.9,-542589827.5199997,.
409000438620',2016-12-17,Indiaforensic AEPS NPCI DEP SET,,2016-12-17,1119396.0,,-543709223.5199997,.
409000438620',2016-12-17,Indiaforensic AEPS NPCI WDL SET,,2016-12-17,,2021447.0,-541687776.5199997,.
409000438620',2016-12-19,AEPS Indiaforensic INCOME 171216,,2016-12-19,,17935.03,-541669841.4899998,.
409000438620',2016-12-19,AEPS Indiaforensic S TAX 171216,,2016-12-19,,2690.25,-541667151.2399998,.
409000438620',2016-12-19,AEPS Indiaforensic INCOME 181216,,2016-12-19,,12582.03,-541654569.2099998,.
409000438620',2016-12-19,AEPS Indiaforensic S TAX 181216,,2016-12-19,,1887.3,-541652681.9099998,.
409000438620',2016-12-19,Indiaforensic AEPS NPCI DEP SET,,2016-12-19,400716.0,,-542053397.9099998,.
409000438620',2016-12-19,Indiaforensic AEPS NPCI WDL SET,,2016-12-19,,2112309.0,-539941088.9099998,.
409000438620',2016-12-19,Indiaforensic AEPS NPCI WDL SET,,2016-12-19,,1563043.0,-538378045.9099998,.
409000438620',2016-12-19,Indiaforensic AEPS NPCI DEP SET,,2016-12-19,119010.0,,-538497055.9099998,.
409000438620',2016-12-20,AEPS Indiaforensic INCOME 191216,,2016-12-20,,19834.77,-538477221.1399999,.
409000438620',2016-12-20,AEPS Indiaforensic S TAX 191216,,2016-12-20,,2975.22,-538474245.9199998,.
409000438620',2016-12-20,Indiaforensic AEPS NPCI WDL SET,,2016-12-20,,2431296.0,-536042949.91999984,.
409000438620',2016-12-20,Indiaforensic AEPS NPCI DEP SET,,2016-12-20,333875.0,,-536376824.91999984,.
409000438620',2016-12-21,AEPS Indiaforensic INCOME 201216,,2016-12-21,,23214.57,-536353610.34999985,.
409000438620',2016-12-21,AEPS Indiaforensic S TAX 201216,,2016-12-21,,3482.19,-536350128.15999985,.
409000438620',2016-12-21,AEPS ACQUIRING ADJ FEES 2,,2016-12-21,17.25,,-536350145.40999985,.
409000438620',2016-12-21,Indiaforensic AEPS NPCI DEP SET,,2016-12-21,248289.0,,-536598434.40999985,.
409000438620',2016-12-21,Indiaforensic AEPS NPCI WDL SET,,2016-12-21,,2927499.0,-533670935.40999985,.
409000438620',2016-12-22,AEPS ACQUIRING ADJ FEES 2,,2016-12-22,17.25,,-533670952.65999985,.
409000438620',2016-12-22,AEPS Indiaforensic INCOME 211216,,2016-12-22,,24765.93,-533646186.72999984,.
409000438620',2016-12-22,AEPS Indiaforensic S TAX 211216,,2016-12-22,,3714.89,-533642471.83999985,.
409000438620',2016-12-22,Indiaforensic AEPS NPCI WDL SET,,2016-12-22,,3033410.0,-530609061.83999985,.
409000438620',2016-12-22,Indiaforensic AEPS NPCI DEP SET,,2016-12-22,298479.0,,-530907540.83999985,.
409000438620',2016-12-23,AEPS Indiaforensic INCOME 221216,,2016-12-23,,25805.08,-530881735.7599999,.
409000438620',2016-12-23,AEPS Indiaforensic S TAX 221216,,2016-12-23,,3870.76,-530877864.9999999,.
409000438620',2016-12-23,Indiaforensic AEPS NPCI WDL SET,,2016-12-23,,3214995.0,-527662869.9999999,.
409000438620',2016-12-23,Indiaforensic AEPS NPCI DEP SET,,2016-12-23,229099.0,,-527891968.9999999,.
409000438620',2016-12-23,FUND TRF TO  Indiaforensic SERVI,,2016-12-23,10000000.0,,-537891968.9999999,.
409000438620',2016-12-26,AEPS Indiaforensic INCOME 231216,,2016-12-26,,28592.38,-537863376.6199999,.
409000438620',2016-12-26,AEPS Indiaforensic S TAX 231216,,2016-12-26,,4288.86,-537859087.7599999,.
409000438620',2016-12-26,AEPS Indiaforensic INCOME 241216,,2016-12-26,,26265.04,-537832822.7199999,.
409000438620',2016-12-26,AEPS Indiaforensic S TAX 241216,,2016-12-26,,3939.76,-537828882.9599999,.
409000438620',2016-12-26,AEPS Indiaforensic INCOME 251216,,2016-12-26,,18157.12,-537810725.8399999,.
409000438620',2016-12-26,AEPS Indiaforensic S TAX 251216,,2016-12-26,,2723.57,-537808002.2699999,.
409000438620',2016-12-26,Indiaforensic AEPS NPCI WDL SET,,2016-12-26,,3499137.0,-534308865.26999986,.
409000438620',2016-12-26,Indiaforensic AEPS NPCI DEP SET,,2016-12-26,400145.0,,-534709010.26999986,.
409000438620',2016-12-26,Indiaforensic AEPS NPCI DEP SET,,2016-12-26,241466.0,,-534950476.26999986,.
409000438620',2016-12-26,Indiaforensic AEPS NPCI WDL SET,,2016-12-26,,3178482.0,-531771994.26999986,.
409000438620',2016-12-26,Indiaforensic AEPS NPCI WDL SET,,2016-12-26,,2160608.0,-529611386.26999986,.
409000438620',2016-12-26,Indiaforensic AEPS NPCI DEP SET,,2016-12-26,165153.0,,-529776539.26999986,.
409000438620',2016-12-27,AEPS Indiaforensic INCOME 261216,,2016-12-27,,31411.59,-529745127.6799999,.
409000438620',2016-12-27,AEPS Indiaforensic S TAX 261216,,2016-12-27,,4711.74,-529740415.9399999,.
409000438620',2016-12-27,AEPS ACQUIRING ADJ FEES 2,,2016-12-27,,17.25,-529740398.6899999,.
409000438620',2016-12-27,TRF TO  Indiaforensic SERVICES I,,2016-12-27,13000000.0,,-542740398.6899998,.
409000438620',2016-12-27,Indiaforensic AEPS NPCI DEP SET,,2016-12-27,281368.0,,-543021766.6899998,.
409000438620',2016-12-27,Indiaforensic AEPS NPCI WDL SET,,2016-12-27,,3926370.0,-539095396.6899998,.
409000438620',2016-12-28,AEPS Indiaforensic INCOME 271216,,2016-12-28,,28381.97,-539067014.7199998,.
409000438620',2016-12-28,AEPS Indiaforensic S TAX 271216,,2016-12-28,,4257.3,-539062757.4199998,.
409000438620',2016-12-28,Indiaforensic AEPS NPCI DEP SET,,2016-12-28,217986.0,,-539280743.4199998,.
409000438620',2016-12-28,Indiaforensic AEPS NPCI WDL SET,,2016-12-28,,3514080.0,-535766663.41999984,.
409000438620',2016-12-28,TRF TO  Indiaforensic SERVICES I,,2016-12-28,5000000.0,,-540766663.4199998,.
409000438620',2016-12-29,AEPS Indiaforensic INCOME 281216,,2016-12-29,,30884.94,-540735778.4799998,.
409000438620',2016-12-29,AEPS Indiaforensic S TAX 281216,,2016-12-29,,4632.74,-540731145.7399998,.
409000438620',2016-12-29,TRF TO  Indiaforensic SERVICES I,,2016-12-29,5000000.0,,-545731145.7399998,.
409000438620',2016-12-29,Indiaforensic AEPS NPCI WDL SET,,2016-12-29,,3779131.0,-541952014.7399998,.
409000438620',2016-12-29,Indiaforensic AEPS NPCI DEP SET,,2016-12-29,244498.0,,-542196512.7399998,.
409000438620',2016-12-30,AEPS Indiaforensic INCOME 291216,,2016-12-30,,29238.2,-542167274.5399997,.
409000438620',2016-12-30,AEPS Indiaforensic S TAX 291216,,2016-12-30,,4385.73,-542162888.8099997,.
409000438620',2016-12-30,Indiaforensic AEPS NPCI DEP SET,,2016-12-30,306577.0,,-542469465.8099997,.
409000438620',2016-12-30,Indiaforensic AEPS NPCI WDL SET,,2016-12-30,,3515367.0,-538954098.8099997,.
409000438620',2016-12-30,TRF TO  Indiaforensic SERVICES I,,2016-12-30,7000000.0,,-545954098.8099997,.
409000438620',2016-12-31,AEPS Indiaforensic INCOME 301216,,2016-12-31,,29409.28,-545924689.5299997,.
409000438620',2016-12-31,AEPS Indiaforensic S TAX 301216,,2016-12-31,,4411.39,-545920278.1399997,.
409000438620',2016-12-31,Indiaforensic AEPS NPCI DEP SET,,2016-12-31,276023.0,,-546196301.1399997,.
409000438620',2016-12-31,Indiaforensic AEPS NPCI WDL SET,,2016-12-31,,3537218.0,-542659083.1399997,.
409000438620',2017-01-02,AEPS Indiaforensic INCOME 311216,,2017-01-02,,27244.37,-542631838.7699997,.
409000438620',2017-01-02,AEPS Indiaforensic S TAX 311216,,2017-01-02,,4086.66,-542627752.1099998,.
409000438620',2017-01-02,AEPS Indiaforensic INCOME 010117,,2017-01-02,,18823.14,-542608928.9699998,.
409000438620',2017-01-02,AEPS Indiaforensic S TAX 010117,,2017-01-02,,2823.47,-542606105.4999998,.
409000438620',2017-01-02,Indiaforensic AEPS NPCI WDL SET,,2017-01-02,,3189441.0,-539416664.4999998,.
409000438620',2017-01-02,Indiaforensic AEPS NPCI DEP SET,,2017-01-02,215092.0,,-539631756.4999998,.
409000438620',2017-01-02,Indiaforensic AEPS NPCI WDL SET,,2017-01-02,,2262619.0,-537369137.4999998,.
409000438620',2017-01-02,Indiaforensic AEPS NPCI DEP SET,,2017-01-02,258520.0,,-537627657.4999998,.
409000438620',2017-01-03,Indiaforensic AEPS NPCI DEP SET,,2017-01-03,574127.0,,-538201784.4999998,.
409000438620',2017-01-03,Indiaforensic AEPS NPCI WDL SET,,2017-01-03,,3835531.0,-534366253.49999976,.
409000438620',2017-01-03,TRF TO  Indiaforensic SERVICES I,,2017-01-03,5000000.0,,-539366253.4999998,.
409000438620',2017-01-04,AEPS Indiaforensic INCOME 020117,,2017-01-04,,30542.5,-539335710.9999998,.
409000438620',2017-01-04,AEPS Indiaforensic S TAX 020117,,2017-01-04,,4581.38,-539331129.6199998,.
409000438620',2017-01-04,AEPS Indiaforensic INCOME 030117,,2017-01-04,,32137.58,-539298992.0399997,.
409000438620',2017-01-04,AEPS Indiaforensic S TAX 030117,,2017-01-04,,4820.64,-539294171.3999997,.
409000438620',2017-01-04,Indiaforensic AEPS NPCI WDL SET,,2017-01-04,,4143994.0,-535150177.39999974,.
409000438620',2017-01-04,Indiaforensic AEPS NPCI DEP SET,,2017-01-04,632106.0,,-535782283.39999974,.
409000438620',2017-01-04,TRF TO  Indiaforensic SERVICES I,,2017-01-04,6000000.0,,-541782283.3999997,.
409000438620',2017-01-05,AEPS Indiaforensic INCOME 040117,,2017-01-05,,29096.7,-541753186.6999997,.
409000438620',2017-01-05,AEPS Indiaforensic S TAX 040117,,2017-01-05,,4364.51,-541748822.1899997,.
409000438620',2017-01-05,Indiaforensic AEPS NPCI WDL SET,,2017-01-05,,3712377.0,-538036445.1899997,.
409000438620',2017-01-05,Indiaforensic AEPS NPCI DEP SET,,2017-01-05,630651.0,,-538667096.1899997,.
409000438620',2017-01-06,AEPS Indiaforensic INCOME 050117,,2017-01-06,,27003.24,-538640092.9499997,.
409000438620',2017-01-06,AEPS Indiaforensic S TAX 050117,,2017-01-06,,4050.49,-538636042.4599997,.
409000438620',2017-01-06,Indiaforensic AEPS NPCI WDL SET,,2017-01-06,,3490624.0,-535145418.4599997,.
409000438620',2017-01-06,Indiaforensic AEPS NPCI DEP SET,,2017-01-06,669721.0,,-535815139.4599997,.
409000438620',2017-01-06,TRF TO  Indiaforensic SERVICES I,,2017-01-06,9000000.0,,-544815139.4599997,.
409000438620',2017-01-07,AEPS Indiaforensic INCOME 060117,,2017-01-07,,29012.41,-544786127.0499997,.
409000438620',2017-01-07,AEPS Indiaforensic S TAX 060117,,2017-01-07,,4351.86,-544781775.1899997,.
409000438620',2017-01-07,Indiaforensic AEPS NPCI WDL SET,,2017-01-07,,3741352.0,-541040423.1899997,.
409000438620',2017-01-07,Indiaforensic AEPS NPCI DEP SET,,2017-01-07,671545.0,,-541711968.1899997,.
409000438620',2017-01-09,AEPS Indiaforensic INCOME 070117,,2017-01-09,,28812.04,-541683156.1499997,.
409000438620',2017-01-09,AEPS Indiaforensic S TAX 070117,,2017-01-09,,4321.81,-541678834.3399998,.
409000438620',2017-01-09,AEPS Indiaforensic INCOME 080117,,2017-01-09,,22181.51,-541656652.8299998,.
409000438620',2017-01-09,AEPS Indiaforensic S TAX 080117,,2017-01-09,,3327.23,-541653325.5999998,.
409000438620',2017-01-09,Indiaforensic AEPS NPCI WDL SET,,2017-01-09,,3737465.0,-537915860.5999998,.
409000438620',2017-01-09,Indiaforensic AEPS NPCI DEP SET,,2017-01-09,624864.0,,-538540724.5999998,.
409000438620',2017-01-09,TRF TO  Indiaforensic ONLINE SER,,2017-01-09,7000000.0,,-545540724.5999998,.
409000438620',2017-01-09,Indiaforensic AEPS NPCI DEP SET,,2017-01-09,332791.0,,-545873515.5999998,.
409000438620',2017-01-09,Indiaforensic AEPS NPCI WDL SET,,2017-01-09,,3096473.0,-542777042.5999998,.
409000438620',2017-01-09,TRF TO  Indiaforensic SERVICES I,,2017-01-09,3000000.0,,-545777042.5999998,.
409000438620',2017-01-10,AEPS Indiaforensic INCOME 090117,,2017-01-10,,37479.63,-545739562.9699998,.
409000438620',2017-01-10,AEPS Indiaforensic S TAX 090117,,2017-01-10,,5621.94,-545733941.0299997,.
409000438620',2017-01-10,Indiaforensic AEPS NPCI WDL SET,,2017-01-10,,5068235.0,-540665706.0299997,.
409000438620',2017-01-10,Indiaforensic AEPS NPCI DEP SET,,2017-01-10,830604.0,,-541496310.0299997,.
409000438620',2017-01-11,AEPS Indiaforensic INCOME 100117,,2017-01-11,,38495.16,-541457814.8699998,.
409000438620',2017-01-11,AEPS ACQUIRING ADJ FEES 1,,2017-01-11,17.25,,-541457832.1199998,.
409000438620',2017-01-11,AEPS Indiaforensic S TAX 100117,,2017-01-11,,5774.27,-541452057.8499998,.
409000438620',2017-01-11,Indiaforensic AEPS NPCI DEP SET,,2017-01-11,983537.0,,-542435594.8499998,.
409000438620',2017-01-11,Indiaforensic AEPS NPCI WDL SET,,2017-01-11,,5366223.0,-537069371.8499998,.
409000438620',2017-01-12,TRF TO  Indiaforensic ONLINE SER,,2017-01-12,8000000.0,,-545069371.8499998,.
409000438620',2017-01-12,AEPS Indiaforensic INCOME 110117,,2017-01-12,,41458.15,-545027913.6999998,.
409000438620',2017-01-12,AEPS Indiaforensic S TAX 110117,,2017-01-12,,6218.72,-545021694.9799998,.
409000438620',2017-01-12,Indiaforensic AEPS NPCI DEP SET,,2017-01-12,753233.0,,-545774927.9799998,.
409000438620',2017-01-12,Indiaforensic AEPS NPCI WDL SET,,2017-01-12,,5963264.0,-539811663.9799998,.
409000438620',2017-01-13,AEPS Indiaforensic INCOME 120117,,2017-01-13,,45459.34,-539766204.6399997,.
409000438620',2017-01-13,AEPS Indiaforensic S TAX 120117,,2017-01-13,,6818.9,-539759385.7399998,.
409000438620',2017-01-13,Indiaforensic AEPS NPCI DEP SET,,2017-01-13,896835.0,,-540656220.7399998,.
409000438620',2017-01-13,Indiaforensic AEPS NPCI WDL SET,,2017-01-13,,6591756.0,-534064464.7399998,.
409000438620',2017-01-13,TRF TO  Indiaforensic SERVICES I,,2017-01-13,12000000.0,,-546064464.7399998,.
409000438620',2017-01-16,Indiaforensic AEPS NPCI WDL SET,,2017-01-16,,6095651.0,-539968813.7399998,.
409000438620',2017-01-16,Indiaforensic AEPS NPCI WDL SET,,2017-01-16,,5033256.0,-534935557.7399998,.
409000438620',2017-01-16,Indiaforensic AEPS NPCI WDL SET,,2017-01-16,,4380574.0,-530554983.7399998,.
409000438620',2017-01-16,Indiaforensic AEPS NPCI DEP SET,,2017-01-16,926399.0,,-531481382.7399998,.
409000438620',2017-01-16,Indiaforensic AEPS NPCI DEP SET,,2017-01-16,903458.0,,-532384840.7399998,.
409000438620',2017-01-16,Indiaforensic AEPS NPCI DEP SET,,2017-01-16,620808.0,,-533005648.7399998,.
409000438620',2017-01-16,AEPS Indiaforensic INCOME 130117,,2017-01-16,,41376.66,-532964272.07999974,.
409000438620',2017-01-16,AEPS Indiaforensic S TAX 130117,,2017-01-16,,6206.5,-532958065.57999974,.
409000438620',2017-01-16,AEPS Indiaforensic INCOME 140117,,2017-01-16,,35322.95,-532922742.62999976,.
409000438620',2017-01-16,AEPS Indiaforensic S TAX 140117,,2017-01-16,,5298.44,-532917444.18999976,.
409000438620',2017-01-16,AEPS Indiaforensic INCOME 150117,,2017-01-16,,31404.45,-532886039.7399998,.
409000438620',2017-01-16,AEPS Indiaforensic S TAX 150117,,2017-01-16,,4710.67,-532881329.06999975,.
409000438620',2017-01-16,TRF TO  Indiaforensic SERVICES I,,2017-01-16,13000000.0,,-545881329.0699997,.
409000438620',2017-01-17,AEPS Indiaforensic INCOME 160117,,2017-01-17,,48572.76,-545832756.3099997,.
409000438620',2017-01-17,AEPS Indiaforensic S TAX 160117,,2017-01-17,,7285.91,-545825470.3999997,.
409000438620',2017-01-17,Indiaforensic AEPS NPCI WDL SET,,2017-01-17,,7086557.0,-538738913.3999997,.
409000438620',2017-01-17,Indiaforensic AEPS NPCI DEP SET,,2017-01-17,956814.0,,-539695727.3999997,.
409000438620',2017-01-17,TRF TO  Indiaforensic SERVICES I,,2017-01-17,6000000.0,,-545695727.3999997,.
409000438620',2017-01-18,AEPS Indiaforensic INCOME 170117,,2017-01-18,,49788.97,-545645938.4299997,.
409000438620',2017-01-18,AEPS Indiaforensic S TAX 170117,,2017-01-18,,7468.35,-545638470.0799997,.
409000438620',2017-01-18,AEPS ACQUIRING ADJ FEES 1,,2017-01-18,17.25,,-545638487.3299997,.
409000438620',2017-01-18,Indiaforensic AEPS NPCI WDL SET,,2017-01-18,,6923897.0,-538714590.3299997,.
409000438620',2017-01-18,Indiaforensic AEPS NPCI DEP SET,,2017-01-18,1450494.0,,-540165084.3299997,.
409000438620',2017-01-19,AEPS Indiaforensic INCOME 180117,,2017-01-19,,46632.06,-540118452.2699997,.
409000438620',2017-01-19,AEPS Indiaforensic S TAX 180117,,2017-01-19,,6994.81,-540111457.4599998,.
409000438620',2017-01-19,TRF TO  Indiaforensic SERVICES I,,2017-01-19,6000000.0,,-546111457.4599998,.
409000438620',2017-01-19,Indiaforensic AEPS NPCI WDL SET,,2017-01-19,,6519008.0,-539592449.4599998,.
409000438620',2017-01-19,Indiaforensic AEPS NPCI DEP SET,,2017-01-19,1175766.0,,-540768215.4599998,.
409000438620',2017-01-20,AEPS Indiaforensic INCOME 190117,,2017-01-20,,47423.85,-540720791.6099998,.
409000438620',2017-01-20,AEPS Indiaforensic S TAX 190117,,2017-01-20,,7113.58,-540713678.0299997,.
409000438620',2017-01-20,TRF TO  Indiaforensic SERVICES I,,2017-01-20,5000000.0,,-545713678.0299997,.
409000438620',2017-01-20,Indiaforensic AEPS NPCI WDL SET,,2017-01-20,,6401467.0,-539312211.0299997,.
409000438620',2017-01-20,Indiaforensic AEPS NPCI DEP SET,,2017-01-20,1302225.0,,-540614436.0299997,.
409000438620',2017-01-21,AEPS Indiaforensic INCOME 200117,,2017-01-21,,42638.69,-540571797.3399997,.
409000438620',2017-01-21,AEPS Indiaforensic S TAX 200117,,2017-01-21,,6395.8,-540565401.5399997,.
409000438620',2017-01-21,Indiaforensic AEPS NPCI WDL SET,,2017-01-21,,5544395.0,-535021006.5399997,.
409000438620',2017-01-21,Indiaforensic AEPS NPCI DEP SET,,2017-01-21,1496383.0,,-536517389.5399997,.
409000438620',2017-01-21,TRF TO  Indiaforensic SERVICES I,,2017-01-21,5000000.0,,-541517389.5399997,.
409000438620',2017-01-21,TRF TO  Indiaforensic SERVICES I,,2017-01-21,2000000.0,,-543517389.5399997,.
409000438620',2017-01-21,TRF TO  Indiaforensic SERVICES I,,2017-01-21,2000000.0,,-545517389.5399997,.
409000438620',2017-01-23,AEPS Indiaforensic INCOME 210117,,2017-01-23,,44327.24,-545473062.2999997,.
409000438620',2017-01-23,AEPS Indiaforensic S TAX 210117,,2017-01-23,,6649.09,-545466413.2099997,.
409000438620',2017-01-23,AEPS Indiaforensic INCOME 220117,,2017-01-23,,37313.27,-545429099.9399997,.
409000438620',2017-01-23,AEPS Indiaforensic S TAX 220117,,2017-01-23,,5596.99,-545423502.9499997,.
409000438620',2017-01-23,Indiaforensic AEPS NPCI WDL SET,,2017-01-23,,4539099.0,-540884403.9499997,.
409000438620',2017-01-23,Indiaforensic AEPS NPCI WDL SET,,2017-01-23,,5449521.0,-535434882.9499997,.
409000438620',2017-01-23,Indiaforensic AEPS NPCI DEP SET,,2017-01-23,1147994.0,,-536582876.9499997,.
409000438620',2017-01-23,Indiaforensic AEPS NPCI DEP SET,,2017-01-23,1407451.0,,-537990327.9499997,.
409000438620',2017-01-23,TRF TO  Indiaforensic SERVICES I,,2017-01-23,7000000.0,,-544990327.9499997,.
409000438620',2017-01-23,MAW/5029649801703125/INDO,,2017-01-23,,4000.0,-544986327.9499997,.
409000438620',2017-01-24,AEPS Indiaforensic INCOME 230117,,2017-01-24,,41076.56,-544945251.3899997,.
409000438620',2017-01-24,AEPS Indiaforensic S TAX 230117,,2017-01-24,,6161.48,-544939089.9099997,.
409000438620',2017-01-24,Indiaforensic AEPS NPCI DEP SET,,2017-01-24,1316197.0,,-546255286.9099997,.
409000438620',2017-01-24,Indiaforensic AEPS NPCI WDL SET,,2017-01-24,,5211499.0,-541043787.9099997,.
409000438620',2017-01-24,TRF TO  Indiaforensic SERVICES I,,2017-01-24,5000000.0,,-546043787.9099997,.
409000438620',2017-01-25,AEPS Indiaforensic INCOME 240117,,2017-01-25,,46309.62,-545997478.2899997,.
409000438620',2017-01-25,AEPS Indiaforensic S TAX 240117,,2017-01-25,,6946.44,-545990531.8499997,.
409000438620',2017-01-25,Indiaforensic AEPS NPCI WDL SET,,2017-01-25,,6164487.0,-539826044.8499997,.
409000438620',2017-01-25,Indiaforensic AEPS NPCI DEP SET,,2017-01-25,1237151.0,,-541063195.8499997,.
409000438620',2017-01-25,FUND TRF TO  Indiaforensic SERVI,,2017-01-25,5000000.0,,-546063195.8499997,.
409000438620',2017-01-27,AEPS Indiaforensic INCOME 250117,,2017-01-27,,44144.45,-546019051.3999996,.
409000438620',2017-01-27,AEPS Indiaforensic S TAX 250117,,2017-01-27,,6621.67,-546012429.7299997,.
409000438620',2017-01-27,AEPS Indiaforensic INCOME 260117,,2017-01-27,,30269.7,-545982160.0299996,.
409000438620',2017-01-27,AEPS Indiaforensic S TAX 260117,,2017-01-27,,4540.46,-545977619.5699996,.
409000438620',2017-01-27,Indiaforensic AEPS NPCI WDL SET,,2017-01-27,,3573076.0,-542404543.5699996,.
409000438620',2017-01-27,Indiaforensic AEPS NPCI WDL SET,,2017-01-27,,5369533.0,-537035010.5699996,.
409000438620',2017-01-27,Indiaforensic AEPS NPCI DEP SET,,2017-01-27,1795401.0,,-538830411.5699996,.
409000438620',2017-01-27,Indiaforensic AEPS NPCI DEP SET,,2017-01-27,977095.0,,-539807506.5699996,.
409000438620',2017-01-27,TRF TO  Indiaforensic SERVICES I,,2017-01-27,6000000.0,,-545807506.5699996,.
409000438620',2017-01-30,AEPS Indiaforensic INCOME 270117,,2017-01-30,,42064.31,-545765442.2599996,.
409000438620',2017-01-30,AEPS Indiaforensic S TAX 270117,,2017-01-30,,6309.65,-545759132.6099997,.
409000438620',2017-01-30,AEPS Indiaforensic INCOME 280117,,2017-01-30,,36755.22,-545722377.3899996,.
409000438620',2017-01-30,AEPS Indiaforensic S TAX 280117,,2017-01-30,,5513.28,-545716864.1099997,.
409000438620',2017-01-30,AEPS Indiaforensic INCOME 290117,,2017-01-30,,27763.08,-545689101.0299996,.
409000438620',2017-01-30,AEPS Indiaforensic S TAX 290117,,2017-01-30,,4164.46,-545684936.5699996,.
409000438620',2017-01-30,Indiaforensic AEPS NPCI WDL SET,,2017-01-30,,4711535.0,-540973401.5699996,.
409000438620',2017-01-30,Indiaforensic AEPS NPCI WDL SET,,2017-01-30,,5348717.0,-535624684.5699996,.
409000438620',2017-01-30,Indiaforensic AEPS NPCI DEP SET,,2017-01-30,1278239.0,,-536902923.5699996,.
409000438620',2017-01-30,Indiaforensic AEPS NPCI DEP SET,,2017-01-30,1435425.0,,-538338348.5699996,.
409000438620',2017-01-30,TRF TO  Indiaforensic SERVICES I,,2017-01-30,7000000.0,,-545338348.5699996,.
409000438620',2017-01-30,Indiaforensic AEPS NPCI WDL SET,,2017-01-30,,3326417.0,-542011931.5699996,.
409000438620',2017-01-30,Indiaforensic AEPS NPCI DEP SET,,2017-01-30,994755.0,,-543006686.5699996,.
409000438620',2017-01-31,AEPS Indiaforensic INCOME 300117,,2017-01-31,,31966.76,-542974719.8099996,.
409000438620',2017-01-31,AEPS Indiaforensic S TAX 300117,,2017-01-31,,4795.01,-542969924.7999996,.
409000438620',2017-01-31,TRF TO  Indiaforensic SERVICES I,,2017-01-31,3000000.0,,-545969924.7999996,.
409000438620',2017-01-31,Indiaforensic AEPS NPCI WDL SET,,2017-01-31,,4150247.0,-541819677.7999996,.
409000438620',2017-01-31,Indiaforensic AEPS NPCI DEP SET,,2017-01-31,945882.0,,-542765559.7999996,.
409000438620',2017-02-01,AEPS Indiaforensic INCOME 310117,,2017-02-01,,39154.23,-542726405.5699996,.
409000438620',2017-02-01,AEPS Indiaforensic S TAX 310117,,2017-02-01,,5873.13,-542720532.4399996,.
409000438620',2017-02-01,Indiaforensic AEPS NPCI WDL SET,,2017-02-01,,4265828.0,-538454704.4399996,.
409000438620',2017-02-01,Indiaforensic AEPS NPCI DEP SET,,2017-02-01,1851991.0,,-540306695.4399996,.
409000438620',2017-02-02,AEPS Indiaforensic INCOME 010217,,2017-02-02,,44268.43,-540262427.0099996,.
409000438620',2017-02-02,AEPS Indiaforensic S TAX 010217,,2017-02-02,,6640.26,-540255786.7499996,.
409000438620',2017-02-02,TRF TO  Indiaforensic SERVICES I,,2017-02-02,6000000.0,,-546255786.7499996,.
409000438620',2017-02-02,Indiaforensic AEPS NPCI WDL SET,,2017-02-02,,5903615.0,-540352171.7499996,.
409000438620',2017-02-02,Indiaforensic AEPS NPCI DEP SET,,2017-02-02,1692989.0,,-542045160.7499996,.
409000438620',2017-02-02,TRF TO  Indiaforensic SERVICES I,,2017-02-02,4000000.0,,-546045160.7499996,.
409000438620',2017-02-03,AEPS Indiaforensic INCOME 020217,,2017-02-03,,43601.11,-546001559.6399996,.
409000438620',2017-02-03,AEPS Indiaforensic S TAX 020217,,2017-02-03,,6540.17,-545995019.4699997,.
409000438620',2017-02-03,Indiaforensic AEPS NPCI WDL SET,,2017-02-03,,5574498.0,-540420521.4699997,.
409000438620',2017-02-03,Indiaforensic AEPS NPCI DEP SET,,2017-02-03,1766575.0,,-542187096.4699997,.
409000438620',2017-02-03,TRF TO  Indiaforensic SERVICES I,,2017-02-03,4000000.0,,-546187096.4699997,.
409000438620',2017-02-04,AEPS Indiaforensic INCOME 030217,,2017-02-04,,43881.36,-546143215.1099997,.
409000438620',2017-02-04,AEPS Indiaforensic S TAX 030217,,2017-02-04,,6582.2,-546136632.9099996,.
409000438620',2017-02-04,Indiaforensic AEPS NPCI WDL SET,,2017-02-04,,5373312.0,-540763320.9099996,.
409000438620',2017-02-04,Indiaforensic AEPS NPCI DEP SET,,2017-02-04,1851577.0,,-542614897.9099996,.
409000438620',2017-02-04,TRF TO  Indiaforensic SERVICES I,,2017-02-04,3000000.0,,-545614897.9099996,.
409000438620',2017-02-06,AEPS Indiaforensic INCOME 040217,,2017-02-06,,38392.63,-545576505.2799996,.
409000438620',2017-02-06,AEPS Indiaforensic S TAX 040217,,2017-02-06,,5758.89,-545570746.3899996,.
409000438620',2017-02-06,AEPS Indiaforensic INCOME 050217,,2017-02-06,,37707.61,-545533038.7799996,.
409000438620',2017-02-06,AEPS Indiaforensic S TAX 050217,,2017-02-06,,5656.14,-545527382.6399996,.
409000438620',2017-02-06,Indiaforensic AEPS NPCI WDL SET,,2017-02-06,,4808136.0,-540719246.6399996,.
409000438620',2017-02-06,Indiaforensic AEPS NPCI WDL SET,,2017-02-06,,3939318.0,-536779928.6399996,.
409000438620',2017-02-06,Indiaforensic AEPS NPCI DEP SET,,2017-02-06,1293195.0,,-538073123.6399996,.
409000438620',2017-02-06,Indiaforensic AEPS NPCI DEP SET,,2017-02-06,1674416.0,,-539747539.6399996,.
409000438620',2017-02-06,TRF T O  Indiaforensic SERVICES,,2017-02-06,5000000.0,,-544747539.6399996,.
409000438620',2017-02-07,AEPS Indiaforensic INCOME 060217,,2017-02-07,,44916.38,-544702623.2599996,.
409000438620',2017-02-07,AEPS Indiaforensic S TAX 060217,,2017-02-07,,6737.46,-544695885.7999996,.
409000438620',2017-02-07,Indiaforensic AEPS NPCI WDL SET,,2017-02-07,,5153470.0,-539542415.7999996,.
409000438620',2017-02-07,Indiaforensic AEPS NPCI DEP SET,,2017-02-07,1728979.0,,-541271394.7999996,.
409000438620',2017-02-07,TRF TO  Indiaforensic SERVICES I,,2017-02-07,5000000.0,,-546271394.7999996,.
409000438620',2017-02-07,MAD/5029649805185394/AHME,,2017-02-07,,1000.0,-546270394.7999996,.
409000438620',2017-02-08,AEPS Indiaforensic INCOME 070217,,2017-02-08,,41601.32,-546228793.4799995,.
409000438620',2017-02-08,AEPS Indiaforensic S TAX 070217,,2017-02-08,,6240.2,-546222553.2799995,.
409000438620',2017-02-08,Indiaforensic AEPS NPCI WDL SET,,2017-02-08,,5512273.0,-540710280.2799995,.
409000438620',2017-02-08,Indiaforensic AEPS NPCI DEP SET,,2017-02-08,1780246.0,,-542490526.2799995,.
409000438620',2017-02-08,AEPS Indiaforensic INCOME 070217,,2017-02-08,41601.32,,-542532127.5999995,.
409000438620',2017-02-08,AEPS Indiaforensic S TAX 070217,,2017-02-08,6240.2,,-542538367.7999996,.
409000438620',2017-02-08,AEPS Indiaforensic INCOME 070217,,2017-02-08,,41666.82,-542496700.9799995,.
409000438620',2017-02-08,AEPS Indiaforensic S TAX 070217,,2017-02-08,,6250.02,-542490450.9599996,.
409000438620',2017-02-09,AEPS ACQUIRING ADJ FEES 0,,2017-02-09,17.25,,-542490468.2099996,.
409000438620',2017-02-09,AEPS Indiaforensic INCOME 080217,,2017-02-09,,45936.78,-542444531.4299996,.
409000438620',2017-02-09,AEPS Indiaforensic S TAX 080217,,2017-02-09,,6890.52,-542437640.9099996,.
409000438620',2017-02-09,Indiaforensic AEPS NPCI WDL SET,,2017-02-09,,6035592.0,-536402048.9099996,.
409000438620',2017-02-09,Indiaforensic AEPS NPCI DEP SET,,2017-02-09,1748542.0,,-538150590.9099996,.
409000438620',2017-02-09,TRF TO  Indiaforensic SERVICES I,,2017-02-09,3000000.0,,-541150590.9099996,.
409000438620',2017-02-09,TRF TO  Indiaforensic SERVICES I,,2017-02-09,5000000.0,,-546150590.9099996,.
409000438620',2017-02-10,AEPS Indiaforensic INCOME 090217,,2017-02-10,,55752.02,-546094838.8899996,.
409000438620',2017-02-10,AEPS Indiaforensic S TAX 090217,,2017-02-10,,8362.8,-546086476.0899997,.
409000438620',2017-02-10,Indiaforensic AEPS NPCI WDL SET,,2017-02-10,,6632481.0,-539453995.0899997,.
409000438620',2017-02-10,Indiaforensic AEPS NPCI DEP SET,,2017-02-10,1929577.0,,-541383572.0899997,.
409000438620',2017-02-10,TRF TO  Indiaforensic SERVICES I,,2017-02-10,4900000.0,,-546283572.0899997,.
409000438620',2017-02-13,AEPS ACQUIRING ADJ FEES 1,,2017-02-13,17.25,,-546283589.3399997,.
409000438620',2017-02-13,CR6070270612151004423 RMCPL,,2017-02-13,2500.0,,-546286089.3399997,.
409000438620',2017-02-13,AEPS Indiaforensic INCOME 100217,,2017-02-13,,58175.24,-546227914.0999997,.
409000438620',2017-02-13,AEPS Indiaforensic S TAX 100217,,2017-02-13,,8726.29,-546219187.8099997,.
409000438620',2017-02-13,AEPS Indiaforensic INCOME 110217,,2017-02-13,,59517.38,-546159670.4299997,.
409000438620',2017-02-13,AEPS Indiaforensic S TAX 110217,,2017-02-13,,8927.61,-546150742.8199997,.
409000438620',2017-02-13,AEPS Indiaforensic INCOME 120217,,2017-02-13,,46191.89,-546104550.9299997,.
409000438620',2017-02-13,AEPS Indiaforensic S TAX 120217,,2017-02-13,,6928.78,-546097622.1499997,.
409000438620',2017-02-13,Indiaforensic AEPS NPCI WDL SET,,2017-02-13,,7744661.0,-538352961.1499997,.
409000438620',2017-02-13,Indiaforensic AEPS NPCI WDL SET,,2017-02-13,,7597753.0,-530755208.14999974,.
409000438620',2017-02-13,Indiaforensic AEPS NPCI WDL SET,,2017-02-13,,5276107.0,-525479101.14999974,.
409000438620',2017-02-13,Indiaforensic AEPS NPCI DEP SET,,2017-02-13,1376867.0,,-526855968.14999974,.
409000438620',2017-02-13,Indiaforensic AEPS NPCI DEP SET,,2017-02-13,1576707.0,,-528432675.14999974,.
409000438620',2017-02-13,Indiaforensic AEPS NPCI DEP SET,,2017-02-13,1814263.0,,-530246938.14999974,.
409000438620',2017-02-13,TRF TO  Indiaforensic SERVICES I,,2017-02-13,15000000.0,,-545246938.1499997,.
409000438620',2017-02-14,AEPS ACQ INCOME SHARING 1,,2017-02-14,,38985.26,-545207952.8899997,.
409000438620',2017-02-14,AEPS BANK INCOME SHARING1,,2017-02-14,,5847.79,-545202105.0999998,.
409000438620',2017-02-14,Indiaforensic AEPS NPCI WDL SET,,2017-02-14,,4546569.0,-540655536.0999998,.
409000438620',2017-02-14,Indiaforensic AEPS NPCI DEP SET,,2017-02-14,1576554.0,,-542232090.0999998,.
409000438620',2017-02-14,REV AEPS ACQ INCOME SHARI,,2017-02-14,38985.26,,-542271075.3599998,.
409000438620',2017-02-14,REV AEPS BANK INCOME SHAR,,2017-02-14,5847.79,,-542276923.1499997,.
409000438620',2017-02-14,AEPS Indiaforensic INCOME 130217,,2017-02-14,,38985.26,-542237937.8899997,.
409000438620',2017-02-14,AEPS Indiaforensic S TAX 130217,,2017-02-14,,5847.79,-542232090.0999998,.
409000438620',2017-02-14,TRF TO  Indiaforensic SERVICES I,,2017-02-14,4000000.0,,-546232090.0999998,.
409000438620',2017-02-15,AEPS Indiaforensic INCOME 140217,,2017-02-15,,50574.38,-546181515.7199998,.
409000438620',2017-02-15,AEPS Indiaforensic S TAX 140217,,2017-02-15,,7586.16,-546173929.5599998,.
409000438620',2017-02-15,Indiaforensic AEPS NPCI WDL SET,,2017-02-15,,6996831.0,-539177098.5599998,.
409000438620',2017-02-15,Indiaforensic AEPS NPCI DEP SET,,2017-02-15,2013959.0,,-541191057.5599998,.
409000438620',2017-02-15,TRF TO  Indiaforensic SERVICES I,,2017-02-15,5000000.0,,-546191057.5599998,.
409000438620',2017-02-16,AEPS ACQUIRING ADJ FEES 1,,2017-02-16,67.85,,-546191125.4099998,.
409000438620',2017-02-16,AEPS Indiaforensic INCOME 150217,,2017-02-16,,45170.27,-546145955.1399999,.
409000438620',2017-02-16,AEPS Indiaforensic S TAX 150217,,2017-02-16,,6775.54,-546139179.5999999,.
409000438620',2017-02-16,Indiaforensic AEPS NPCI WDL SET,,2017-02-16,,5708666.0,-540430513.5999999,.
409000438620',2017-02-16,Indiaforensic AEPS NPCI DEP SET,,2017-02-16,1967290.0,,-542397803.5999999,.
409000438620',2017-02-17,AEPS Indiaforensic INCOME 160217,,2017-02-17,,53214.37,-542344589.2299999,.
409000438620',2017-02-17,AEPS Indiaforensic S TAX 160217,,2017-02-17,,7982.16,-542336607.0699999,.
409000438620',2017-02-17,Indiaforensic AEPS NPCI WDL SET,,2017-02-17,,6821404.0,-535515203.06999993,.
409000438620',2017-02-17,Indiaforensic AEPS NPCI DEP SET,,2017-02-17,1983908.0,,-537499111.0699999,.
409000438620',2017-02-18,AEPS Indiaforensic INCOME 170217,,2017-02-18,,56765.65,-537442345.42,.
409000438620',2017-02-18,AEPS Indiaforensic S TAX 170217,,2017-02-18,,8514.85,-537433830.5699999,.
409000438620',2017-02-18,Indiaforensic AEPS NPCI WDL SET,,2017-02-18,,6029936.0,-531403894.56999993,.
409000438620',2017-02-18,Indiaforensic AEPS NPCI DEP SET,,2017-02-18,1631989.0,,-533035883.56999993,.
409000438620',2017-02-18,TRF TO  Indiaforensic SERVICES I,,2017-02-18,5000000.0,,-538035883.5699999,.
409000438620',2017-02-18,TRF TO  Indiaforensic SERVICES I,,2017-02-18,4000000.0,,-542035883.5699999,.
409000438620',2017-02-18,TRF TO  Indiaforensic SERVICES I,,2017-02-18,3000000.0,,-545035883.5699999,.
409000438620',2017-02-20,AEPS ACQUIRING ADJ FEES 1,,2017-02-20,34.5,,-545035918.0699999,.
409000438620',2017-02-20,AEPS Indiaforensic INCOME 180217,,2017-02-20,,49054.49,-544986863.5799999,.
409000438620',2017-02-20,AEPS Indiaforensic S TAX 180217,,2017-02-20,,7358.17,-544979505.41,.
409000438620',2017-02-20,AEPS Indiaforensic INCOME 190217,,2017-02-20,,40336.25,-544939169.16,.
409000438620',2017-02-20,AEPS Indiaforensic S TAX 190217,,2017-02-20,,6050.44,-544933118.7199999,.
409000438620',2017-02-20,Indiaforensic AEPS NPCI WDL SET,,2017-02-20,,4996235.0,-539936883.7199999,.
409000438620',2017-02-20,Indiaforensic AEPS NPCI DEP SET,,2017-02-20,1179195.0,,-541116078.7199999,.
409000438620',2017-02-20,Indiaforensic AEPS NPCI WDL SET,,2017-02-20,,3571332.0,-537544746.7199999,.
409000438620',2017-02-20,Indiaforensic AEPS NPCI DEP SET,,2017-02-20,1704183.0,,-539248929.7199999,.
409000438620',2017-02-21,AEPS Indiaforensic INCOME 200217,,2017-02-21,,62160.33,-539186769.3899999,.
409000438620',2017-02-21,AEPS ACQUIRING ADJ FEES 2,,2017-02-21,69.0,,-539186838.3899999,.
409000438620',2017-02-21,AEPS Indiaforensic S TAX 200217,,2017-02-21,,9324.05,-539177514.3399999,.
409000438620',2017-02-21,TRF TO  Indiaforensic SERVICES I,,2017-02-21,7000000.0,,-546177514.3399999,.
409000438620',2017-02-21,Indiaforensic AEPS NPCI WDL SET,,2017-02-21,,5174625.0,-541002889.3399999,.
409000438620',2017-02-21,Indiaforensic AEPS NPCI DEP SET,,2017-02-21,1701414.0,,-542704303.3399999,.
409000438620',2017-02-22,TRF TO  Indiaforensic SERVICES I,,2017-02-22,3600000.0,,-546304303.3399999,.
409000438620',2017-02-22,AEPS Indiaforensic INCOME 210217,,2017-02-22,,47140.33,-546257163.0099999,.
409000438620',2017-02-22,AEPS Indiaforensic S TAX 210217,,2017-02-22,,7071.05,-546250091.9599999,.
409000438620',2017-02-22,Indiaforensic AEPS NPCI WDL SET,,2017-02-22,,4767687.0,-541482404.9599999,.
409000438620',2017-02-22,Indiaforensic AEPS NPCI DEP SET,,2017-02-22,1450332.0,,-542932736.9599999,.
409000438620',2017-02-23,TRF TO  Indiaforensic SERVICES I,,2017-02-23,3000000.0,,-545932736.9599999,.
409000438620',2017-02-23,Indiaforensic AEPS NPCI WDL SET,,2017-02-23,,4870155.0,-541062581.9599999,.
409000438620',2017-02-23,Indiaforensic AEPS NPCI DEP SET,,2017-02-23,1748013.0,,-542810594.9599999,.
409000438620',2017-02-23,AEPS Indiaforensic INCOME 220217,,2017-02-23,,59044.68,-542751550.28,.
409000438620',2017-02-23,AEPS Indiaforensic S TAX 220217,,2017-02-23,,8856.7,-542742693.5799999,.
409000438620',2017-02-24,TRF TO  Indiaforensic SERVICES I,,2017-02-24,3500000.0,,-546242693.5799999,.
409000438620',2017-02-27,AEPS ACQUIRING ADJ FEES 2,,2017-02-27,17.25,,-546242710.8299999,.
409000438620',2017-02-27,Indiaforensic AEPS NPCI WDL SET,,2017-02-27,,5051819.0,-541190891.8299999,.
409000438620',2017-02-27,Indiaforensic AEPS NPCI DEP SET,,2017-02-27,1659043.0,,-542849934.8299999,.
409000438620',2017-02-27,Indiaforensic AEPS NPCI WDL SET,,2017-02-27,,4153809.0,-538696125.8299999,.
409000438620',2017-02-27,Indiaforensic AEPS NPCI DEP SET,,2017-02-27,1690412.0,,-540386537.8299999,.
409000438620',2017-02-27,Indiaforensic AEPS NPCI WDL SET,,2017-02-27,,4202712.0,-536183825.8299999,.
409000438620',2017-02-27,Indiaforensic AEPS NPCI WDL SET,,2017-02-27,,3302207.0,-532881618.8299999,.
409000438620',2017-02-27,Indiaforensic AEPS NPCI DEP SET,,2017-02-27,1694663.0,,-534576281.8299999,.
409000438620',2017-02-27,Indiaforensic AEPS NPCI DEP SET,,2017-02-27,1278777.0,,-535855058.8299999,.
409000438620',2017-02-27,AEPS Indiaforensic INCOME 230217,,2017-02-27,,58932.13,-535796126.6999999,.
409000438620',2017-02-27,AEPS Indiaforensic S TAX 230217,,2017-02-27,,8839.82,-535787286.87999994,.
409000438620',2017-02-27,AEPS Indiaforensic INCOME 240217,,2017-02-27,,57046.39,-535730240.48999995,.
409000438620',2017-02-27,AEPS Indiaforensic S TAX 240217,,2017-02-27,,8556.96,-535721683.53,.
409000438620',2017-02-27,AEPS Indiaforensic INCOME 250217,,2017-02-27,,56806.33,-535664877.2,.
409000438620',2017-02-27,AEPS Indiaforensic S TAX 250217,,2017-02-27,,8520.95,-535656356.25,.
409000438620',2017-02-27,AEPS Indiaforensic INCOME 260217,,2017-02-27,,50188.84,-535606167.41,.
409000438620',2017-02-27,AEPS Indiaforensic S TAX 260217,,2017-02-27,,7528.33,-535598639.08000004,.
409000438620',2017-02-28,TRF TO  Indiaforensic SERVICES I,,2017-02-28,10000000.0,,-545598639.08,.
409000438620',2017-02-28,Indiaforensic AEPS NPCI WDL SET,,2017-02-28,,5613998.0,-539984641.08,.
409000438620',2017-02-28,AEPS Indiaforensic INCOME 270217,,2017-02-28,,58870.9,-539925770.1800001,.
409000438620',2017-02-28,AEPS Indiaforensic S TAX 270217,,2017-02-28,,8830.64,-539916939.5400001,.
409000438620',2017-02-28,Indiaforensic AEPS NPCI DEP SET,,2017-02-28,2358142.0,,-542275081.5400001,.
409000438620',2017-02-28,TRF TO  Indiaforensic SERVICES I,,2017-02-28,4000000.0,,-546275081.5400001,.
409000438620',2017-02-28,CB6081170479254556391 RMCPL,,2017-02-28,2000.0,,-546277081.5400001,.
409000438620',2017-02-28,CB6071890656747451692 RMCPL,,2017-02-28,2000.0,,-546279081.5400001,.
409000438620',2017-02-28,CB6071520837535773978 RMCPL,,2017-02-28,2000.0,,-546281081.5400001,.
409000438620',2017-02-28,CB6071520527726337477 RMCPL,,2017-02-28,2000.0,,-546283081.5400001,.
409000438620',2017-02-28,CB6070270588571385379 RMCPL,,2017-02-28,5500.0,,-546288581.5400001,.
409000438620',2017-02-28,CB6072640703972005258 RMCPL,,2017-02-28,1400.0,,-546289981.5400001,.
409000438620',2017-02-28,CB6072640831931934770 RMCPL,,2017-02-28,4000.0,,-546293981.5400001,.
409000438620',2017-02-28,CB6072640663032310547 RMCPL,,2017-02-28,1000.0,,-546294981.5400001,.
409000438620',2017-02-28,CB6072640406507563422 RMCPL,,2017-02-28,26.0,,-546295007.5400001,.
409000438620',2017-02-28,CB6072640663032310547 RMCPL,,2017-02-28,2000.0,,-546297007.5400001,.
409000438620',2017-02-28,CB6071530498371001838 RMCPL,,2017-02-28,2000.0,,-546299007.5400001,.
409000438620',2017-02-28,CB6071530498371001838 RMCPL,,2017-02-28,2000.0,,-546301007.5400001,.
409000438620',2017-02-28,CB6071530498371001838 RMCPL,,2017-02-28,2000.0,,-546303007.5400001,.
409000438620',2017-02-28,CB6071530498371001838 RMCPL,,2017-02-28,2000.0,,-546305007.5400001,.
409000438620',2017-02-28,CB6073870599067795765 RMCPL,,2017-02-28,3000.0,,-546308007.5400001,.
409000438620',2017-02-28,CB6073870550900546669 RMCPL,,2017-02-28,2700.0,,-546310707.5400001,.
409000438620',2017-02-28,CB6070850342483229142 RMCPL,,2017-02-28,2000.0,,-546312707.5400001,.
409000438620',2017-03-01,AEPS Indiaforensic INCOME 280217,,2017-03-01,,62212.29,-546250495.2500001,.
409000438620',2017-03-01,AEPS Indiaforensic S TAX 280217,,2017-03-01,,9331.84,-546241163.4100001,.
409000438620',2017-03-01,Indiaforensic AEPS NPCI WDL SET,,2017-03-01,,5174449.0,-541066714.4100001,.
409000438620',2017-03-01,Indiaforensic AEPS NPCI DEP SET,,2017-03-01,2129210.0,,-543195924.4100001,.
409000438620',2017-03-02,TRF TO  Indiaforensic SERVICES I,,2017-03-02,3000000.0,,-546195924.4100001,.
409000438620',2017-03-02,AEPS Indiaforensic INCOME 010317,,2017-03-02,,59973.47,-546135950.94,.
409000438620',2017-03-02,AEPS Indiaforensic S TAX 010317,,2017-03-02,,8996.02,-546126954.9200001,.
409000438620',2017-03-02,Indiaforensic AEPS NPCI WDL SET,,2017-03-02,,5650083.0,-540476871.9200001,.
409000438620',2017-03-02,Indiaforensic AEPS NPCI DEP SET,,2017-03-02,2455911.0,,-542932782.9200001,.
409000438620',2017-03-03,AEPS Indiaforensic INCOME 020317,,2017-03-03,,66731.67,-542866051.2500001,.
409000438620',2017-03-03,AEPS Indiaforensic S TAX 020317,,2017-03-03,,10009.75,-542856041.5000001,.
409000438620',2017-03-03,Indiaforensic AEPS NPCI WDL SET,,2017-03-03,,6083741.0,-536772300.5000001,.
409000438620',2017-03-03,Indiaforensic AEPS NPCI DEP SET,,2017-03-03,2351597.0,,-539123897.5000001,.
409000438620',2017-03-03,TRF TO  Indiaforensic SERVICES I,,2017-03-03,3400000.0,,-542523897.5000001,.
409000438620',2017-03-04,AEPS ACQUIRING ADJ FEES 0,,2017-03-04,34.5,,-542523932.0000001,.
409000438620',2017-03-04,AEPS Indiaforensic INCOME 030317,,2017-03-04,,65930.09,-542458001.9100001,.
409000438620',2017-03-04,AEPS Indiaforensic S TAX 030317,,2017-03-04,,9889.51,-542448112.4000001,.
409000438620',2017-03-04,Indiaforensic AEPS NPCI WDL SET,,2017-03-04,,5120026.0,-537328086.4000001,.
409000438620',2017-03-04,Indiaforensic AEPS NPCI DEP SET,,2017-03-04,2338283.0,,-539666369.4000001,.
409000438620',2017-03-04,TRF TO  Indiaforensic SERVICES I,,2017-03-04,3000000.0,,-542666369.4000001,.
409000438620',2017-03-06,AEPS Indiaforensic INCOME 040317,,2017-03-06,,58459.29,-542607910.1100001,.
409000438620',2017-03-06,AEPS Indiaforensic S TAX 040317,,2017-03-06,,8768.89,-542599141.2200001,.
409000438620',2017-03-06,AEPS Indiaforensic INCOME 050317,,2017-03-06,,55555.48,-542543585.7400001,.
409000438620',2017-03-06,AEPS Indiaforensic S TAX 050317,,2017-03-06,,8333.32,-542535252.4200001,.
409000438620',2017-03-06,Indiaforensic AEPS NPCI WDL SET,,2017-03-06,,5091234.0,-537444018.4200001,.
409000438620',2017-03-06,Indiaforensic AEPS NPCI DEP SET,,2017-03-06,1692923.0,,-539136941.4200001,.
409000438620',2017-03-06,Indiaforensic AEPS NPCI WDL SET,,2017-03-06,,4949142.0,-534187799.4200001,.
409000438620',2017-03-06,Indiaforensic AEPS NPCI DEP SET,,2017-03-06,2610820.0,,-536798619.4200001,.
409000438620',2017-03-07,TRF TO  Indiaforensic SERVICES I,,2017-03-07,9500000.0,,-546298619.4200001,.
409000438620',2017-03-07,AEPS Indiaforensic INCOME 060317,,2017-03-07,,68266.88,-546230352.5400001,.
409000438620',2017-03-07,AEPS Indiaforensic S TAX 060317,,2017-03-07,,10240.03,-546220112.5100001,.
409000438620',2017-03-07,Indiaforensic AEPS NPCI WDL SET,,2017-03-07,,6269785.0,-539950327.5100001,.
409000438620',2017-03-07,Indiaforensic AEPS NPCI DEP SET,,2017-03-07,2819933.0,,-542770260.5100001,.
409000438620',2017-03-08,CB 702912345498/RMCPL04073/,,2017-03-08,2000.0,,-542772260.5100001,.
409000438620',2017-03-08,TRF TO  Indiaforensic SERVICES I,,2017-03-08,3500000.0,,-546272260.5100001,.
409000438620',2017-03-08,Indiaforensic AEPS NPCI WDL SET,,2017-03-08,,6258434.0,-540013826.5100001,.
409000438620',2017-03-08,Indiaforensic AEPS NPCI DEP SET,,2017-03-08,3032365.0,,-543046191.5100001,.
409000438620',2017-03-08,AEPS Indiaforensic INCOME 070317,,2017-03-08,,69104.54,-542977086.9700001,.
409000438620',2017-03-08,AEPS Indiaforensic S TAX 070317,,2017-03-08,,10365.68,-542966721.2900002,.
409000438620',2017-03-09,TRF TO  Indiaforensic SERVICES I,,2017-03-09,3300000.0,,-546266721.2900002,.
409000438620',2017-03-09,AEPS Indiaforensic INCOME 080317,,2017-03-09,,73873.04,-546192848.2500002,.
409000438620',2017-03-09,AEPS Indiaforensic S TAX 080317,,2017-03-09,,11080.96,-546181767.2900002,.
409000438620',2017-03-09,Indiaforensic AEPS NPCI WDL SET,,2017-03-09,,8586538.0,-537595229.2900002,.
409000438620',2017-03-09,Indiaforensic AEPS NPCI DEP SET,,2017-03-09,3218370.0,,-540813599.2900002,.
409000438620',2017-03-10,AEPS ACQUIRING ADJ FEES 0,,2017-03-10,109.25,,-540813708.5400002,.
409000438620',2017-03-10,AEPS Indiaforensic INCOME 090317,,2017-03-10,,77907.55,-540735800.9900002,.
409000438620',2017-03-10,AEPS Indiaforensic S TAX 090317,,2017-03-10,,11686.13,-540724114.8600003,.
409000438620',2017-03-10,Indiaforensic AEPS NPCI WDL SET,,2017-03-10,,10449644.0,-530274470.86000025,.
409000438620',2017-03-10,Indiaforensic AEPS NPCI DEP SET,,2017-03-10,3664144.0,,-533938614.86000025,.
409000438620',2017-03-10,TRF TO  Indiaforensic SERVICES I,,2017-03-10,12000000.0,,-545938614.8600003,.
409000438620',2017-03-14,AEPS ACQUIRING ADJ FEES 1,,2017-03-14,365.93,,-545938980.7900002,.
409000438620',2017-03-14,CR700914054936/RMCPL09525/9,,2017-03-14,1.0,,-545938981.7900002,.
409000438620',2017-03-14,CR700914034260/RMCPL09525/9,,2017-03-14,1.0,,-545938982.7900002,.
409000438620',2017-03-14,CR700912554328/RMCPL09540/9,,2017-03-14,1.0,,-545938983.7900002,.
409000438620',2017-03-14,CR700913298387/RMCPL00272/9,,2017-03-14,2000.0,,-545940983.7900002,.
409000438620',2017-03-14,CR701012109609/RMCPL00059/1,,2017-03-14,4000.0,,-545944983.7900002,.
409000438620',2017-03-14,CR701017457955/RMCPL01584/1,,2017-03-14,4100.0,,-545949083.7900002,.
409000438620',2017-03-14,CR701012203216/RMCPL00106/1,,2017-03-14,1000.0,,-545950083.7900002,.
409000438620',2017-03-14,CR701018126271/RMCPL00142/1,,2017-03-14,10.0,,-545950093.7900002,.
409000438620',2017-03-14,CR701118227907/RMCPL10020/1,,2017-03-14,500.0,,-545950593.7900002,.
409000438620',2017-03-14,CR701117230994/RMCPL04097/1,,2017-03-14,200.0,,-545950793.7900002,.
409000438620',2017-03-14,CR701111209347/RMCPL08013/1,,2017-03-14,2000.0,,-545952793.7900002,.
409000438620',2017-03-14,CR701212378181/RMCPL09541/1,,2017-03-14,1.0,,-545952794.7900002,.
409000438620',2017-03-14,CR701213142751/RMCPL00222/1,,2017-03-14,2500.0,,-545955294.7900002,.
409000438620',2017-03-14,CR701219465661/RMCPL03029/1,,2017-03-14,2000.0,,-545957294.7900002,.
409000438620',2017-03-14,CR701216164862/RMCPL10066/1,,2017-03-14,4008.0,,-545961302.7900002,.
409000438620',2017-03-14,CR701315015768/RMCPL09540/1,,2017-03-14,1.0,,-545961303.7900002,.
409000438620',2017-03-14,CR701315585384/RMCPL09540/1,,2017-03-14,1.0,,-545961304.7900002,.
409000438620',2017-03-14,CR701317303270/RMCPL00382/1,,2017-03-14,2500.0,,-545963804.7900002,.
409000438620',2017-03-14,CR701415018116/RMCPL08472/1,,2017-03-14,2500.0,,-545966304.7900002,.
409000438620',2017-03-14,CR701412436074/RMCPL09008/1,,2017-03-14,2000.0,,-545968304.7900002,.
409000438620',2017-03-14,CR701420317476/RMCPL09183/1,,2017-03-14,100.0,,-545968404.7900002,.
409000438620',2017-03-14,CR701517013917/RMCPL09807/1,,2017-03-14,10.0,,-545968414.7900002,.
409000438620',2017-03-14,CR701515309661/RMCPL09183/1,,2017-03-14,1800.0,,-545970214.7900002,.
409000438620',2017-03-14,CR701515518225/RMCPL09183/1,,2017-03-14,500.0,,-545970714.7900002,.
409000438620',2017-03-14,CR701510013189/RMCPL09183/1,,2017-03-14,1020.0,,-545971734.7900002,.
409000438620',2017-03-14,CR701512577479/RMCPL09650/1,,2017-03-14,320.0,,-545972054.7900002,.
409000438620',2017-03-14,CR701512415216/RMCPL09183/1,,2017-03-14,4500.0,,-545976554.7900002,.
409000438620',2017-03-14,CR701510063435/RMCPL09183/1,,2017-03-14,4500.0,,-545981054.7900002,.
409000438620',2017-03-14,CR701511595458/RMCPL09702/1,,2017-03-14,2000.0,,-545983054.7900002,.
409000438620',2017-03-14,CR701510204807/RMCPL09183/1,,2017-03-14,800.0,,-545983854.7900002,.
409000438620',2017-03-14,CR701511089994/RMCPL08986/1,,2017-03-14,10.0,,-545983864.7900002,.
409000438620',2017-03-14,CR701518477882/RMCPL09183/1,,2017-03-14,100.0,,-545983964.7900002,.
409000438620',2017-03-14,CR701518027104/RMCPL09183/1,,2017-03-14,500.0,,-545984464.7900002,.
409000438620',2017-03-14,AEPS Indiaforensic INCOME 100317,,2017-03-14,,66146.17,-545918318.6200002,.
409000438620',2017-03-14,AEPS Indiaforensic S TAX 100317,,2017-03-14,,9921.93,-545908396.6900003,.
409000438620',2017-03-14,AEPS Indiaforensic INCOME 110317,,2017-03-14,,58831.95,-545849564.7400002,.
409000438620',2017-03-14,AEPS Indiaforensic S TAX 110317,,2017-03-14,,8824.79,-545840739.9500003,.
409000438620',2017-03-14,AEPS Indiaforensic INCOME 120317,,2017-03-14,,35551.55,-545805188.4000003,.
409000438620',2017-03-14,AEPS Indiaforensic S TAX 120317,,2017-03-14,,5332.73,-545799855.6700003,.
409000438620',2017-03-14,AEPS Indiaforensic INCOME 130317,,2017-03-14,,8365.29,-545791490.3800004,.
409000438620',2017-03-14,AEPS Indiaforensic S TAX 130317,,2017-03-14,,1254.79,-545790235.5900004,.
409000438620',2017-03-14,Indiaforensic AEPS NPCI WDL SET,,2017-03-14,,11626333.0,-534163902.5900004,.
409000438620',2017-03-14,Indiaforensic AEPS NPCI WDL SET,,2017-03-14,,10425344.0,-523738558.5900004,.
409000438620',2017-03-14,Indiaforensic AEPS NPCI WDL SET,,2017-03-14,,5584983.0,-518153575.5900004,.
409000438620',2017-03-14,Indiaforensic AEPS NPCI WDL SET,,2017-03-14,,1025654.0,-517127921.5900004,.
409000438620',2017-03-14,Indiaforensic AEPS NPCI DEP SET,,2017-03-14,3333755.0,,-520461676.5900004,.
409000438620',2017-03-14,Indiaforensic AEPS NPCI DEP SET,,2017-03-14,2340864.0,,-522802540.5900004,.
409000438620',2017-03-14,Indiaforensic AEPS NPCI DEP SET,,2017-03-14,1873716.0,,-524676256.5900004,.
409000438620',2017-03-14,Indiaforensic AEPS NPCI DEP SET,,2017-03-14,993499.0,,-525669755.5900004,.
409000438620',2017-03-14,TRF TO  Indiaforensic SERVICES I,,2017-03-14,15000000.0,,-540669755.5900004,.
409000438620',2017-03-14,TRF TO  Indiaforensic SERVICES I,,2017-03-14,5000000.0,,-545669755.5900004,.
409000438620',2017-03-15,AEPS ACQUIRING ADJ FEES 1,,2017-03-15,529.35,,-545670284.9400004,.
409000438620',2017-03-15,CR/701918079145/RMCPL09181/,,2017-03-15,2000.0,,-545672284.9400004,.
409000438620',2017-03-15,CR/702314063287/RMCPL09545/,,2017-03-15,1.0,,-545672285.9400004,.
409000438620',2017-03-15,CR/702313578352/RMCPL09529/,,2017-03-15,1.0,,-545672286.9400004,.
409000438620',2017-03-15,CR/702912378102/RMCPL09452/,,2017-03-15,2000.0,,-545674286.9400004,.
409000438620',2017-03-15,CR/702214521272/RMCPL01289/,,2017-03-15,1030.0,,-545675316.9400004,.
409000438620',2017-03-15,CR/703113177879/RMCPL09177/,,2017-03-15,100.0,,-545675416.9400004,.
409000438620',2017-03-15,CR/702915542341/RMCPL09982/,,2017-03-15,2500.0,,-545677916.9400004,.
409000438620',2017-03-15,CR/702319183259/RMCPL02131/,,2017-03-15,6000.0,,-545683916.9400004,.
409000438620',2017-03-15,CR/702912342024/RMCPL01289/,,2017-03-15,2000.0,,-545685916.9400004,.
409000438620',2017-03-15,CR/701617533392/RMCPL00145/,,2017-03-15,2000.0,,-545687916.9400004,.
409000438620',2017-03-15,CR/702912476756/RMCPL09328/,,2017-03-15,2000.0,,-545689916.9400004,.
409000438620',2017-03-15,CR/701618449077/RMCPL00382/,,2017-03-15,2000.0,,-545691916.9400004,.
409000438620',2017-03-15,CR/701616530915/RMCPL09788/,,2017-03-15,1000.0,,-545692916.9400004,.
409000438620',2017-03-15,CR/701615478359/RMCPL00414/,,2017-03-15,1000.0,,-545693916.9400004,.
409000438620',2017-03-15,CR/701613198574/RMCPL06765/,,2017-03-15,2000.0,,-545695916.9400004,.
409000438620',2017-03-15,CR/701610205403/RMCPL03662/,,2017-03-15,4500.0,,-545700416.9400004,.
409000438620',2017-03-15,CR/701616514373/RMCPL08986/,,2017-03-15,10.0,,-545700426.9400004,.
409000438620',2017-03-15,CR/701613468916/RMCPL00363/,,2017-03-15,500.0,,-545700926.9400004,.
409000438620',2017-03-15,CR/701618579606/RMCPL02389/,,2017-03-15,200.0,,-545701126.9400004,.
409000438620',2017-03-15,CR/701610422004/RMCPL09939/,,2017-03-15,105.0,,-545701231.9400004,.
409000438620',2017-03-15,CR/701708387699/RMCPL09188/,,2017-03-15,2000.0,,-545703231.9400004,.
409000438620',2017-03-15,CR/701709126587/RMCPL03044/,,2017-03-15,4000.0,,-545707231.9400004,.
409000438620',2017-03-15,CR/701717496837/RMCPL00180/,,2017-03-15,2000.0,,-545709231.9400004,.
409000438620',2017-03-15,CR/701713467018/RMCPL09832/,,2017-03-15,100.0,,-545709331.9400004,.
409000438620',2017-03-15,CR/701714547716/RMCPL09435/,,2017-03-15,2100.0,,-545711431.9400004,.
409000438620',2017-03-15,CR/701718239660/RMCPL08471/,,2017-03-15,4000.0,,-545715431.9400004,.
409000438620',2017-03-15,CR/701818486779/RMCPL01585/,,2017-03-15,1500.0,,-545716931.9400004,.
409000438620',2017-03-15,CR/701814317641/RMCPL09952/,,2017-03-15,10.0,,-545716941.9400004,.
409000438620',2017-03-15,CR/701812002973/RMCPL03315/,,2017-03-15,500.0,,-545717441.9400004,.
409000438620',2017-03-15,CR/701918068597/RMCPL07034/,,2017-03-15,2000.0,,-545719441.9400004,.
409000438620',2017-03-15,CR/702018178371/RMCPL01987/,,2017-03-15,2050.0,,-545721491.9400004,.
409000438620',2017-03-15,CR/702018513828/RMCPL10036/,,2017-03-15,4000.0,,-545725491.9400004,.
409000438620',2017-03-15,CR/702211126310/RMCPL09827/,,2017-03-15,1000.0,,-545726491.9400004,.
409000438620',2017-03-15,CR/702110254729/RMCPL00045/,,2017-03-15,200.0,,-545726691.9400004,.
409000438620',2017-03-15,CR/702211089620/RMCPL00388/,,2017-03-15,7000.0,,-545733691.9400004,.
409000438620',2017-03-15,CR/702208309984/RMCPL00153/,,2017-03-15,1000.0,,-545734691.9400004,.
409000438620',2017-03-15,CR/702113075221/RMCPL08472/,,2017-03-15,2000.0,,-545736691.9400004,.
409000438620',2017-03-15,CR/702318153328/RMCPL00414/,,2017-03-15,5000.0,,-545741691.9400004,.
409000438620',2017-03-15,CR/702409248615/RMCPL03587/,,2017-03-15,2000.0,,-545743691.9400004,.
409000438620',2017-03-15,CR/702409171883/RMCPL03587/,,2017-03-15,2000.0,,-545745691.9400004,.
409000438620',2017-03-15,CR/702312273810/RMCPL02714/,,2017-03-15,2700.0,,-545748391.9400004,.
409000438620',2017-03-15,CR/702409487025/RMCPL00614/,,2017-03-15,1000.0,,-545749391.9400004,.
409000438620',2017-03-15,CR/702311519773/RMCPL00119/,,2017-03-15,2500.0,,-545751891.9400004,.
409000438620',2017-03-15,CR/702313417409/RMCPL09832/,,2017-03-15,100.0,,-545751991.9400004,.
409000438620',2017-03-15,CR/702313033238/RMCPL09832/,,2017-03-15,10.0,,-545752001.9400004,.
409000438620',2017-03-15,CR/702311129690/RMCPL09035/,,2017-03-15,2000.0,,-545754001.9400004,.
409000438620',2017-03-15,CR/702318408822/RMCPL03676/,,2017-03-15,4500.0,,-545758501.9400004,.
409000438620',2017-03-15,CR/702309521618/RMCPL09844/,,2017-03-15,180.0,,-545758681.9400004,.
409000438620',2017-03-15,CR/702420380267/RMCPL07034/,,2017-03-15,500.0,,-545759181.9400004,.
409000438620',2017-03-15,AEPS Indiaforensic INCOME 140317,,2017-03-15,,35025.26,-545724156.6800004,.
409000438620',2017-03-15,AEPS Indiaforensic S TAX 140317,,2017-03-15,,5253.79,-545718902.8900005,.
409000438620',2017-03-15,TRF TO  Indiaforensic SERVICES I,,2017-03-15,67000.0,,-545785902.8900005,.
409000438620',2017-03-15,Indiaforensic AEPS NPCI WDL SET,,2017-03-15,,6356394.0,-539429508.8900005,.
409000438620',2017-03-15,Indiaforensic AEPS NPCI DEP SET,,2017-03-15,2121501.0,,-541551009.8900005,.
409000438620',2017-03-16,AEPS ACQUIRING ADJ FEES 1,,2017-03-16,3211.03,,-541554220.9200004,.
409000438620',2017-03-16,CR/702912523440/RMCPL09050/,,2017-03-16,10.0,,-541554230.9200004,.
409000438620',2017-03-16,CR/702913280858/RMCPL01094/,,2017-03-16,500.0,,-541554730.9200004,.
409000438620',2017-03-16,CR/703015219962/RMCPL00119/,,2017-03-16,1010.0,,-541555740.9200004,.
409000438620',2017-03-16,CR/702915457739/RMCPL09702/,,2017-03-16,1000.0,,-541556740.9200004,.
409000438620',2017-03-16,CR/702915223612/RMCPL00408/,,2017-03-16,500.0,,-541557240.9200004,.
409000438620',2017-03-16,CR/702912562923/RMCPL09844/,,2017-03-16,9800.0,,-541567040.9200004,.
409000438620',2017-03-16,CR/702912585732/RMCPL00388/,,2017-03-16,180.0,,-541567220.9200004,.
409000438620',2017-03-16,CR/702915009893/RMCPL09452/,,2017-03-16,800.0,,-541568020.9200004,.
409000438620',2017-03-16,CR/702915032958/RMCPL09999/,,2017-03-16,2500.0,,-541570520.9200004,.
409000438620',2017-03-16,CR/702915355080/RMCPL00012/,,2017-03-16,4000.0,,-541574520.9200004,.
409000438620',2017-03-16,CR/702616123100/RMCPL02389/,,2017-03-16,2000.0,,-541576520.9200004,.
409000438620',2017-03-16,CR/702912422857/RMCPL09286/,,2017-03-16,2000.0,,-541578520.9200004,.
409000438620',2017-03-16,CR/702519273140/RMCPL09920/,,2017-03-16,1500.0,,-541580020.9200004,.
409000438620',2017-03-16,CR/702810037160/RMCPL00182/,,2017-03-16,1000.0,,-541581020.9200004,.
409000438620',2017-03-16,CR/702810535636/RMCPL09286/,,2017-03-16,2000.0,,-541583020.9200004,.
409000438620',2017-03-16,CR/702620129386/RMCPL07034/,,2017-03-16,200.0,,-541583220.9200004,.
409000438620',2017-03-16,CR/702510590983/RMCPL01749/,,2017-03-16,2500.0,,-541585720.9200004,.
409000438620',2017-03-16,CR/702514260416/RMCPL00106/,,2017-03-16,123.0,,-541585843.9200004,.
409000438620',2017-03-16,CR/702912190617/RMCPL09661/,,2017-03-16,2000.0,,-541587843.9200004,.
409000438620',2017-03-16,CR/702817103497/RMCPL01289/,,2017-03-16,2000.0,,-541589843.9200004,.
409000438620',2017-03-16,CR/702510355129/RMCPL09789/,,2017-03-16,2000.0,,-541591843.9200004,.
409000438620',2017-03-16,CR/702612354958/RMCPL06763/,,2017-03-16,5000.0,,-541596843.9200004,.
409000438620',2017-03-16,CR/702720565515/RMCPL01583/,,2017-03-16,2000.0,,-541598843.9200004,.
409000438620',2017-03-16,CR/702912370614/RMCPL00125/,,2017-03-16,2000.0,,-541600843.9200004,.
409000438620',2017-03-16,CR/702518157902/RMCPL02346/,,2017-03-16,2000.0,,-541602843.9200004,.
409000438620',2017-03-16,CR/702616402648/RMCPL09999/,,2017-03-16,1400.0,,-541604243.9200004,.
409000438620',2017-03-16,CR/702612177420/RMCPL04217/,,2017-03-16,22.0,,-541604265.9200004,.
409000438620',2017-03-16,CR/702514051484/RMCPL00928/,,2017-03-16,4000.0,,-541608265.9200004,.
409000438620',2017-03-16,CR/702912404210/RMCPL00108/,,2017-03-16,2000.0,,-541610265.9200004,.
409000438620',2017-03-16,CR/702612542814/RMCPL03029/,,2017-03-16,2000.0,,-541612265.9200004,.
409000438620',2017-03-16,CR/702810105900/RMCPL09435/,,2017-03-16,1575.0,,-541613840.9200004,.
409000438620',2017-03-16,CR/702616341612/RMCPL01228/,,2017-03-16,1000.0,,-541614840.9200004,.
409000438620',2017-03-16,CR/702612078342/RMCPL03662/,,2017-03-16,1000.0,,-541615840.9200004,.
409000438620',2017-03-16,CR/702817328003/RMCPL00125/,,2017-03-16,500.0,,-541616340.9200004,.
409000438620',2017-03-16,CR/702521373840/RMCPL09920/,,2017-03-16,278.0,,-541616618.9200004,.
409000438620',2017-03-16,CR/702616543454/RMCPL09998/,,2017-03-16,2500.0,,-541619118.9200004,.
409000438620',2017-03-16,CR/702518117817/RMCPL00250/,,2017-03-16,1.0,,-541619119.9200004,.
409000438620',2017-03-16,CR/702510447286/RMCPL01682/,,2017-03-16,1000.0,,-541620119.9200004,.
409000438620',2017-03-16,CR/701912310898/RMCPL09249/,,2017-03-16,510.0,,-541620629.9200004,.
409000438620',2017-03-16,CR/703513354880/RMCPL09924/,,2017-03-16,2000.0,,-541622629.9200004,.
409000438620',2017-03-16,CR/703511212261/RMCPL00119/,,2017-03-16,4000.0,,-541626629.9200004,.
409000438620',2017-03-16,CR/705012087261/RMCPL00123/,,2017-03-16,2500.0,,-541629129.9200004,.
409000438620',2017-03-16,CR/705012109528/RMCPL00123/,,2017-03-16,2500.0,,-541631629.9200004,.
409000438620',2017-03-16,CR/703513192289/RMCPL00179/,,2017-03-16,25.0,,-541631654.9200004,.
409000438620',2017-03-16,CR/703512045065/RMCPL08472/,,2017-03-16,3000.0,,-541634654.9200004,.
409000438620',2017-03-16,CR/703512055267/RMCPL08472/,,2017-03-16,4000.0,,-541638654.9200004,.
409000438620',2017-03-16,CR/703512237549/RMCPL00928/,,2017-03-16,10000.0,,-541648654.9200004,.
409000438620',2017-03-16,CR/703707430913/RMCPL09119/,,2017-03-16,100.0,,-541648754.9200004,.
409000438620',2017-03-16,CR/703611309516/RMCPL09119/,,2017-03-16,100.0,,-541648854.9200004,.
409000438620',2017-03-16,CR/703512037726/RMCPL03662/,,2017-03-16,1000.0,,-541649854.9200004,.
409000438620',2017-03-16,CR/703511589274/RMCPL09080/,,2017-03-16,10.0,,-541649864.9200004,.
409000438620',2017-03-16,CR/703512186591/RMCPL06811/,,2017-03-16,9900.0,,-541659764.9200004,.
409000438620',2017-03-16,CR/703512399431/RMCPL00109/,,2017-03-16,20.0,,-541659784.9200004,.
409000438620',2017-03-16,CR/703512068652/RMCPL03601/,,2017-03-16,500.0,,-541660284.9200004,.
409000438620',2017-03-16,CR/705009379517/RMCPL09768/,,2017-03-16,2000.0,,-541662284.9200004,.
409000438620',2017-03-16,CR/705012365566/RMCPL04395/,,2017-03-16,1130.0,,-541663414.9200004,.
409000438620',2017-03-16,CR/703512412359/RMCPL03202/,,2017-03-16,1000.0,,-541664414.9200004,.
409000438620',2017-03-16,CR/703512168560/RMCPL02346/,,2017-03-16,3900.0,,-541668314.9200004,.
409000438620',2017-03-16,CR/703512098877/RMCPL00109/,,2017-03-16,600.0,,-541668914.9200004,.
409000438620',2017-03-16,CR/705013200040/RMCPL01583/,,2017-03-16,2040.0,,-541670954.9200004,.
409000438620',2017-03-16,CR/703511358967/RMCPL09924/,,2017-03-16,3000.0,,-541673954.9200004,.
409000438620',2017-03-16,CR/703513589251/RMCPL00520/,,2017-03-16,2000.0,,-541675954.9200004,.
409000438620',2017-03-16,CR/703512104002/RMCPL09962/,,2017-03-16,300.0,,-541676254.9200004,.
409000438620',2017-03-16,CR/703512162079/RMCPL09008/,,2017-03-16,1000.0,,-541677254.9200004,.
409000438620',2017-03-16,CR/705012173177/RMCPL05050/,,2017-03-16,1000.0,,-541678254.9200004,.
409000438620',2017-03-16,CR/703512262231/RMCPL00180/,,2017-03-16,800.0,,-541679054.9200004,.
409000438620',2017-03-16,CR/703512152054/RMCPL00527/,,2017-03-16,100.0,,-541679154.9200004,.
409000438620',2017-03-16,CR/703512223075/RMCPL04006/,,2017-03-16,150.0,,-541679304.9200004,.
409000438620',2017-03-16,CR/703610480126/RMCPL09119/,,2017-03-16,100.0,,-541679404.9200004,.
409000438620',2017-03-16,CR/703511059209/RMCPL04894/,,2017-03-16,500.0,,-541679904.9200004,.
409000438620',2017-03-16,CR/703513398988/RMCPL00010/,,2017-03-16,1000.0,,-541680904.9200004,.
409000438620',2017-03-16,CR/705013437838/RMCPL05050/,,2017-03-16,2500.0,,-541683404.9200004,.
409000438620',2017-03-16,CR/703512134587/RMCPL00614/,,2017-03-16,500.0,,-541683904.9200004,.
409000438620',2017-03-16,CR/703512575542/RMCPL00614/,,2017-03-16,370.0,,-541684274.9200004,.
409000438620',2017-03-16,CR/703512287584/RMCPL06718/,,2017-03-16,1500.0,,-541685774.9200004,.
409000438620',2017-03-16,CR/703513126877/RMCPL10043/,,2017-03-16,1500.0,,-541687274.9200004,.
409000438620',2017-03-16,CR/705012365566/RMCPL09626/,,2017-03-16,2000.0,,-541689274.9200004,.
409000438620',2017-03-16,CR/705013238571/RMCPL09998/,,2017-03-16,2500.0,,-541691774.9200004,.
409000438620',2017-03-16,CR/705009322265/RMCPL10020/,,2017-03-16,4000.0,,-541695774.9200004,.
409000438620',2017-03-16,CR/703512372317/RMCPL03038/,,2017-03-16,2000.0,,-541697774.9200004,.
409000438620',2017-03-16,CR/703512125283/RMCPL03038/,,2017-03-16,2000.0,,-541699774.9200004,.
409000438620',2017-03-16,CR/705013380703/RMCPL09998/,,2017-03-16,2500.0,,-541702274.9200004,.
409000438620',2017-03-16,CR/703512524876/RMCPL01168/,,2017-03-16,1500.0,,-541703774.9200004,.
409000438620',2017-03-16,CR/703511437254/RMCPL09661/,,2017-03-16,500.0,,-541704274.9200004,.
409000438620',2017-03-16,CR/703512392532/RMCPL09001/,,2017-03-16,100.0,,-541704374.9200004,.
409000438620',2017-03-16,CR/705007460328/RMCPL00187/,,2017-03-16,4600.0,,-541708974.9200004,.
409000438620',2017-03-16,CR/705012376799/RMCPL09009/,,2017-03-16,2810.0,,-541711784.9200004,.
409000438620',2017-03-16,CR/703511247205/RMCPL09930/,,2017-03-16,300.0,,-541712084.9200004,.
409000438620',2017-03-16,CR/705013282379/RMCPL09738/,,2017-03-16,2000.0,,-541714084.9200004,.
409000438620',2017-03-16,CR/703512554149/RMCPL09998/,,2017-03-16,510.0,,-541714594.9200004,.
409000438620',2017-03-16,CR/703512370285/RMCPL03986/,,2017-03-16,1500.0,,-541716094.9200004,.
409000438620',2017-03-16,CR/703512386495/RMCPL01168/,,2017-03-16,1000.0,,-541717094.9200004,.
409000438620',2017-03-16,CR/703512092770/RMCPL09294/,,2017-03-16,1250.0,,-541718344.9200004,.
409000438620',2017-03-16,CR/703512385515/RMCPL09294/,,2017-03-16,1000.0,,-541719344.9200004,.
409000438620',2017-03-16,CR/703512309677/RMCPL09294/,,2017-03-16,1250.0,,-541720594.9200004,.
409000438620',2017-03-16,CR/703512236216/RMCPL09447/,,2017-03-16,900.0,,-541721494.9200004,.
409000438620',2017-03-16,CR/705009534317/RMCPL00519/,,2017-03-16,2000.0,,-541723494.9200004,.
409000438620',2017-03-16,CR/703512189615/RMCPL05098/,,2017-03-16,1000.0,,-541724494.9200004,.
409000438620',2017-03-16,CR/705009020249/RMCPL09165/,,2017-03-16,300.0,,-541724794.9200004,.
409000438620',2017-03-16,CR/705009104725/RMCPL07788/,,2017-03-16,1.0,,-541724795.9200004,.
409000438620',2017-03-16,CR/705013137356/RMCPL01527/,,2017-03-16,2000.0,,-541726795.9200004,.
409000438620',2017-03-16,CR/703512071991/RMCPL00354/,,2017-03-16,4000.0,,-541730795.9200004,.
409000438620',2017-03-16,CR/703911488422/RMCPL00045/,,2017-03-16,500.0,,-541731295.9200004,.
409000438620',2017-03-16,CR/703911579924/RMCPL10920/,,2017-03-16,1010.0,,-541732305.9200004,.
409000438620',2017-03-16,CR/703911182508/RMCPL10920/,,2017-03-16,1010.0,,-541733315.9200004,.
409000438620',2017-03-16,CR/703911310334/RMCPL10920/,,2017-03-16,1010.0,,-541734325.9200004,.
409000438620',2017-03-16,CR/703317156763/RMCPL09386/,,2017-03-16,2020.0,,-541736345.9200004,.
409000438620',2017-03-16,CR/703911493540/RMCPL09924/,,2017-03-16,1000.0,,-541737345.9200004,.
409000438620',2017-03-16,CR/704008448119/RMCPL06758/,,2017-03-16,2100.0,,-541739445.9200004,.
409000438620',2017-03-16,CR/703911308094/RMCPL00190/,,2017-03-16,1000.0,,-541740445.9200004,.
409000438620',2017-03-16,CR/703212307247/RMCPL02151/,,2017-03-16,8200.0,,-541748645.9200004,.
409000438620',2017-03-16,CR/704712580811/RMCPL00223/,,2017-03-16,3800.0,,-541752445.9200004,.
409000438620',2017-03-16,CR/703212278067/RMCPL02418/,,2017-03-16,2000.0,,-541754445.9200004,.
409000438620',2017-03-16,CR/704014465795/RMCPL00329/,,2017-03-16,1000.0,,-541755445.9200004,.
409000438620',2017-03-16,CR/705113148431/RMCPL09119/,,2017-03-16,100.0,,-541755545.9200004,.
409000438620',2017-03-16,CR/703317220219/RMCPL10070/,,2017-03-16,300.0,,-541755845.9200004,.
409000438620',2017-03-16,CR/704010384583/RMCPL09919/,,2017-03-16,1030.0,,-541756875.9200004,.
409000438620',2017-03-16,CR/704807377583/RMCPL09792/,,2017-03-16,5.0,,-541756880.9200004,.
409000438620',2017-03-16,CR/703317380309/RMCPL09998/,,2017-03-16,5000.0,,-541761880.9200004,.
409000438620',2017-03-16,CR/703211094391/RMCPL03887/,,2017-03-16,1000.0,,-541762880.9200004,.
409000438620',2017-03-16,CR/703211089751/RMCPL08013/,,2017-03-16,500.0,,-541763380.9200004,.
409000438620',2017-03-16,CR/703911010412/RMCPL03661/,,2017-03-16,540.0,,-541763920.9200004,.
409000438620',2017-03-16,CR/703911019474/RMCPL09008/,,2017-03-16,1500.0,,-541765420.9200004,.
409000438620',2017-03-16,CR/703911076603/RMCPL00224/,,2017-03-16,550.0,,-541765970.9200004,.
409000438620',2017-03-16,CR/703911377353/RMCPL10048/,,2017-03-16,10000.0,,-541775970.9200004,.
409000438620',2017-03-16,CR/703911455506/RMCPL02141/,,2017-03-16,2000.0,,-541777970.9200004,.
409000438620',2017-03-16,CR/704712135160/RMCPL00223/,,2017-03-16,4000.0,,-541781970.9200004,.
409000438620',2017-03-16,CR/703317162046/RMCPL09286/,,2017-03-16,1000.0,,-541782970.9200004,.
409000438620',2017-03-16,CR/703211052458/RMCPL06811/,,2017-03-16,2000.0,,-541784970.9200004,.
409000438620',2017-03-16,CR/703911359246/RMCPL00023/,,2017-03-16,930.0,,-541785900.9200004,.
409000438620',2017-03-16,CR/703317249350/RMCPL00845/,,2017-03-16,2500.0,,-541788400.9200004,.
409000438620',2017-03-16,CR/703911108896/RMCPL09924/,,2017-03-16,2000.0,,-541790400.9200004,.
409000438620',2017-03-16,CR/703317444582/RMCPL00814/,,2017-03-16,500.0,,-541790900.9200004,.
409000438620',2017-03-16,CR/703911480924/RMCPL08508/,,2017-03-16,100.0,,-541791000.9200004,.
409000438620',2017-03-16,CR/704008055485/RMCPL07498/,,2017-03-16,2000.0,,-541793000.9200004,.
409000438620',2017-03-16,CR/703211468374/RMCPL00162/,,2017-03-16,2500.0,,-541795500.9200004,.
409000438620',2017-03-16,CR/703211445031/RMCPL08683/,,2017-03-16,2500.0,,-541798000.9200004,.
409000438620',2017-03-16,CR/703212432292/RMCPL08879/,,2017-03-16,7700.0,,-541805700.9200004,.
409000438620',2017-03-16,CR/703911002642/RMCPL07109/,,2017-03-16,100.0,,-541805800.9200004,.
409000438620',2017-03-16,CR/703911285457/RMCPL07109/,,2017-03-16,100.0,,-541805900.9200004,.
409000438620',2017-03-16,CR/703211137761/RMCPL04806/,,2017-03-16,4500.0,,-541810400.9200004,.
409000438620',2017-03-16,CR/704911069168/RMCPL10503/,,2017-03-16,10.0,,-541810410.9200004,.
409000438620',2017-03-16,CR/704010329046/RMCPL08777/,,2017-03-16,1500.0,,-541811910.9200004,.
409000438620',2017-03-16,CR/703211530676/RMCPL00125/,,2017-03-16,2000.0,,-541813910.9200004,.
409000438620',2017-03-16,CR/703911528993/RMCPL00126/,,2017-03-16,900.0,,-541814810.9200004,.
409000438620',2017-03-16,CR/703212498260/RMCPL01168/,,2017-03-16,2200.0,,-541817010.9200004,.
409000438620',2017-03-16,CR/703211147702/RMCPL05314/,,2017-03-16,2850.0,,-541819860.9200004,.
409000438620',2017-03-16,CR/703911420565/RMCPL06499/,,2017-03-16,2000.0,,-541821860.9200004,.
409000438620',2017-03-16,CR/703911047833/RMCPL09188/,,2017-03-16,1000.0,,-541822860.9200004,.
409000438620',2017-03-16,CR/704011317280/RMCPL00123/,,2017-03-16,2000.0,,-541824860.9200004,.
409000438620',2017-03-16,CR/703211461683/RMCPL05098/,,2017-03-16,2500.0,,-541827360.9200004,.
409000438620',2017-03-16,CR/704014552775/RMCPL00220/,,2017-03-16,300.0,,-541827660.9200004,.
409000438620',2017-03-16,CR/703911381531/RMCPL04343/,,2017-03-16,2500.0,,-541830160.9200004,.
409000438620',2017-03-16,CR/703911317187/RMCPL09249/,,2017-03-16,20.0,,-541830180.9200004,.
409000438620',2017-03-16,CR/703911021892/RMCPL00928/,,2017-03-16,2000.0,,-541832180.9200004,.
409000438620',2017-03-16,CR/703911036432/RMCPL00928/,,2017-03-16,2000.0,,-541834180.9200004,.
409000438620',2017-03-16,CR/703211035317/RMCPL09249/,,2017-03-16,500.0,,-541834680.9200004,.
409000438620',2017-03-16,CR/703212319075/RMCPL00059/,,2017-03-16,5000.0,,-541839680.9200004,.
409000438620',2017-03-16,CR/704710480392/RMCPL00223/,,2017-03-16,2500.0,,-541842180.9200004,.
409000438620',2017-03-16,CR/704710150356/RMCPL00223/,,2017-03-16,4000.0,,-541846180.9200004,.
409000438620',2017-03-16,CR/704710471026/RMCPL00223/,,2017-03-16,2500.0,,-541848680.9200004,.
409000438620',2017-03-16,CR/703911286974/RMCPL09211/,,2017-03-16,1000.0,,-541849680.9200004,.
409000438620',2017-03-16,CR/703911006328/RMCPL09152/,,2017-03-16,520.0,,-541850200.9200004,.
409000438620',2017-03-16,CR/703911172430/RMCPL00026/,,2017-03-16,1000.0,,-541851200.9200004,.
409000438620',2017-03-16,CR/703911422871/RMCPL09286/,,2017-03-16,900.0,,-541852100.9200004,.
409000438620',2017-03-16,CR/703211446848/RMCPL08637/,,2017-03-16,3000.0,,-541855100.9200004,.
409000438620',2017-03-16,CR/703211335622/RMCPL02353/,,2017-03-16,7700.0,,-541862800.9200004,.
409000438620',2017-03-16,CR/703911173385/RMCPL00100/,,2017-03-16,100.0,,-541862900.9200004,.
409000438620',2017-03-16,CR/704010260895/RMCPL00145/,,2017-03-16,2000.0,,-541864900.9200004,.
409000438620',2017-03-16,CR/704011026006/RMCPL09649/,,2017-03-16,510.0,,-541865410.9200004,.
409000438620',2017-03-16,CR/703211538213/RMCPL10110/,,2017-03-16,1000.0,,-541866410.9200004,.
409000438620',2017-03-16,CR/703317488484/RMCPL09286/,,2017-03-16,4000.0,,-541870410.9200004,.
409000438620',2017-03-16,CR/704711049160/RMCPL00223/,,2017-03-16,2000.0,,-541872410.9200004,.
409000438620',2017-03-16,CR/704711562449/RMCPL00223/,,2017-03-16,4000.0,,-541876410.9200004,.
409000438620',2017-03-16,CR/704711305102/RMCPL00223/,,2017-03-16,4000.0,,-541880410.9200004,.
409000438620',2017-03-16,CR/703211365010/RMCPL08879/,,2017-03-16,10000.0,,-541890410.9200004,.
409000438620',2017-03-16,CR/703911422771/RMCPL00095/,,2017-03-16,9000.0,,-541899410.9200004,.
409000438620',2017-03-16,CR/703911233833/RMCPL07955/,,2017-03-16,500.0,,-541899910.9200004,.
409000438620',2017-03-16,CR/704014110559/RMCPL00928/,,2017-03-16,2000.0,,-541901910.9200004,.
409000438620',2017-03-16,CR/704014253721/RMCPL00928/,,2017-03-16,2000.0,,-541903910.9200004,.
409000438620',2017-03-16,CR/704008048580/RMCPL01300/,,2017-03-16,1000.0,,-541904910.9200004,.
409000438620',2017-03-16,CR/703912339722/RMCPL09924/,,2017-03-16,1500.0,,-541906410.9200004,.
409000438620',2017-03-16,CR/703211532649/RMCPL02313/,,2017-03-16,2000.0,,-541908410.9200004,.
409000438620',2017-03-16,CR/703317579194/RMCPL00925/,,2017-03-16,1540.0,,-541909950.9200004,.
409000438620',2017-03-16,CR/703911581932/RMCPL07498/,,2017-03-16,2000.0,,-541911950.9200004,.
409000438620',2017-03-16,CR/703211500952/RMCPL05245/,,2017-03-16,1000.0,,-541912950.9200004,.
409000438620',2017-03-16,CR/703211266847/RMCPL05245/,,2017-03-16,4000.0,,-541916950.9200004,.
409000438620',2017-03-16,CR/703211398286/RMCPL09183/,,2017-03-16,3000.0,,-541919950.9200004,.
409000438620',2017-03-16,CR/703211268518/RMCPL09183/,,2017-03-16,3000.0,,-541922950.9200004,.
409000438620',2017-03-16,CR/703911475322/RMCPL10034/,,2017-03-16,2000.0,,-541924950.9200004,.
409000438620',2017-03-16,CR/703211163838/RMCPL01228/,,2017-03-16,1500.0,,-541926450.9200004,.
409000438620',2017-03-16,CR/704008529622/RMCPL07947/,,2017-03-16,2000.0,,-541928450.9200004,.
409000438620',2017-03-16,CR/704014408592/RMCPL09505/,,2017-03-16,10000.0,,-541938450.9200004,.
409000438620',2017-03-16,CR/704011058766/RMCPL06499/,,2017-03-16,2000.0,,-541940450.9200004,.
409000438620',2017-03-16,CR/703212542177/RMCPL09959/,,2017-03-16,2000.0,,-541942450.9200004,.
409000438620',2017-03-16,CR/703211433653/RMCPL09249/,,2017-03-16,2000.0,,-541944450.9200004,.
409000438620',2017-03-16,CR/703211098694/RMCPL04006/,,2017-03-16,700.0,,-541945150.9200004,.
409000438620',2017-03-16,CR/703211573802/RMCPL00093/,,2017-03-16,50.0,,-541945200.9200004,.
409000438620',2017-03-16,CR/703211255169/RMCPL09286/,,2017-03-16,900.0,,-541946100.9200004,.
409000438620',2017-03-16,CR/704010388327/RMCPL09449/,,2017-03-16,2040.0,,-541948140.9200004,.
409000438620',2017-03-16,CR/703211266350/RMCPL00225/,,2017-03-16,1000.0,,-541949140.9200004,.
409000438620',2017-03-16,CR/703211505320/RMCPL00118/,,2017-03-16,3000.0,,-541952140.9200004,.
409000438620',2017-03-16,CR/704713473092/RMCPL00223/,,2017-03-16,1000.0,,-541953140.9200004,.
409000438620',2017-03-16,CR/704713516552/RMCPL00223/,,2017-03-16,4000.0,,-541957140.9200004,.
409000438620',2017-03-16,CR/703211379113/RMCPL05149/,,2017-03-16,10000.0,,-541967140.9200004,.
409000438620',2017-03-16,CR/704010307539/RMCPL09249/,,2017-03-16,500.0,,-541967640.9200004,.
409000438620',2017-03-16,CR/704010489063/RMCPL00093/,,2017-03-16,10000.0,,-541977640.9200004,.
409000438620',2017-03-16,CR/703211427974/RMCPL09222/,,2017-03-16,1000.0,,-541978640.9200004,.
409000438620',2017-03-16,CR/703211211256/RMCPL00045/,,2017-03-16,5000.0,,-541983640.9200004,.
409000438620',2017-03-16,CR/704011352380/RMCPL00222/,,2017-03-16,2500.0,,-541986140.9200004,.
409000438620',2017-03-16,CR/704718359754/RMCPL09150/,,2017-03-16,10.0,,-541986150.9200004,.
409000438620',2017-03-16,CR/703211580587/RMCPL09738/,,2017-03-16,200.0,,-541986350.9200004,.
409000438620',2017-03-16,CR/704011230307/RMCPL09998/,,2017-03-16,2500.0,,-541988850.9200004,.
409000438620',2017-03-16,CR/703911345485/RMCPL09100/,,2017-03-16,300.0,,-541989150.9200004,.
409000438620',2017-03-16,CR/703911175459/RMCPL09100/,,2017-03-16,300.0,,-541989450.9200004,.
409000438620',2017-03-16,CR/703911152224/RMCPL03661/,,2017-03-16,9950.0,,-541999400.9200004,.
409000438620',2017-03-16,CR/704011004810/RMCPL07109/,,2017-03-16,10.0,,-541999410.9200004,.
409000438620',2017-03-16,CR/704011042718/RMCPL01300/,,2017-03-16,4500.0,,-542003910.9200004,.
409000438620',2017-03-16,CR/703911127410/RMCPL00012/,,2017-03-16,1800.0,,-542005710.9200004,.
409000438620',2017-03-16,CR/703211018962/RMCPL02953/,,2017-03-16,2000.0,,-542007710.9200004,.
409000438620',2017-03-16,CR/703211063126/RMCPL08124/,,2017-03-16,1560.0,,-542009270.9200004,.
409000438620',2017-03-16,CR/704809510689/RMCPL09918/,,2017-03-16,10.0,,-542009280.9200004,.
409000438620',2017-03-16,CR/703911241850/RMCPL09726/,,2017-03-16,200.0,,-542009480.9200004,.
409000438620',2017-03-16,CR/704011108334/RMCPL00225/,,2017-03-16,2000.0,,-542011480.9200004,.
409000438620',2017-03-16,CR/703911152979/RMCPL09152/,,2017-03-16,1050.0,,-542012530.9200004,.
409000438620',2017-03-16,CR/704012246607/RMCPL09505/,,2017-03-16,1.0,,-542012531.9200004,.
409000438620',2017-03-16,CR/705613136683/RMCPL09744/,,2017-03-16,1.0,,-542012532.9200004,.
409000438620',2017-03-16,CR/705612116986/RMCPL09744/,,2017-03-16,3.0,,-542012535.9200004,.
409000438620',2017-03-16,CR/704011496173/RMCPL07310/,,2017-03-16,2000.0,,-542014535.9200004,.
409000438620',2017-03-16,CR/704011500521/RMCPL07310/,,2017-03-16,2000.0,,-542016535.9200004,.
409000438620',2017-03-16,CR/703211330110/RMCPL09998/,,2017-03-16,800.0,,-542017335.9200004,.
409000438620',2017-03-16,CR/703211398191/RMCPL01960/,,2017-03-16,5000.0,,-542022335.9200004,.
409000438620',2017-03-16,CR/703911068849/RMCPL09704/,,2017-03-16,3500.0,,-542025835.9200004,.
409000438620',2017-03-16,CR/703911483576/RMCPL09175/,,2017-03-16,2000.0,,-542027835.9200004,.
409000438620',2017-03-16,CR/703912347610/RMCPL10070/,,2017-03-16,2010.0,,-542029845.9200004,.
409000438620',2017-03-16,CR/703911170950/RMCPL02810/,,2017-03-16,200.0,,-542030045.9200004,.
409000438620',2017-03-16,CR/703211192726/RMCPL06595/,,2017-03-16,2000.0,,-542032045.9200004,.
409000438620',2017-03-16,CR/703211477582/RMCPL06595/,,2017-03-16,2000.0,,-542034045.9200004,.
409000438620',2017-03-16,CR/703911599560/RMCPL09067/,,2017-03-16,700.0,,-542034745.9200004,.
409000438620',2017-03-16,CR/704008261749/RMCPL02092/,,2017-03-16,4000.0,,-542038745.9200004,.
409000438620',2017-03-16,CR/703418176843/RMCPL00130/,,2017-03-16,100.0,,-542038845.9200004,.
409000438620',2017-03-16,CR/704710230780/RMCPL00223/,,2017-03-16,4000.0,,-542042845.9200004,.
409000438620',2017-03-16,CR/704710312656/RMCPL00223/,,2017-03-16,4000.0,,-542046845.9200004,.
409000438620',2017-03-16,CR/704712050798/RMCPL00223/,,2017-03-16,2100.0,,-542048945.9200004,.
409000438620',2017-03-16,CR/705816566753/RMCPL09531/,,2017-03-16,1.0,,-542048946.9200004,.
409000438620',2017-03-16,CR/705810099708/RMCPL09146/,,2017-03-16,100.0,,-542049046.9200004,.
409000438620',2017-03-16,AEPS Indiaforensic INCOME 150317,,2017-03-16,,38401.33,-542010645.5900004,.
409000438620',2017-03-16,AEPS Indiaforensic S TAX 150317,,2017-03-16,,5760.2,-542004885.3900003,.
409000438620',2017-03-16,TRF TO  Indiaforensic SERVICES I,,2017-03-16,4000000.0,,-546004885.3900003,.
409000438620',2017-03-16,TRF TO  Indiaforensic SERVICES I,,2017-03-16,117000.0,,-546121885.3900003,.
409000438620',2017-03-16,Indiaforensic AEPS NPCI WDL SET,,2017-03-16,,6894754.0,-539227131.3900003,.
409000438620',2017-03-16,Indiaforensic AEPS NPCI DEP SET,,2017-03-16,2341595.0,,-541568726.3900003,.
409000438620',2017-03-17,TRF TO  Indiaforensic SERVICES I,,2017-03-17,150000.0,,-541718726.3900003,.
409000438620',2017-03-17,Indiaforensic AEPS NPCI WDL SET,,2017-03-17,,6167414.0,-535551312.39000034,.
409000438620',2017-03-17,Indiaforensic AEPS NPCI DEP SET,,2017-03-17,2761468.0,,-538312780.3900003,.
409000438620',2017-03-17,TRF TO  Indiaforensic SERVICES I,,2017-03-17,4500000.0,,-542812780.3900003,.
409000438620',2017-03-17,TRF TO  Indiaforensic SERVICES I,,2017-03-17,3500000.0,,-546312780.3900003,.
409000438620',2017-03-17,AEPS Indiaforensic INCOME 160317,,2017-03-17,,37531.25,-546275249.1400003,.
409000438620',2017-03-17,AEPS Indiaforensic S TAX 160317,,2017-03-17,,5629.69,-546269619.4500003,.
409000438620',2017-03-18,AEPS Indiaforensic INCOME 170317,,2017-03-18,,36706.07,-546232913.3800002,.
409000438620',2017-03-18,AEPS Indiaforensic S TAX 170317,,2017-03-18,,5505.91,-546227407.4700003,.
409000438620',2017-03-18,Indiaforensic AEPS NPCI WDL SET,,2017-03-18,,5885633.0,-540341774.4700003,.
409000438620',2017-03-18,Indiaforensic AEPS NPCI DEP SET,,2017-03-18,2897669.0,,-543239443.4700003,.
409000438620',2017-03-20,TRF TO  Indiaforensic SERVICES I,,2017-03-20,3000000.0,,-546239443.4700003,.
409000438620',2017-03-20,AEPS ACQUIRING ADJ FEES 1,,2017-03-20,17.25,,-546239460.7200003,.
409000438620',2017-03-20,AEPS Indiaforensic INCOME 180317,,2017-03-20,,36592.51,-546202868.2100003,.
409000438620',2017-03-20,AEPS Indiaforensic S TAX 180317,,2017-03-20,,5488.88,-546197379.3300003,.
409000438620',2017-03-20,AEPS Indiaforensic INCOME 190317,,2017-03-20,,30044.52,-546167334.8100003,.
409000438620',2017-03-20,AEPS Indiaforensic S TAX 190317,,2017-03-20,,4506.68,-546162828.1300004,.
409000438620',2017-03-20,Indiaforensic AEPS NPCI WDL SET,,2017-03-20,,5717143.0,-540445685.1300004,.
409000438620',2017-03-20,Indiaforensic AEPS NPCI DEP SET,,2017-03-20,2854865.0,,-543300550.1300004,.
409000438620',2017-03-20,Indiaforensic AEPS NPCI WDL SET,,2017-03-20,,4723661.0,-538576889.1300004,.
409000438620',2017-03-20,Indiaforensic AEPS NPCI DEP SET,,2017-03-20,1865816.0,,-540442705.1300004,.
409000438620',2017-03-21,AEPS Indiaforensic INCOME 200317,,2017-03-21,,39313.54,-540403391.5900004,.
409000438620',2017-03-21,AEPS Indiaforensic S TAX 200317,,2017-03-21,,5897.03,-540397494.5600004,.
409000438620',2017-03-21,TRF TO  Indiaforensic SERVICES I,,2017-03-21,5700000.0,,-546097494.5600004,.
409000438620',2017-03-21,TRF TO  Indiaforensic SERVICES I,,2017-03-21,200000.0,,-546297494.5600004,.
409000438620',2017-03-21,Indiaforensic AEPS NPCI WDL SET,,2017-03-21,,6226847.0,-540070647.5600004,.
409000438620',2017-03-21,Indiaforensic AEPS NPCI DEP SET,,2017-03-21,2887957.0,,-542958604.5600004,.
409000438620',2017-03-22,AEPS ACQUIRING ADJ FEES 2,,2017-03-22,,17.25,-542958587.3100004,.
409000438620',2017-03-22,AEPS Indiaforensic INCOME 210317,,2017-03-22,,40705.3,-542917882.0100005,.
409000438620',2017-03-22,AEPS Indiaforensic S TAX 210317,,2017-03-22,,6105.8,-542911776.2100005,.
409000438620',2017-03-22,TRF TO  Indiaforensic SERVICES I,,2017-03-22,3000000.0,,-545911776.2100005,.
409000438620',2017-03-22,Indiaforensic AEPS NPCI WDL SET,,2017-03-22,,6464477.0,-539447299.2100005,.
409000438620',2017-03-22,Indiaforensic AEPS NPCI DEP SET,,2017-03-22,3066079.0,,-542513378.2100005,.
409000438620',2017-03-23,AEPS Indiaforensic INCOME 220317,,2017-03-23,,41309.28,-542472068.9300005,.
409000438620',2017-03-23,AEPS Indiaforensic S TAX 220317,,2017-03-23,,6196.39,-542465872.5400006,.
409000438620',2017-03-23,TRF TO  Indiaforensic SERVICES I,,2017-03-23,3800000.0,,-546265872.5400006,.
409000438620',2017-03-23,Indiaforensic AEPS NPCI WDL SET,,2017-03-23,,6267951.0,-539997921.5400006,.
409000438620',2017-03-23,Indiaforensic AEPS NPCI DEP SET,,2017-03-23,3391283.0,,-543389204.5400006,.
409000438620',2017-03-24,AEPS Indiaforensic INCOME 230317,,2017-03-24,,47043.27,-543342161.2700006,.
409000438620',2017-03-24,AEPS Indiaforensic S TAX 230317,,2017-03-24,,7056.49,-543335104.7800006,.
409000438620',2017-03-24,TRF TO  Indiaforensic SERVICES I,,2017-03-24,2900000.0,,-546235104.7800006,.
409000438620',2017-03-24,Indiaforensic AEPS NPCI WDL SET,,2017-03-24,,7655501.0,-538579603.7800006,.
409000438620',2017-03-24,Indiaforensic AEPS NPCI DEP SET,,2017-03-24,3777149.0,,-542356752.7800006,.
409000438620',2017-03-27,TRF TO  Indiaforensic SERVICES I,,2017-03-27,3900000.0,,-546256752.7800006,.
409000438620',2017-03-27,AEPS Indiaforensic INCOME 240317,,2017-03-27,,47465.9,-546209286.8800006,.
409000438620',2017-03-27,AEPS Indiaforensic S TAX 240317,,2017-03-27,,7119.89,-546202166.9900006,.
409000438620',2017-03-27,AEPS Indiaforensic INCOME 250317,,2017-03-27,,42527.17,-546159639.8200006,.
409000438620',2017-03-27,AEPS Indiaforensic S TAX 250317,,2017-03-27,,6379.08,-546153260.7400006,.
409000438620',2017-03-27,AEPS Indiaforensic INCOME 260317,,2017-03-27,,25070.11,-546128190.6300006,.
409000438620',2017-03-27,AEPS Indiaforensic S TAX 260317,,2017-03-27,,3760.52,-546124430.1100006,.
409000438620',2017-03-27,Indiaforensic AEPS NPCI WDL SET,,2017-03-27,,7427011.0,-538697419.1100006,.
409000438620',2017-03-27,Indiaforensic AEPS NPCI WDL SET,,2017-03-27,,6703731.0,-531993688.1100006,.
409000438620',2017-03-27,Indiaforensic AEPS NPCI WDL SET,,2017-03-27,,3812734.0,-528180954.1100006,.
409000438620',2017-03-27,Indiaforensic AEPS NPCI DEP SET,,2017-03-27,3799792.0,,-531980746.1100006,.
409000438620',2017-03-27,Indiaforensic AEPS NPCI DEP SET,,2017-03-27,2929877.0,,-534910623.1100006,.
409000438620',2017-03-27,Indiaforensic AEPS NPCI DEP SET,,2017-03-27,1799382.0,,-536710005.1100006,.
409000438620',2017-03-27,TRF TO  Indiaforensic SERVICES I,,2017-03-27,9000000.0,,-545710005.1100006,.
409000438620',2017-03-27,TRF TO  Indiaforensic VIRTUAL VI,,2017-03-27,500000.0,,-546210005.1100006,.
409000438620',2017-03-29,AEPS ACQUIRING ADJ FEES 2,,2017-03-29,17.25,,-546210022.3600006,.
409000438620',2017-03-29,AEPS Indiaforensic INCOME 270317,,2017-03-29,,48842.35,-546161180.0100006,.
409000438620',2017-03-29,AEPS Indiaforensic S TAX 270317,,2017-03-29,,7326.35,-546153853.6600006,.
409000438620',2017-03-29,AEPS Indiaforensic INCOME 280317,,2017-03-29,,49909.85,-546103943.8100005,.
409000438620',2017-03-29,AEPS Indiaforensic S TAX 280317,,2017-03-29,,7486.48,-546096457.3300005,.
409000438620',2017-03-29,Indiaforensic AEPS NPCI WDL SET,,2017-03-29,,7561466.0,-538534991.3300005,.
409000438620',2017-03-29,Indiaforensic AEPS NPCI WDL SET,,2017-03-29,,7529999.0,-531004992.3300005,.
409000438620',2017-03-29,Indiaforensic AEPS NPCI DEP SET,,2017-03-29,3901134.0,,-534906126.3300005,.
409000438620',2017-03-29,Indiaforensic AEPS NPCI DEP SET,,2017-03-29,3638187.0,,-538544313.3300005,.
409000438620',2017-03-30,AEPS Indiaforensic INCOME 290317,,2017-03-30,,40384.25,-538503929.0800005,.
409000438620',2017-03-30,AEPS Indiaforensic S TAX 290317,,2017-03-30,,6057.64,-538497871.4400005,.
409000438620',2017-03-30,TRF TO  Indiaforensic SERVICES I,,2017-03-30,7800000.0,,-546297871.4400005,.
409000438620',2017-03-30,Indiaforensic AEPS NPCI WDL SET,,2017-03-30,,5893354.0,-540404517.4400005,.
409000438620',2017-03-30,Indiaforensic AEPS NPCI DEP SET,,2017-03-30,3190213.0,,-543594730.4400005,.
409000438620',2017-03-31,AEPS ACQUIRING ADJ FEES 3,,2017-03-31,17.25,,-543594747.6900005,.
409000438620',2017-03-31,AEPS Indiaforensic INCOME 300317,,2017-03-31,,48081.48,-543546666.2100005,.
409000438620',2017-03-31,AEPS Indiaforensic S TAX 300317,,2017-03-31,,7212.22,-543539453.9900005,.
409000438620',2017-03-31,Indiaforensic AEPS NPCI WDL SET,,2017-03-31,,7152014.0,-536387439.9900005,.
409000438620',2017-03-31,Indiaforensic AEPS NPCI DEP SET,,2017-03-31,3942761.0,,-540330200.9900005,.
409000438620',2017-03-31,CB702112054142/RMCPL05050/2,,2017-03-31,2000.0,,-540332200.9900005,.
409000438620',2017-03-31,TRF TO  Indiaforensic SERVICES I,,2017-03-31,5900000.0,,-546232200.9900005,.
409000438620',2017-03-31,REV Indfor AEPS NPCI DEP SET,,2017-03-31,,100.0,-546232100.9900005,.
409000438620',2017-03-31,REV Indfor AEPS NPCI WDL SET,,2017-03-31,100.0,,-546232200.9900005,.
409000438620',2017-04-03,AEPS ACQUIRING ADJ FEES 3,,2017-04-03,,34.5,-546232166.4900005,.
409000438620',2017-04-03,AEPS Indiaforensic INCOME 310317,,2017-04-03,,48327.68,-546183838.8100005,.
409000438620',2017-04-03,AEPS Indiaforensic S TAX 310317,,2017-04-03,,7249.15,-546176589.6600006,.
409000438620',2017-04-03,AEPS Indiaforensic INCOME 010417,,2017-04-03,,12740.61,-546163849.0500005,.
409000438620',2017-04-03,AEPS Indiaforensic S TAX 010417,,2017-04-03,,1911.09,-546161937.9600005,.
409000438620',2017-04-03,AEPS Indiaforensic INCOME 020417,,2017-04-03,,32354.44,-546129583.5200005,.
409000438620',2017-04-03,AEPS Indiaforensic S TAX 020417,,2017-04-03,,4853.17,-546124730.3500005,.
409000438620',2017-04-03,Indiaforensic AEPS NPCI WDL SET,,2017-04-03,,6902898.0,-539221832.3500005,.
409000438620',2017-04-03,Indiaforensic AEPS NPCI WDL SET,,2017-04-03,,1927607.0,-537294225.3500005,.
409000438620',2017-04-03,Indiaforensic AEPS NPCI WDL SET,,2017-04-03,,4798437.0,-532495788.3500005,.
409000438620',2017-04-03,Indiaforensic AEPS NPCI DEP SET,,2017-04-03,4074057.0,,-536569845.3500005,.
409000438620',2017-04-03,Indiaforensic AEPS NPCI DEP SET,,2017-04-03,816532.0,,-537386377.3500005,.
409000438620',2017-04-03,Indiaforensic AEPS NPCI DEP SET,,2017-04-03,2260197.0,,-539646574.3500005,.
409000438620',2017-04-04,TRF TO  Indiaforensic SERVICES I,,2017-04-04,100000.0,,-539746574.3500005,.
409000438620',2017-04-04,TRF TO  Indiaforensic SERVICES I,,2017-04-04,6500000.0,,-546246574.3500005,.
409000438620',2017-04-05,AEPS Indiaforensic INCOME 030417,,2017-04-05,,55910.28,-546190664.0700005,.
409000438620',2017-04-05,AEPS Indiaforensic S TAX 030417,,2017-04-05,,8386.54,-546182277.5300006,.
409000438620',2017-04-05,AEPS Indiaforensic INCOME 040417,,2017-04-05,,48413.24,-546133864.2900006,.
409000438620',2017-04-05,AEPS Indiaforensic S TAX 040417,,2017-04-05,,7261.99,-546126602.3000005,.
409000438620',2017-04-05,TRF TO  Indiaforensic SERVICES I,,2017-04-05,50000.0,,-546176602.3000005,.
409000438620',2017-04-05,Indiaforensic AEPS NPCI WDL SET,,2017-04-05,,8712507.0,-537464095.3000005,.
409000438620',2017-04-05,Indiaforensic AEPS NPCI WDL SET,,2017-04-05,,6933616.0,-530530479.30000055,.
409000438620',2017-04-05,Indiaforensic AEPS NPCI DEP SET,,2017-04-05,4212561.0,,-534743040.30000055,.
409000438620',2017-04-05,Indiaforensic AEPS NPCI DEP SET,,2017-04-05,4235901.0,,-538978941.3000005,.
409000438620',2017-04-05,TRF TO  Indiaforensic SERVICES I,,2017-04-05,7000000.0,,-545978941.3000005,.
409000438620',2017-04-06,AEPS Indiaforensic INCOME 050417,,2017-04-06,,44065.55,-545934875.7500006,.
409000438620',2017-04-06,AEPS Indiaforensic S TAX 050417,,2017-04-06,,6609.83,-545928265.9200006,.
409000438620',2017-04-06,Indiaforensic AEPS NPCI WDL SET,,2017-04-06,,6597518.0,-539330747.9200006,.
409000438620',2017-04-06,Indiaforensic AEPS NPCI DEP SET,,2017-04-06,3766291.0,,-543097038.9200006,.
409000438620',2017-04-06,TRF TO  Indiaforensic VIRTUAL VI,,2017-04-06,2000000.0,,-545097038.9200006,.
409000438620',2017-04-06,TRF TO  Indiaforensic SERVICES I,,2017-04-06,1200000.0,,-546297038.9200006,.
409000438620',2017-04-07,AEPS Indiaforensic INCOME 060417,,2017-04-07,,54746.1,-546242292.8200005,.
409000438620',2017-04-07,AEPS Indiaforensic S TAX 060417,,2017-04-07,,8211.92,-546234080.9000006,.
409000438620',2017-04-07,Indiaforensic AEPS NPCI WDL SET,,2017-04-07,,7938518.0,-538295562.9000006,.
409000438620',2017-04-07,Indiaforensic AEPS NPCI DEP SET,,2017-04-07,5099347.0,,-543394909.9000006,.
409000438620',2017-04-10,AEPS Indiaforensic INCOME 070417,,2017-04-10,,62324.6,-543332585.3000005,.
409000438620',2017-04-10,AEPS Indiaforensic S TAX 070417,,2017-04-10,,9348.69,-543323236.6100005,.
409000438620',2017-04-10,AEPS Indiaforensic INCOME 080417,,2017-04-10,,58781.02,-543264455.5900005,.
409000438620',2017-04-10,AEPS Indiaforensic S TAX 080417,,2017-04-10,,8817.15,-543255638.4400005,.
409000438620',2017-04-10,AEPS Indiaforensic INCOME 090417,,2017-04-10,,45106.56,-543210531.8800006,.
409000438620',2017-04-10,AEPS Indiaforensic S TAX 090417,,2017-04-10,,6765.98,-543203765.9000006,.
409000438620',2017-04-10,TRF TO  Indiaforensic SERVICES I,,2017-04-10,3000000.0,,-546203765.9000006,.
409000438620',2017-04-10,Indiaforensic AEPS NPCI WDL SET,,2017-04-10,,10149455.0,-536054310.9000006,.
409000438620',2017-04-10,Indiaforensic AEPS NPCI WDL SET,,2017-04-10,,10137924.0,-525916386.9000006,.
409000438620',2017-04-10,Indiaforensic AEPS NPCI WDL SET,,2017-04-10,,7285363.0,-518631023.9000006,.
409000438620',2017-04-10,Indiaforensic AEPS NPCI DEP SET,,2017-04-10,4662743.0,,-523293766.9000006,.
409000438620',2017-04-10,Indiaforensic AEPS NPCI DEP SET,,2017-04-10,4669640.0,,-527963406.9000006,.
409000438620',2017-04-10,Indiaforensic AEPS NPCI DEP SET,,2017-04-10,3938242.0,,-531901648.9000006,.
409000438620',2017-04-11,AEPS Indiaforensic INCOME 100417,,2017-04-11,,78440.74,-531823208.16000056,.
409000438620',2017-04-11,AEPS Indiaforensic S TAX 100417,,2017-04-11,,11766.11,-531811442.05000055,.
409000438620',2017-04-11,Indiaforensic AEPS NPCI WDL SET,,2017-04-11,,13572775.0,-518238667.05000055,.
409000438620',2017-04-11,Indiaforensic AEPS NPCI DEP SET,,2017-04-11,6926158.0,,-525164825.05000055,.
409000438620',2017-04-12,TRF TO  Indiaforensic SERVICES I,,2017-04-12,15000000.0,,-540164825.0500005,.
409000438620',2017-04-12,TRF TO  Indiaforensic SERVICES I,,2017-04-12,6000000.0,,-546164825.0500005,.
409000438620',2017-04-12,AEPS Indiaforensic INCOME 110417,,2017-04-12,,79785.15,-546085039.9000006,.
409000438620',2017-04-12,AEPS Indiaforensic S TAX 110417,,2017-04-12,,11967.77,-546073072.1300006,.
409000438620',2017-04-12,Indiaforensic AEPS NPCI WDL SET,,2017-04-12,,14051707.0,-532021365.1300006,.
409000438620',2017-04-12,Indiaforensic AEPS NPCI DEP SET,,2017-04-12,6363852.0,,-538385217.1300006,.
409000438620',2017-04-12,TRF TO  Indiaforensic SERVICES I,,2017-04-12,7900000.0,,-546285217.1300006,.
409000438620',2017-04-13,AEPS Indiaforensic INCOME 120417,,2017-04-13,,62417.38,-546222799.7500006,.
409000438620',2017-04-13,AEPS Indiaforensic S TAX 120417,,2017-04-13,,9362.61,-546213437.1400006,.
409000438620',2017-04-13,Indiaforensic AEPS NPCI WDL SET,,2017-04-13,,10980031.0,-535233406.1400006,.
409000438620',2017-04-13,Indiaforensic AEPS NPCI DEP SET,,2017-04-13,4870828.0,,-540104234.1400006,.
409000438620',2017-04-13,TRF TO  Indiaforensic SERVICES I,,2017-04-13,6200000.0,,-546304234.1400006,.
409000438620',2017-04-15,AEPS Indiaforensic INCOME 130417,,2017-04-15,,79457.44,-546224776.7000005,.
409000438620',2017-04-15,AEPS Indiaforensic S TAX 130417,,2017-04-15,,11918.62,-546212858.0800005,.
409000438620',2017-04-15,AEPS Indiaforensic INCOME 140417,,2017-04-15,,44918.31,-546167939.7700006,.
409000438620',2017-04-15,AEPS Indiaforensic S TAX 140417,,2017-04-15,,6737.75,-546161202.0200006,.
409000438620',2017-04-15,Indiaforensic AEPS NPCI WDL SET,,2017-04-15,,28590307.0,-517570895.0200006,.
409000438620',2017-04-15,Indiaforensic AEPS NPCI WDL SET,,2017-04-15,,16163369.0,-501407526.0200006,.
409000438620',2017-04-15,Indiaforensic AEPS NPCI DEP SET,,2017-04-15,9282476.0,,-510690002.0200006,.
409000438620',2017-04-15,Indiaforensic AEPS NPCI DEP SET,,2017-04-15,6627852.0,,-517317854.0200006,.
409000438620',2017-04-17,AEPS Indiaforensic INCOME 150417,,2017-04-17,,73487.96,-517244366.0600006,.
409000438620',2017-04-17,AEPS Indiaforensic S TAX 150417,,2017-04-17,,11023.19,-517233342.8700006,.
409000438620',2017-04-17,AEPS Indiaforensic INCOME 160417,,2017-04-17,,43714.11,-517189628.7600006,.
409000438620',2017-04-17,AEPS Indiaforensic S TAX 160417,,2017-04-17,,6557.12,-517183071.6400006,.
409000438620',2017-04-17,TRF TO  Indiaforensic SERVICES I,,2017-04-17,15000000.0,,-532183071.6400006,.
409000438620',2017-04-17,TRF TO  Indiaforensic SERVICES I,,2017-04-17,13900000.0,,-546083071.6400006,.
409000438620',2017-04-17,REV Indiaforensic AEPS NPCI DEP,,2017-04-17,,9282476.0,-536800595.6400006,.
409000438620',2017-04-17,REV Indiaforensic AEPS NPCI DEP,,2017-04-17,,6627852.0,-530172743.6400006,.
409000438620',2017-04-17,Indiaforensic AEPS NPCI DEP SET,,2017-04-17,,13985222.0,-516187521.6400006,.
409000438620',2017-04-17,Indiaforensic AEPS NPCI DEP SET,,2017-04-17,,7913648.0,-508273873.6400006,.
409000438620',2017-04-17,Indiaforensic AEPS NPCI DEP SET,,2017-04-17,,12008218.0,-496265655.6400006,.
409000438620',2017-04-17,Indiaforensic AEPS NPCI DEP SET,,2017-04-17,,7057145.0,-489208510.6400006,.
409000438620',2017-04-17,REV Indiaforensic AEPS NPCI WDL,,2017-04-17,28590307.0,,-517798817.6400006,.
409000438620',2017-04-17,REV Indiaforensic AEPS NPCI WDL,,2017-04-17,16163369.0,,-533962186.6400006,.
409000438620',2017-04-17,Indiaforensic AEPS NPCI DEP SET,,2017-04-17,5943977.0,,-539906163.6400006,.
409000438620',2017-04-17,Indiaforensic AEPS NPCI DEP SET,,2017-04-17,3595581.0,,-543501744.6400006,.
409000438620',2017-04-18,RPN AEPS NPCI WDL SET 170,,2017-04-18,,422888.0,-543078856.6400006,.
409000438620',2017-04-18,REV RPN AEPS NPCI WDL SET,,2017-04-18,422888.0,,-543501744.6400006,.
409000438620',2017-04-18,TRF FRM  Indiaforensic SERVICES,,2017-04-18,,3400000.0,-540101744.6400006,.
409000438620',2017-04-18,Indiaforensic AEPS NPCI WDL SET,,2017-04-18,,11399171.0,-528702573.6400006,.
409000438620',2017-04-18,Indiaforensic AEPS NPCI DEP SET,,2017-04-18,6457952.0,,-535160525.6400006,.
409000438620',2017-04-18,Indiaforensic AEPS NPCI DEP SET,,2017-04-18,3681096.0,,-538841621.6400006,.
409000438620',2017-04-18,Indiaforensic AEPS NPCI DEP SET,,2017-04-18,6137957.0,,-544979578.6400006,.
409000438620',2017-04-18,AEPS Indiaforensic INCOME 170417,,2017-04-18,,71093.7,-544908484.9400005,.
409000438620',2017-04-18,AEPS Indiaforensic S TAX 170417,,2017-04-18,,10664.06,-544897820.8800006,.
409000438620',2017-04-19,Indiaforensic AEPS NPCI WDL SET,,2017-04-19,,11464674.0,-533433146.8800006,.
409000438620',2017-04-19,Indiaforensic AEPS NPCI DEP SET,,2017-04-19,5468347.0,,-538901493.8800006,.
409000438620',2017-04-19,AEPS Indiaforensic INCOME 180417,,2017-04-19,,68399.46,-538833094.4200006,.
409000438620',2017-04-19,AEPS Indiaforensic S TAX 180417,,2017-04-19,,10259.92,-538822834.5000006,.
409000438620',2017-04-19,Indiaforensic RIF AEPS NPCI WDL,,2017-04-19,4200.0,,-538827034.5000006,.
409000438620',2017-04-19,TRF TO  Indiaforensic SERVICES I,,2017-04-19,1400000.0,,-540227034.5000006,.
409000438620',2017-04-20,AEPS Indiaforensic INCOME 190417,,2017-04-20,,71710.87,-540155323.6300006,.
409000438620',2017-04-20,AEPS Indiaforensic S TAX 190417,,2017-04-20,,10756.63,-540144567.0000006,.
409000438620',2017-04-20,Indiaforensic AEPS NPCI WDL SET,,2017-04-20,,10914591.0,-529229976.0000006,.
409000438620',2017-04-20,Indfor RIF AEPS NPCI WDL SET,,2017-04-20,,3400.0,-529226576.0000006,.
409000438620',2017-04-20,Indiaforensic AEPS NPCI DEP SET,,2017-04-20,6704972.0,,-535931548.0000006,.
409000438620',2017-04-20,TRF TO  Indiaforensic SERVICES I,,2017-04-20,10000000.0,,-545931548.0000006,.
409000438620',2017-04-21,AEPS Indiaforensic INCOME 200417,,2017-04-21,,73100.59,-545858447.4100006,.
409000438620',2017-04-21,AEPS Indiaforensic S TAX 200417,,2017-04-21,,10965.09,-545847482.3200005,.
409000438620',2017-04-21,Indiaforensic AEPS NPCI WDL SET,,2017-04-21,,10850606.0,-534996876.3200005,.
409000438620',2017-04-21,Indfor RIF AEPS NPCI WDL SET,,2017-04-21,,4000.0,-534992876.3200005,.
409000438620',2017-04-21,Indiaforensic AEPS NPCI DEP SET,,2017-04-21,6560531.0,,-541553407.3200005,.
409000438620',2017-04-21,TRF TO  Indiaforensic SERVICES I,,2017-04-21,4700000.0,,-546253407.3200005,.
409000438620',2017-04-24,AEPS Indiaforensic INCOME 210417,,2017-04-24,,58586.88,-546194820.4400005,.
409000438620',2017-04-24,AEPS Indiaforensic S TAX 210417,,2017-04-24,,8788.03,-546186032.4100006,.
409000438620',2017-04-24,AEPS Indiaforensic INCOME 220417,,2017-04-24,,49506.08,-546136526.3300005,.
409000438620',2017-04-24,AEPS Indiaforensic S TAX 220417,,2017-04-24,,7425.91,-546129100.4200006,.
409000438620',2017-04-24,AEPS Indiaforensic INCOME 230417,,2017-04-24,,48727.64,-546080372.7800006,.
409000438620',2017-04-24,AEPS Indiaforensic S TAX 230417,,2017-04-24,,7309.15,-546073063.6300006,.
409000438620',2017-04-24,Indiaforensic AEPS NPCI WDL SET,,2017-04-24,,9474361.0,-536598702.6300006,.
409000438620',2017-04-24,Indiaforensic AEPS NPCI WDL SET,,2017-04-24,,7850659.0,-528748043.6300006,.
409000438620',2017-04-24,Indiaforensic AEPS NPCI WDL SET,,2017-04-24,,7044362.0,-521703681.6300006,.
409000438620',2017-04-24,Indfor RIF AEPS NPCI WDL SET,,2017-04-24,,5000.0,-521698681.6300006,.
409000438620',2017-04-24,Indfor RIF AEPS NPCI WDL SET,,2017-04-24,,2350.0,-521696331.6300006,.
409000438620',2017-04-24,Indiaforensic AEPS NPCI DEP SET,,2017-04-24,5138473.0,,-526834804.6300006,.
409000438620',2017-04-24,Indiaforensic AEPS NPCI DEP SET,,2017-04-24,3924071.0,,-530758875.6300006,.
409000438620',2017-04-24,Indiaforensic AEPS NPCI DEP SET,,2017-04-24,4598969.0,,-535357844.6300006,.
409000438620',2017-04-24,Indfor RIF AEPS NPCI DEP SET,,2017-04-24,2500.0,,-535360344.6300006,.
409000438620',2017-04-24,TRF TO  Indiaforensic SERVICES I,,2017-04-24,10800000.0,,-546160344.6300006,.
409000438620',2017-04-25,AEPS Indiaforensic INCOME 240417,,2017-04-25,,74531.46,-546085813.1700006,.
409000438620',2017-04-25,AEPS Indiaforensic S TAX 240417,,2017-04-25,,11179.72,-546074633.4500005,.
409000438620',2017-04-25,Indiaforensic AEPS NPCI WDL SET,,2017-04-25,,11481013.0,-534593620.4500005,.
409000438620',2017-04-25,Indfor RIF AEPS NPCI WDL SET,,2017-04-25,,8000.0,-534585620.4500005,.
409000438620',2017-04-25,Indiaforensic AEPS NPCI DEP SET,,2017-04-25,6399894.0,,-540985514.4500005,.
409000438620',2017-04-25,TRF TO  Indiaforensic SERVICES I,,2017-04-25,5300000.0,,-546285514.4500005,.
409000438620',2017-04-26,AEPS Indiaforensic INCOME 250417,,2017-04-26,,83664.3,-546201850.1500006,.
409000438620',2017-04-26,AEPS Indiaforensic S TAX 250417,,2017-04-26,,12549.65,-546189300.5000006,.
409000438620',2017-04-26,Indiaforensic AEPS NPCI WDL SET,,2017-04-26,,12926812.0,-533262488.5000006,.
409000438620',2017-04-26,Indiaforensic AEPS NPCI DEP SET,,2017-04-26,8524128.0,,-541786616.5000006,.
409000438620',2017-04-26,TRF TO  Indiaforensic SERVICES I,,2017-04-26,4500000.0,,-546286616.5000006,.
409000438620',2017-04-27,AEPS Indiaforensic INCOME 260417,,2017-04-27,,83405.99,-546203210.5100006,.
409000438620',2017-04-27,AEPS Indiaforensic S TAX 260417,,2017-04-27,,12510.9,-546190699.6100006,.
409000438620',2017-04-27,Indiaforensic AEPS NPCI WDL SET,,2017-04-27,,12667344.0,-533523355.6100006,.
409000438620',2017-04-27,Indfor RIF AEPS NPCI WDL SET,,2017-04-27,,1000.0,-533522355.6100006,.
409000438620',2017-04-27,Indiaforensic AEPS NPCI DEP SET,,2017-04-27,8229874.0,,-541752229.6100006,.
409000438620',2017-04-27,TRF TO  Indiaforensic SERVICES I,,2017-04-27,4500000.0,,-546252229.6100006,.
409000438620',2017-04-28,AEPS Indiaforensic INCOME 270417,,2017-04-28,,76928.66,-546175300.9500006,.
409000438620',2017-04-28,AEPS Indiaforensic S TAX 270417,,2017-04-28,,11539.3,-546163761.6500007,.
409000438620',2017-04-28,Indiaforensic AEPS NPCI WDL SET,,2017-04-28,,11506412.0,-534657349.6500007,.
409000438620',2017-04-28,Indfor RIF AEPS NPCI WDL SET,,2017-04-28,,2500.0,-534654849.6500007,.
409000438620',2017-04-28,Indiaforensic AEPS NPCI DEP SET,,2017-04-28,7962036.0,,-542616885.6500007,.
409000438620',2017-04-28,TRF TO  Indiaforensic SERVICES I,,2017-04-28,3600000.0,,-546216885.6500007,.
409000438620',2017-04-29,Indiaforensic AEPS NPCI WDL SET,,2017-04-29,,10742007.0,-535474878.6500007,.
409000438620',2017-04-29,Indiaforensic AEPS NPCI DEP SET,,2017-04-29,7296074.0,,-542770952.6500007,.
409000438620',2017-04-29,Indfor RIF AEPS NPCI DEP SET,,2017-04-29,2000.0,,-542772952.6500007,.
409000438620',2017-04-29,TRF TO  Indiaforensic SERVICES I,,2017-04-29,3000000.0,,-545772952.6500007,.
409000438620',2017-04-29,TRF TO  Indiaforensic SERVICES I,,2017-04-29,500000.0,,-546272952.6500007,.
409000438620',2017-04-29,AEPS Indiaforensic INCOME 280417,,2017-04-29,,70675.21,-546202277.4400007,.
409000438620',2017-04-29,AEPS Indiaforensic S TAX 280417,,2017-04-29,,10601.28,-546191676.1600007,.
409000438620',2017-05-02,AEPS Indiaforensic INCOME 290417,,2017-05-02,,63624.25,-546128051.9100007,.
409000438620',2017-05-02,AEPS Indiaforensic S TAX 290417,,2017-05-02,,9543.64,-546118508.2700007,.
409000438620',2017-05-02,AEPS Indiaforensic INCOME 300417,,2017-05-02,,43944.76,-546074563.5100007,.
409000438620',2017-05-02,AEPS Indiaforensic S TAX 300417,,2017-05-02,,6591.71,-546067971.8000007,.
409000438620',2017-05-02,AEPS Indiaforensic INCOME 010517,,2017-05-02,,75552.22,-545992419.5800006,.
409000438620',2017-05-02,AEPS Indiaforensic S TAX 010517,,2017-05-02,,11332.83,-545981086.7500006,.
409000438620',2017-05-02,Indiaforensic AEPS NPCI WDL SET,,2017-05-02,,9194561.0,-536786525.7500006,.
409000438620',2017-05-02,Indiaforensic AEPS NPCI WDL SET,,2017-05-02,,6527305.0,-530259220.7500006,.
409000438620',2017-05-02,Indiaforensic AEPS NPCI WDL SET,,2017-05-02,,11264256.0,-518994964.7500006,.
409000438620',2017-05-02,Indiaforensic AEPS NPCI DEP SET,,2017-05-02,6482372.0,,-525477336.7500006,.
409000438620',2017-05-02,Indiaforensic AEPS NPCI DEP SET,,2017-05-02,4360112.0,,-529837448.7500006,.
409000438620',2017-05-02,Indiaforensic AEPS NPCI DEP SET,,2017-05-02,6488970.0,,-536326418.7500006,.
409000438620',2017-05-02,TRF TO  Indiaforensic SERVICES I,,2017-05-02,9900000.0,,-546226418.7500006,.
409000438620',2017-05-02,REV Indfor RIF AEPS NPCI WDL,,2017-05-02,4200.0,,-546230618.7500006,.
409000438620',2017-05-02,Indiaforensic RIF AEPS NPCI WDL1,,2017-05-02,,4200.0,-546226418.7500006,.
409000438620',2017-05-03,AEPS Indiaforensic INCOME 020517,,2017-05-03,,82273.36,-546144145.3900006,.
409000438620',2017-05-03,AEPS Indiaforensic S TAX 020517,,2017-05-03,,12341.0,-546131804.3900006,.
409000438620',2017-05-03,Indfor RIFAEPS NPCI WDL SET,,2017-05-03,,500.0,-546131304.3900006,.
409000438620',2017-05-03,Indfor RIFAEPS NPCI WDL SET,,2017-05-03,,10500.0,-546120804.3900006,.
409000438620',2017-05-03,Indfor RIFAEPS NPCI DEP SET,,2017-05-03,6500.0,,-546127304.3900006,.
409000438620',2017-05-03,Indiaforensic AEPS NPCI WDL SET,,2017-05-03,,12896244.0,-533231060.3900006,.
409000438620',2017-05-03,Indfor RIF AEPS NPCI WDL SET,,2017-05-03,,13000.0,-533218060.3900006,.
409000438620',2017-05-03,Indiaforensic AEPS NPCI DEP SET,,2017-05-03,8076375.0,,-541294435.3900006,.
409000438620',2017-05-03,TRF TO  Indiaforensic SERVICES I,,2017-05-03,5000000.0,,-546294435.3900006,.
409000438620',2017-05-04,AEPS Indiaforensic INCOME 030517,,2017-05-04,,76192.93,-546218242.4600006,.
409000438620',2017-05-04,AEPS Indiaforensic S TAX 030517,,2017-05-04,,11428.94,-546206813.5200006,.
409000438620',2017-05-04,Indiaforensic AEPS NPCI WDL SET,,2017-05-04,,11438031.0,-534768782.5200006,.
409000438620',2017-05-04,Indiaforensic AEPS NPCI DEP SET,,2017-05-04,7584364.0,,-542353146.5200006,.
409000438620',2017-05-04,TRF TO  Indiaforensic SERVICES I,,2017-05-04,3900000.0,,-546253146.5200006,.
409000438620',2017-05-05,AEPS Indiaforensic INCOME 040517,,2017-05-05,,81531.19,-546171615.3300005,.
409000438620',2017-05-05,AEPS Indiaforensic S TAX 040517,,2017-05-05,,12229.68,-546159385.6500006,.
409000438620',2017-05-05,Indiaforensic AEPS NPCI WDL SET,,2017-05-05,,12366957.0,-533792428.6500006,.
409000438620',2017-05-05,Indfor RIF AEPS NPCI WDL SET,,2017-05-05,,1001.0,-533791427.6500006,.
409000438620',2017-05-05,Indiaforensic AEPS NPCI DEP SET,,2017-05-05,8334668.0,,-542126095.6500006,.
409000438620',2017-05-05,Indfor RIF AEPS NPCI DEP SET,,2017-05-05,1.0,,-542126096.6500006,.
409000438620',2017-05-05,TRF TO  Indiaforensic SERVICES I,,2017-05-05,4100000.0,,-546226096.6500006,.
409000438620',2017-05-06,AEPS Indiaforensic INCOME 050517,,2017-05-06,,78416.5,-546147680.1500006,.
409000438620',2017-05-06,AEPS Indiaforensic S TAX 050517,,2017-05-06,,11762.48,-546135917.6700006,.
409000438620',2017-05-06,Indiaforensic AEPS NPCI WDL SET,,2017-05-06,,12066554.0,-534069363.67000055,.
409000438620',2017-05-06,Indfor RIF AEPS NPCI WDL SET,,2017-05-06,,47.0,-534069316.67000055,.
409000438620',2017-05-06,Indiaforensic AEPS NPCI DEP SET,,2017-05-06,7908830.0,,-541978146.6700006,.
409000438620',2017-05-06,Indfor RIF AEPS NPCI DEP SET,,2017-05-06,47.0,,-541978193.6700006,.
409000438620',2017-05-06,TRF TO  Indiaforensic SERVICES I,,2017-05-06,4000000.0,,-545978193.6700006,.
409000438620',2017-05-08,CR706815051775/RMCPL09514/1,,2017-05-08,4200.0,,-545982393.6700006,.
409000438620',2017-05-08,CR706815084457/RMCPL09514/1,,2017-05-08,1500.0,,-545983893.6700006,.
409000438620',2017-05-08,CR706815310865/RMCPL09514/1,,2017-05-08,900.0,,-545984793.6700006,.
409000438620',2017-05-08,CR706815322169/RMCPL09514/1,,2017-05-08,300.0,,-545985093.6700006,.
409000438620',2017-05-08,CR706815429845/RMCPL09514/1,,2017-05-08,300.0,,-545985393.6700006,.
409000438620',2017-05-08,CR706815530650/RMCPL09514/1,,2017-05-08,4750.0,,-545990143.6700006,.
409000438620',2017-05-08,CR706815573139/RMCPL09514/1,,2017-05-08,6300.0,,-545996443.6700006,.
409000438620',2017-05-08,CR708619137006/RMCPL10418/1,,2017-05-08,100.0,,-545996543.6700006,.
409000438620',2017-05-08,CR708619151610/RMCPL11535/1,,2017-05-08,4500.0,,-546001043.6700006,.
409000438620',2017-05-08,CR708619167462/RMCPL03019/1,,2017-05-08,10000.0,,-546011043.6700006,.
409000438620',2017-05-08,CR708619433466/RMCPL01289/1,,2017-05-08,500.0,,-546011543.6700006,.
409000438620',2017-05-08,CR708619579014/RMCPL09647/1,,2017-05-08,530.0,,-546012073.6700006,.
409000438620',2017-05-08,CR708619580226/RMCPL11772/1,,2017-05-08,2000.0,,-546014073.6700006,.
409000438620',2017-05-08,CR708620073490/RMCPL00322/1,,2017-05-08,1000.0,,-546015073.6700006,.
409000438620',2017-05-08,CR708620474398/RMCPL07811/1,,2017-05-08,10000.0,,-546025073.6700006,.
409000438620',2017-05-08,CR708620554618/RMCPL09100/1,,2017-05-08,10000.0,,-546035073.6700006,.
409000438620',2017-05-08,CR708620580826/RMCPL10928/1,,2017-05-08,3000.0,,-546038073.6700006,.
409000438620',2017-05-08,CR708713296485/RMCPL10816/1,,2017-05-08,1200.0,,-546039273.6700006,.
409000438620',2017-05-08,CR708713540313/RMCPL11230/1,,2017-05-08,4500.0,,-546043773.6700006,.
409000438620',2017-05-08,CR708715531973/RMCPL09715/1,,2017-05-08,5500.0,,-546049273.6700006,.
409000438620',2017-05-08,CR709016444285/RMCPL08471/1,,2017-05-08,5.0,,-546049278.6700006,.
409000438620',2017-05-08,CR709017060693/RMCPL01421/1,,2017-05-08,2000.0,,-546051278.6700006,.
409000438620',2017-05-08,CR709017120861/RMCPL09898/1,,2017-05-08,2000.0,,-546053278.6700006,.
409000438620',2017-05-08,CR709017505785/RMCPL03913/1,,2017-05-08,200.0,,-546053478.6700006,.
409000438620',2017-05-08,CR709314491212/RMCPL00010/1,,2017-05-08,2000.0,,-546055478.6700006,.
409000438620',2017-05-08,CR709409441036/RMCPL10428/1,,2017-05-08,3000.0,,-546058478.6700006,.
409000438620',2017-05-08,CR709413407592/RMCPL00020/1,,2017-05-08,8000.0,,-546066478.6700006,.
409000438620',2017-05-08,CR709415348696/RMCPL00034/1,,2017-05-08,300.0,,-546066778.6700006,.
409000438620',2017-05-08,CR709415507144/RMCPL00079/1,,2017-05-08,500.0,,-546067278.6700006,.
409000438620',2017-05-08,CR709419207193/RMCPL09194/1,,2017-05-08,10.0,,-546067288.6700006,.
409000438620',2017-05-08,CR709713514451/RMCPL12344/1,,2017-05-08,500.0,,-546067788.6700006,.
409000438620',2017-05-08,CR709713589019/RMCPL00329/1,,2017-05-08,1510.0,,-546069298.6700006,.
409000438620',2017-05-08,CR710214010261/RMCPL10820/1,,2017-05-08,2000.0,,-546071298.6700006,.
409000438620',2017-05-08,CR710408291108/RMCPL12213/1,,2017-05-08,10000.0,,-546081298.6700006,.
409000438620',2017-05-08,CR710408495312/RMCPL10766/1,,2017-05-08,1500.0,,-546082798.6700006,.
409000438620',2017-05-08,CR710408141168/RMCPL11221/1,,2017-05-08,1200.0,,-546083998.6700006,.
409000438620',2017-05-08,CR710408339156/RMCPL00143/1,,2017-05-08,1210.0,,-546085208.6700006,.
409000438620',2017-05-08,CR710408575496/RMCPL11327/1,,2017-05-08,5.0,,-546085213.6700006,.
409000438620',2017-05-08,CR710408299532/RMCPL01094/1,,2017-05-08,1000.0,,-546086213.6700006,.
409000438620',2017-05-08,CR710408317328/RMCPL11327/1,,2017-05-08,1000.0,,-546087213.6700006,.
409000438620',2017-05-08,CR710611188027/RMCPL06719/1,,2017-05-08,3000.0,,-546090213.6700006,.
409000438620',2017-05-08,CR710711245067/RMCPL10086/1,,2017-05-08,500.0,,-546090713.6700006,.
409000438620',2017-05-08,CR710711288135/RMCPL09175/1,,2017-05-08,800.0,,-546091513.6700006,.
409000438620',2017-05-08,CR710711294375/RMCPL09981/1,,2017-05-08,200.0,,-546091713.6700006,.
409000438620',2017-05-08,CR710718070170/RMCPL10734/1,,2017-05-08,4000.0,,-546095713.6700006,.
409000438620',2017-05-08,CR710718155658/RMCPL11779/1,,2017-05-08,100.0,,-546095813.6700006,.
409000438620',2017-05-08,CR710718160806/RMCPL12187/1,,2017-05-08,1.0,,-546095814.6700006,.
409000438620',2017-05-08,CR710718253314/RMCPL11393/1,,2017-05-08,500.0,,-546096314.6700006,.
409000438620',2017-05-08,CR710718331626/RMCPL03589/1,,2017-05-08,4300.0,,-546100614.6700006,.
409000438620',2017-05-08,CR710718358146/RMCPL11841/1,,2017-05-08,1200.0,,-546101814.6700006,.
409000438620',2017-05-08,CR710718388254/RMCPL02810/1,,2017-05-08,6430.0,,-546108244.6700006,.
409000438620',2017-05-08,CR710718456894/RMCPL01071/1,,2017-05-08,5032.0,,-546113276.6700006,.
409000438620',2017-05-08,CR710719063006/RMCPL01960/1,,2017-05-08,3000.0,,-546116276.6700006,.
409000438620',2017-05-08,CR710719366450/RMCPL09999/1,,2017-05-08,2150.0,,-546118426.6700006,.
409000438620',2017-05-08,CR710719433374/RMCPL11167/1,,2017-05-08,1000.0,,-546119426.6700006,.
409000438620',2017-05-08,CR710719483762/RMCPL04343/1,,2017-05-08,110.0,,-546119536.6700006,.
409000438620',2017-05-08,CR710719109806/RMCPL06758/1,,2017-05-08,3100.0,,-546122636.6700006,.
409000438620',2017-05-08,CR710719335814/RMCPL11772/1,,2017-05-08,100.0,,-546122736.6700006,.
409000438620',2017-05-08,CR710719530658/RMCPL11784/1,,2017-05-08,4500.0,,-546127236.6700006,.
409000438620',2017-05-08,CR710720028938/RMCPL03287/1,,2017-05-08,3000.0,,-546130236.6700006,.
409000438620',2017-05-08,CR710720120666/RMCPL02803/1,,2017-05-08,3000.0,,-546133236.6700006,.
409000438620',2017-05-08,CR710720135330/RMCPL12472/1,,2017-05-08,100.0,,-546133336.6700006,.
409000438620',2017-05-08,CR710720164658/RMCPL02837/1,,2017-05-08,2800.0,,-546136136.6700006,.
409000438620',2017-05-08,CR710720244842/RMCPL11793/1,,2017-05-08,1500.0,,-546137636.6700006,.
409000438620',2017-05-08,CR710720570498/RMCPL00886/1,,2017-05-08,10000.0,,-546147636.6700006,.
409000438620',2017-05-08,CR710721332646/RMCPL02803/1,,2017-05-08,2600.0,,-546150236.6700006,.
409000438620',2017-05-08,CR710819383326/RMCPL11836/1,,2017-05-08,500.0,,-546150736.6700006,.
409000438620',2017-05-08,CR710819390346/RMCPL10724/1,,2017-05-08,500.0,,-546151236.6700006,.
409000438620',2017-05-08,CR710911419243/RMCPL00537/1,,2017-05-08,2300.0,,-546153536.6700006,.
409000438620',2017-05-08,CR710918058293/RMCPL00292/1,,2017-05-08,2000.0,,-546155536.6700006,.
409000438620',2017-05-08,CR710918429405/RMCPL11330/1,,2017-05-08,2300.0,,-546157836.6700006,.
409000438620',2017-05-08,CR710918508809/RMCPL09999/1,,2017-05-08,510.0,,-546158346.6700006,.
409000438620',2017-05-08,CR710918553425/RMCPL10650/1,,2017-05-08,900.0,,-546159246.6700006,.
409000438620',2017-05-08,CR710918020661/RMCPL01101/1,,2017-05-08,1000.0,,-546160246.6700006,.
409000438620',2017-05-08,CR710918043437/RMCPL05470/1,,2017-05-08,500.0,,-546160746.6700006,.
409000438620',2017-05-08,CR710918201777/RMCPL09447/1,,2017-05-08,1000.0,,-546161746.6700006,.
409000438620',2017-05-08,CR711116340959/RMCPL06499/1,,2017-05-08,10000.0,,-546171746.6700006,.
409000438620',2017-05-08,CR711118228005/RMCPL11327/1,,2017-05-08,500.0,,-546172246.6700006,.
409000438620',2017-05-08,CR711118338766/RMCPL13143/1,,2017-05-08,3000.0,,-546175246.6700006,.
409000438620',2017-05-08,CR711119526652/RMCPL01504/1,,2017-05-08,1.0,,-546175247.6700006,.
409000438620',2017-05-08,CR711119185456/RMCPL02389/1,,2017-05-08,5000.0,,-546180247.6700006,.
409000438620',2017-05-08,CR711119108416/RMCPL09999/1,,2017-05-08,510.0,,-546180757.6700006,.
409000438620',2017-05-08,CR711119295148/RMCPL01961/1,,2017-05-08,800.0,,-546181557.6700006,.
409000438620',2017-05-08,CR711120307076/RMCPL04395/1,,2017-05-08,2500.0,,-546184057.6700006,.
409000438620',2017-05-08,CR711121298556/RMCPL06758/1,,2017-05-08,10000.0,,-546194057.6700006,.
409000438620',2017-05-08,CR711211559070/RMCPL01504/1,,2017-05-08,1.0,,-546194058.6700006,.
409000438620',2017-05-08,CR711211060314/RMCPL12057/1,,2017-05-08,2150.0,,-546196208.6700006,.
409000438620',2017-05-08,CR711211070610/RMCPL09249/1,,2017-05-08,2000.0,,-546198208.6700006,.
409000438620',2017-05-08,CR711211091358/RMCPL11121/1,,2017-05-08,2000.0,,-546200208.6700006,.
409000438620',2017-05-08,CR711211101966/RMCPL01544/1,,2017-05-08,600.0,,-546200808.6700006,.
409000438620',2017-05-08,CR711211117254/RMCPL02141/1,,2017-05-08,10000.0,,-546210808.6700006,.
409000438620',2017-05-08,CR711216497957/RMCPL11952/1,,2017-05-08,2000.0,,-546212808.6700006,.
409000438620',2017-05-08,CR711220054749/RMCPL01289/1,,2017-05-08,400.0,,-546213208.6700006,.
409000438620',2017-05-08,CR711312411877/RMCPL12017/1,,2017-05-08,4780.0,,-546217988.6700006,.
409000438620',2017-05-08,CR711312396277/RMCPL02417/1,,2017-05-08,310.0,,-546218298.6700006,.
409000438620',2017-05-08,AEPS ACQUIRING ADJ FEES 0,,2017-05-08,1205.89,,-546219504.5600005,.
409000438620',2017-05-08,AEPS Indiaforensic INCOME 060517,,2017-05-08,,80623.55,-546138881.0100006,.
409000438620',2017-05-08,AEPS Indiaforensic S TAX 060517,,2017-05-08,,12093.53,-546126787.4800006,.
409000438620',2017-05-08,AEPS Indiaforensic INCOME 070517,,2017-05-08,,47931.79,-546078855.6900007,.
409000438620',2017-05-08,AEPS Indiaforensic S TAX 070517,,2017-05-08,,7189.77,-546071665.9200007,.
409000438620',2017-05-08,Indiaforensic AEPS NPCI WDL SET,,2017-05-08,,12586350.0,-533485315.9200007,.
409000438620',2017-05-08,Indiaforensic AEPS NPCI WDL SET,,2017-05-08,,7895892.0,-525589423.9200007,.
409000438620',2017-05-08,Indiaforensic AEPS NPCI DEP SET,,2017-05-08,7943292.0,,-533532715.9200007,.
409000438620',2017-05-08,Indiaforensic AEPS NPCI DEP SET,,2017-05-08,4549756.0,,-538082471.9200007,.
409000438620',2017-05-08,TRF TO  Indiaforensic SERVICES I,,2017-05-08,8200000.0,,-546282471.9200007,.
409000438620',2017-05-09,AEPS Indiaforensic INCOME 080517,,2017-05-09,,84591.85,-546197880.0700006,.
409000438620',2017-05-09,AEPS Indiaforensic S TAX 080517,,2017-05-09,,12688.78,-546185191.2900007,.
409000438620',2017-05-09,Indiaforensic AEPS NPCI WDL SET,,2017-05-09,,13701640.0,-532483551.2900007,.
409000438620',2017-05-09,Indiaforensic AEPS NPCI DEP SET,,2017-05-09,7679899.0,,-540163450.2900007,.
409000438620',2017-05-09,TRF TO  Indiaforensic SERVICES I,,2017-05-09,6100000.0,,-546263450.2900007,.
409000438620',2017-05-11,AEPS ACQUIRING ADJ FEES 0,,2017-05-11,14.95,,-546263465.2400007,.
409000438620',2017-05-11,AEPS Indiaforensic INCOME 090517,,2017-05-11,,94593.37,-546168871.8700007,.
409000438620',2017-05-11,AEPS Indiaforensic S TAX 090517,,2017-05-11,,14189.01,-546154682.8600007,.
409000438620',2017-05-11,AEPS Indiaforensic INCOME 100517,,2017-05-11,,100197.9,-546054484.9600008,.
409000438620',2017-05-11,AEPS Indiaforensic S TAX 100517,,2017-05-11,,15029.69,-546039455.2700007,.
409000438620',2017-05-11,Indiaforensic AEPS NPCI WDL SET,,2017-05-11,,15495496.0,-530543959.2700007,.
409000438620',2017-05-11,Indfor RIF AEPS NPCI WDL SET,,2017-05-11,,1600.0,-530542359.2700007,.
409000438620',2017-05-11,Indiaforensic AEPS NPCI WDL SET,,2017-05-11,,16994833.0,-513547526.2700007,.
409000438620',2017-05-11,Indfor RIF AEPS NPCI WDL SET,,2017-05-11,,10000.0,-513537526.2700007,.
409000438620',2017-05-11,Indiaforensic AEPS NPCI DEP SET,,2017-05-11,9420324.0,,-522957850.2700007,.
409000438620',2017-05-11,Indiaforensic AEPS NPCI DEP SET,,2017-05-11,8959219.0,,-531917069.2700007,.
409000438620',2017-05-11,Indfor RIF AEPS NPCI DEP SET,,2017-05-11,4000.0,,-531921069.2700007,.
409000438620',2017-05-11,TRF TO  Indiaforensic SERVICES I,,2017-05-11,14300000.0,,-546221069.2700007,.
409000438620',2017-05-12,AEPS Indiaforensic INCOME 110517,,2017-05-12,,109476.8,-546111592.4700007,.
409000438620',2017-05-12,AEPS Indiaforensic S TAX 110517,,2017-05-12,,16421.52,-546095170.9500008,.
409000438620',2017-05-12,Indiaforensic AEPS NPCI WDL SET,,2017-05-12,,18531427.0,-527563743.95000076,.
409000438620',2017-05-12,Indfor RIF AEPS NPCI WDL SET,,2017-05-12,,15000.0,-527548743.95000076,.
409000438620',2017-05-12,Indiaforensic AEPS NPCI DEP SET,,2017-05-12,10168561.0,,-537717304.9500008,.
409000438620',2017-05-12,Indfor RIF AEPS NPCI DEP SET,,2017-05-12,5000.0,,-537722304.9500008,.
409000438620',2017-05-12,TRF TO  Indiaforensic SERVICES I,,2017-05-12,8500000.0,,-546222304.9500008,.
409000438620',2017-05-15,AEPS ACQUIRING ADJ FEES 1,,2017-05-15,,14.95,-546222290.0000007,.
409000438620',2017-05-15,REV Indiaforensic RIF AEPS NPCI,,2017-05-15,,4200.0,-546218090.0000007,.
409000438620',2017-05-15,REV Indiaforensic RIF AEPS NPCI,,2017-05-15,,4200.0,-546213890.0000007,.
409000438620',2017-05-15,Indiaforensic AEPS NPCI WDL SET,,2017-05-15,,17756199.0,-528457691.0000007,.
409000438620',2017-05-15,Indfor RIF AEPS NPCI WDL SET,,2017-05-15,,2000.0,-528455691.0000007,.
409000438620',2017-05-15,Indiaforensic AEPS NPCI WDL SET,,2017-05-15,,9894671.0,-518561020.0000007,.
409000438620',2017-05-15,Indiaforensic AEPS NPCI WDL SET,,2017-05-15,,11906771.0,-506654249.0000007,.
409000438620',2017-05-15,Indiaforensic AEPS NPCI DEP SET,,2017-05-15,9947700.0,,-516601949.0000007,.
409000438620',2017-05-15,Indiaforensic AEPS NPCI DEP SET,,2017-05-15,5139127.0,,-521741076.0000007,.
409000438620',2017-05-15,Indiaforensic AEPS NPCI DEP SET,,2017-05-15,7216165.0,,-528957241.0000007,.
409000438620',2017-05-15,AEPS Indiaforensic INCOME 120517,,2017-05-15,,90723.58,-528866517.42000073,.
409000438620',2017-05-15,AEPS Indiaforensic S TAX 120517,,2017-05-15,,13608.54,-528852908.8800007,.
409000438620',2017-05-15,AEPS Indiaforensic INCOME 130517,,2017-05-15,,48252.42,-528804656.4600007,.
409000438620',2017-05-15,AEPS Indiaforensic S TAX 130517,,2017-05-15,,7237.86,-528797418.6000007,.
409000438620',2017-05-15,AEPS Indiaforensic INCOME 140517,,2017-05-15,,60987.4,-528736431.2000007,.
409000438620',2017-05-15,AEPS Indiaforensic S TAX 140517,,2017-05-15,,9148.11,-528727283.0900007,.
409000438620',2017-05-16,AEPS Indiaforensic INCOME 150517,,2017-05-16,,86902.37,-528640380.7200007,.
409000438620',2017-05-16,AEPS Indiaforensic S TAX 150517,,2017-05-16,,13035.36,-528627345.36000067,.
409000438620',2017-05-16,Indiaforensic AEPS NPCI WDL SET,,2017-05-16,,17500067.0,-511127278.36000067,.
409000438620',2017-05-16,Indiaforensic AEPS NPCI DEP SET,,2017-05-16,10517149.0,,-521644427.36000067,.
409000438620',2017-05-16,TRF TO  Indiaforensic SERVICES I,,2017-05-16,15000000.0,,-536644427.36000067,.
409000438620',2017-05-16,TRF TO  Indiaforensic SERVICES I,,2017-05-16,9600000.0,,-546244427.3600006,.
409000438620',2017-05-17,Indiaforensic AEPS NPCI WDL SET,,2017-05-17,,18966339.0,-527278088.3600006,.
409000438620',2017-05-17,AEPS ACQUIRING ADJ FEES 1,,2017-05-17,1358.71,,-527279447.0700006,.
409000438620',2017-05-17,CR712508085145/RMCPL11121/1,,2017-05-17,914.0,,-527280361.0700006,.
409000438620',2017-05-17,CR712308167347/RMCPL10111/1,,2017-05-17,4000.0,,-527284361.0700006,.
409000438620',2017-05-17,CR712409292094/RMCPL13062/1,,2017-05-17,210.0,,-527284571.0700006,.
409000438620',2017-05-17,CR712812130863/RMCPL10418/1,,2017-05-17,1080.0,,-527285651.0700006,.
409000438620',2017-05-17,CR712315432757/RMCPL10820/1,,2017-05-17,2000.0,,-527287651.0700006,.
409000438620',2017-05-17,CR712317547993/RMCPL12345/1,,2017-05-17,100.0,,-527287751.0700006,.
409000438620',2017-05-17,CR712318287809/RMCPL13003/1,,2017-05-17,520.0,,-527288271.0700006,.
409000438620',2017-05-17,CR712319498193/RMCPL09902/1,,2017-05-17,1050.0,,-527289321.0700006,.
409000438620',2017-05-17,CR712319200149/RMCPL00224/1,,2017-05-17,260.0,,-527289581.0700006,.
409000438620',2017-05-17,CR712513457822/RMCPL00271/1,,2017-05-17,3000.0,,-527292581.0700006,.
409000438620',2017-05-17,CR712811322383/RMCPL13438/1,,2017-05-17,400.0,,-527292981.0700006,.
409000438620',2017-05-17,CR712811328311/RMCPL10452/1,,2017-05-17,10000.0,,-527302981.0700006,.
409000438620',2017-05-17,CR712319299881/RMCPL13626/1,,2017-05-17,420.0,,-527303401.0700006,.
409000438620',2017-05-17,CR712512322006/RMCPL11238/1,,2017-05-17,500.0,,-527303901.0700006,.
409000438620',2017-05-17,CR712215202578/RMCPL12426/1,,2017-05-17,5000.0,,-527308901.0700006,.
409000438620',2017-05-17,CR712215245634/RMCPL00093/1,,2017-05-17,500.0,,-527309401.0700006,.
409000438620',2017-05-17,CR712215421746/RMCPL12778/1,,2017-05-17,100.0,,-527309501.0700006,.
409000438620',2017-05-17,CR712219201035/RMCPL10068/1,,2017-05-17,1000.0,,-527310501.0700006,.
409000438620',2017-05-17,CR712219334415/RMCPL11737/1,,2017-05-17,2025.0,,-527312526.0700006,.
409000438620',2017-05-17,CR712219348611/RMCPL12872/1,,2017-05-17,1000.0,,-527313526.0700006,.
409000438620',2017-05-17,CR712219529727/RMCPL12872/1,,2017-05-17,1000.0,,-527314526.0700006,.
409000438620',2017-05-17,CR712219537995/RMCPL03978/1,,2017-05-17,10000.0,,-527324526.0700006,.
409000438620',2017-05-17,CR712219038147/RMCPL12698/1,,2017-05-17,50.0,,-527324576.0700006,.
409000438620',2017-05-17,CR712219044231/RMCPL12394/1,,2017-05-17,1000.0,,-527325576.0700006,.
409000438620',2017-05-17,CR712312095299/RMCPL11888/1,,2017-05-17,1300.0,,-527326876.0700006,.
409000438620',2017-05-17,CR712314507817/RMCPL12380/1,,2017-05-17,1000.0,,-527327876.0700006,.
409000438620',2017-05-17,CR712314531373/RMCPL13914/1,,2017-05-17,1400.0,,-527329276.0700006,.
409000438620',2017-05-17,CR712314383953/RMCPL13030/1,,2017-05-17,2000.0,,-527331276.0700006,.
409000438620',2017-05-17,CR712314398461/RMCPL00138/1,,2017-05-17,2124.0,,-527333400.0700006,.
409000438620',2017-05-17,CR712315396721/RMCPL12008/1,,2017-05-17,1000.0,,-527334400.0700006,.
409000438620',2017-05-17,CR712316278509/RMCPL00100/1,,2017-05-17,9000.0,,-527343400.0700006,.
409000438620',2017-05-17,CR712316386905/RMCPL13062/1,,2017-05-17,2500.0,,-527345900.0700006,.
409000438620',2017-05-17,CR712316398761/RMCPL11073/1,,2017-05-17,1000.0,,-527346900.0700006,.
409000438620',2017-05-17,CR712317195217/RMCPL11793/1,,2017-05-17,1000.0,,-527347900.0700006,.
409000438620',2017-05-17,CR712317289417/RMCPL11586/1,,2017-05-17,2000.0,,-527349900.0700006,.
409000438620',2017-05-17,CR712317362725/RMCPL11327/1,,2017-05-17,200.0,,-527350100.0700006,.
409000438620',2017-05-17,CR712317372241/RMCPL00027/1,,2017-05-17,700.0,,-527350800.0700006,.
409000438620',2017-05-17,CR712317374269/RMCPL11321/1,,2017-05-17,1500.0,,-527352300.0700006,.
409000438620',2017-05-17,CR712317394237/RMCPL09138/1,,2017-05-17,2500.0,,-527354800.0700006,.
409000438620',2017-05-17,CR712317398761/RMCPL11592/1,,2017-05-17,1007.0,,-527355807.0700006,.
409000438620',2017-05-17,CR712317432457/RMCPL10401/1,,2017-05-17,2000.0,,-527357807.0700006,.
409000438620',2017-05-17,CR712317189025/RMCPL10630/1,,2017-05-17,600.0,,-527358407.0700006,.
409000438620',2017-05-17,CR712317261097/RMCPL12208/1,,2017-05-17,200.0,,-527358607.0700006,.
409000438620',2017-05-17,CR712317327865/RMCPL11850/1,,2017-05-17,5000.0,,-527363607.0700006,.
409000438620',2017-05-17,CR712317407749/RMCPL00928/1,,2017-05-17,2050.0,,-527365657.0700006,.
409000438620',2017-05-17,CR712317481225/RMCPL11849/1,,2017-05-17,5000.0,,-527370657.0700006,.
409000438620',2017-05-17,CR712317504937/RMCPL11371/1,,2017-05-17,2000.0,,-527372657.0700006,.
409000438620',2017-05-17,CR712318102349/RMCPL11898/1,,2017-05-17,100.0,,-527372757.0700006,.
409000438620',2017-05-17,CR712319418873/RMCPL09650/1,,2017-05-17,310.0,,-527373067.0700006,.
409000438620',2017-05-17,CR712319336985/RMCPL13407/1,,2017-05-17,700.0,,-527373767.0700006,.
409000438620',2017-05-17,CR712319243721/RMCPL09650/1,,2017-05-17,110.0,,-527373877.0700006,.
409000438620',2017-05-17,CR712319431341/RMCPL12007/1,,2017-05-17,300.0,,-527374177.0700006,.
409000438620',2017-05-17,CR712320220321/RMCPL13149/1,,2017-05-17,400.0,,-527374577.0700006,.
409000438620',2017-05-17,CR711711430930/RMCPL11457/1,,2017-05-17,300.0,,-527374877.0700006,.
409000438620',2017-05-17,CR711817594501/RMCPL12065/1,,2017-05-17,4544.0,,-527379421.0700006,.
409000438620',2017-05-17,CR712408080678/RMCPL10823/1,,2017-05-17,660.0,,-527380081.0700006,.
409000438620',2017-05-17,CR712217055506/RMCPL06863/1,,2017-05-17,1320.0,,-527381401.0700006,.
409000438620',2017-05-17,CR712219141911/RMCPL01544/1,,2017-05-17,1700.0,,-527383101.0700006,.
409000438620',2017-05-17,CR712311140827/RMCPL09119/1,,2017-05-17,3000.0,,-527386101.0700006,.
409000438620',2017-05-17,CR712311150655/RMCPL13562/1,,2017-05-17,730.0,,-527386831.0700006,.
409000438620',2017-05-17,CR712311189655/RMCPL11056/1,,2017-05-17,2005.0,,-527388836.0700006,.
409000438620',2017-05-17,CR712311355795/RMCPL10458/1,,2017-05-17,1000.0,,-527389836.0700006,.
409000438620',2017-05-17,CR712311501031/RMCPL09985/1,,2017-05-17,1500.0,,-527391336.0700006,.
409000438620',2017-05-17,CR712312136113/RMCPL12380/1,,2017-05-17,200.0,,-527391536.0700006,.
409000438620',2017-05-17,CR712312180730/RMCPL11479/1,,2017-05-17,1500.0,,-527393036.0700006,.
409000438620',2017-05-17,CR712312396635/RMCPL11085/1,,2017-05-17,500.0,,-527393536.0700006,.
409000438620',2017-05-17,CR712312453263/RMCPL09841/1,,2017-05-17,1500.0,,-527395036.0700006,.
409000438620',2017-05-17,CR712312501312/RMCPL00190/1,,2017-05-17,4000.0,,-527399036.0700006,.
409000438620',2017-05-17,CR712313332521/RMCPL11263/1,,2017-05-17,2250.0,,-527401286.0700006,.
409000438620',2017-05-17,CR712313179629/RMCPL11263/1,,2017-05-17,2220.0,,-527403506.0700006,.
409000438620',2017-05-17,CR712313259969/RMCPL13117/1,,2017-05-17,2500.0,,-527406006.0700006,.
409000438620',2017-05-17,CR712314247765/RMCPL11220/1,,2017-05-17,2000.0,,-527408006.0700006,.
409000438620',2017-05-17,CR712314268669/RMCPL00138/1,,2017-05-17,2100.0,,-527410106.0700006,.
409000438620',2017-05-17,CR712314433213/RMCPL03978/1,,2017-05-17,1000.0,,-527411106.0700006,.
409000438620',2017-05-17,CR712314442573/RMCPL11678/1,,2017-05-17,600.0,,-527411706.0700006,.
409000438620',2017-05-17,CR712314492337/RMCPL10758/1,,2017-05-17,530.0,,-527412236.0700006,.
409000438620',2017-05-17,CR712314021505/RMCPL11951/1,,2017-05-17,2000.0,,-527414236.0700006,.
409000438620',2017-05-17,CR712314055201/RMCPL00166/1,,2017-05-17,8300.0,,-527422536.0700006,.
409000438620',2017-05-17,CR712315035305/RMCPL00020/1,,2017-05-17,2030.0,,-527424566.0700006,.
409000438620',2017-05-17,CR712316139549/RMCPL11850/1,,2017-05-17,4500.0,,-527429066.0700006,.
409000438620',2017-05-17,CR712316301465/RMCPL00109/1,,2017-05-17,4000.0,,-527433066.0700006,.
409000438620',2017-05-17,CR712316417013/RMCPL05050/1,,2017-05-17,3000.0,,-527436066.0700006,.
409000438620',2017-05-17,CR712317596449/RMCPL11073/1,,2017-05-17,1000.0,,-527437066.0700006,.
409000438620',2017-05-17,CR712317307657/RMCPL12015/1,,2017-05-17,10000.0,,-527447066.0700006,.
409000438620',2017-05-17,CR712317103381/RMCPL11888/1,,2017-05-17,3000.0,,-527450066.0700006,.
409000438620',2017-05-17,CR712317178105/RMCPL02810/1,,2017-05-17,10000.0,,-527460066.0700006,.
409000438620',2017-05-17,CR712317181537/RMCPL13678/1,,2017-05-17,50.0,,-527460116.0700006,.
409000438620',2017-05-17,CR712317018349/RMCPL04296/1,,2017-05-17,2040.0,,-527462156.0700006,.
409000438620',2017-05-17,CR712318097357/RMCPL12143/1,,2017-05-17,700.0,,-527462856.0700006,.
409000438620',2017-05-17,CR712318156697/RMCPL11393/1,,2017-05-17,10.0,,-527462866.0700006,.
409000438620',2017-05-17,CR712318187429/RMCPL11592/1,,2017-05-17,1008.0,,-527463874.0700006,.
409000438620',2017-05-17,CR712318195385/RMCPL12731/1,,2017-05-17,1000.0,,-527464874.0700006,.
409000438620',2017-05-17,CR712318384769/RMCPL13504/1,,2017-05-17,10.0,,-527464884.0700006,.
409000438620',2017-05-17,CR712318414409/RMCPL11535/1,,2017-05-17,600.0,,-527465484.0700006,.
409000438620',2017-05-17,CR712318496777/RMCPL01530/1,,2017-05-17,200.0,,-527465684.0700006,.
409000438620',2017-05-17,CR712319209689/RMCPL12815/1,,2017-05-17,3000.0,,-527468684.0700006,.
409000438620',2017-05-17,CR712319234649/RMCPL00329/1,,2017-05-17,320.0,,-527469004.0700006,.
409000438620',2017-05-17,CR712319325129/RMCPL13176/1,,2017-05-17,3020.0,,-527472024.0700006,.
409000438620',2017-05-17,CR712319399205/RMCPL06758/1,,2017-05-17,9990.0,,-527482014.0700006,.
409000438620',2017-05-17,CR712320365401/RMCPL07549/1,,2017-05-17,5000.0,,-527487014.0700006,.
409000438620',2017-05-17,CR712320490981/RMCPL07283/1,,2017-05-17,520.0,,-527487534.0700006,.
409000438620',2017-05-17,CR711417448551/RMCPL00222/1,,2017-05-17,5000.0,,-527492534.0700006,.
409000438620',2017-05-17,CR711417395835/RMCPL12427/1,,2017-05-17,1000.0,,-527493534.0700006,.
409000438620',2017-05-17,CR711417594615/RMCPL12143/1,,2017-05-17,6060.0,,-527499594.0700006,.
409000438620',2017-05-17,CR711618196142/RMCPL00077/1,,2017-05-17,5.0,,-527499599.0700006,.
409000438620',2017-05-17,CR711515127853/RMCPL00077/1,,2017-05-17,10.0,,-527499609.0700006,.
409000438620',2017-05-17,CR711519013421/RMCPL00077/1,,2017-05-17,5.0,,-527499614.0700006,.
409000438620',2017-05-17,CR711712282094/RMCPL00077/1,,2017-05-17,5.0,,-527499619.0700006,.
409000438620',2017-05-17,CR711715563206/RMCPL00077/1,,2017-05-17,11.0,,-527499630.0700006,.
409000438620',2017-05-17,CR711716294250/RMCPL00077/1,,2017-05-17,10.0,,-527499640.0700006,.
409000438620',2017-05-17,CR711914494024/RMCPL03165/1,,2017-05-17,1000.0,,-527500640.0700006,.
409000438620',2017-05-17,CR711914235580/RMCPL11686/1,,2017-05-17,300.0,,-527500940.0700006,.
409000438620',2017-05-17,CR711914388460/RMCPL11265/1,,2017-05-17,710.0,,-527501650.0700006,.
409000438620',2017-05-17,AEPS Indiaforensic INCOME 160517,,2017-05-17,,93039.12,-527408610.9500006,.
409000438620',2017-05-17,AEPS Indiaforensic S TAX 160517,,2017-05-17,,13955.87,-527394655.0800006,.
409000438620',2017-05-17,Indiaforensic AEPS NPCI DEP SET,,2017-05-17,11531772.0,,-538926427.0800006,.
409000438620',2017-05-17,TRF TO  Indiaforensic SERVICES I,,2017-05-17,7300000.0,,-546226427.0800006,.
409000438620',2017-05-18,AEPS Indiaforensic INCOME 170517,,2017-05-18,,79321.7,-546147105.3800006,.
409000438620',2017-05-18,AEPS Indiaforensic S TAX 170517,,2017-05-18,,11898.26,-546135207.1200006,.
409000438620',2017-05-18,Indiaforensic AEPS NPCI WDL SET,,2017-05-18,,15721302.0,-530413905.1200006,.
409000438620',2017-05-18,Indiaforensic AEPS NPCI DEP SET,,2017-05-18,10759830.0,,-541173735.1200006,.
409000438620',2017-05-18,TRF TO  Indiaforensic SERVICES I,,2017-05-18,5100000.0,,-546273735.1200006,.
409000438620',2017-05-19,AEPS Indiaforensic INCOME 180517,,2017-05-19,,80425.06,-546193310.0600007,.
409000438620',2017-05-19,AEPS Indiaforensic S TAX 180517,,2017-05-19,,12063.76,-546181246.3000007,.
409000438620',2017-05-19,Indiaforensic AEPS NPCI WDL SET,,2017-05-19,,16112873.0,-530068373.30000067,.
409000438620',2017-05-19,Indiaforensic AEPS NPCI DEP SET,,2017-05-19,10661090.0,,-540729463.3000007,.
409000438620',2017-05-19,TRF TO  Indiaforensic SERVICES I,,2017-05-19,5500000.0,,-546229463.3000007,.
409000438620',2017-05-20,AEPS ACQUIRING ADJ FEES 1,,2017-05-20,17.25,,-546229480.5500007,.
409000438620',2017-05-20,AEPS Indiaforensic INCOME 190517,,2017-05-20,,81130.79,-546148349.7600007,.
409000438620',2017-05-20,AEPS Indiaforensic S TAX 190517,,2017-05-20,,12169.62,-546136180.1400007,.
409000438620',2017-05-20,Indiaforensic AEPS NPCI WDL SET,,2017-05-20,,16122558.0,-530013622.1400007,.
409000438620',2017-05-20,Indfor RIF AEPS NPCI WDL SET,,2017-05-20,,400.0,-530013222.1400007,.
409000438620',2017-05-20,Indiaforensic AEPS NPCI DEP SET,,2017-05-20,10955457.0,,-540968679.1400007,.
409000438620',2017-05-20,TRF TO  Indiaforensic SERVICES I,,2017-05-20,4500000.0,,-545468679.1400007,.
409000438620',2017-05-22,AEPS Indiaforensic INCOME 200517,,2017-05-22,,72668.58,-545396010.5600007,.
409000438620',2017-05-22,AEPS Indiaforensic S TAX 200517,,2017-05-22,,10900.29,-545385110.2700007,.
409000438620',2017-05-22,AEPS Indiaforensic INCOME 210517,,2017-05-22,,27744.72,-545357365.5500007,.
409000438620',2017-05-22,AEPS Indiaforensic S TAX 210517,,2017-05-22,,4161.71,-545353203.8400006,.
409000438620',2017-05-22,Indiaforensic AEPS NPCI WDL SET,,2017-05-22,,13894471.0,-531458732.8400006,.
409000438620',2017-05-22,Indfor RIF AEPS NPCI WDL SET,,2017-05-22,,27000.0,-531431732.8400006,.
409000438620',2017-05-22,Indiaforensic AEPS NPCI WDL SET,,2017-05-22,,4835635.0,-526596097.8400006,.
409000438620',2017-05-22,Indiaforensic AEPS NPCI DEP SET,,2017-05-22,10152280.0,,-536748377.8400006,.
409000438620',2017-05-22,Indfor RIF AEPS NPCI WDL SET,,2017-05-22,20000.0,,-536768377.8400006,.
409000438620',2017-05-22,Indiaforensic AEPS NPCI DEP SET,,2017-05-22,4052844.0,,-540821221.8400006,.
409000438620',2017-05-22,TRF TO  Indiaforensic SERVICES I,,2017-05-22,5400000.0,,-546221221.8400006,.
409000438620',2017-05-22,OUTWARD REMITTANCE CHRG,,2017-05-22,250.0,,-546221471.8400006,.
409000438620',2017-05-22,SERVICE TAX,,2017-05-22,35.0,,-546221506.8400006,.
409000438620',2017-05-22,SWACHH BHARAT CESS,,2017-05-22,1.25,,-546221508.0900006,.
409000438620',2017-05-22,KRISHI KALYAN CESS,,2017-05-22,1.25,,-546221509.3400006,.
409000438620',2017-05-23,AEPS ACQUIRING ADJ FEES 2,,2017-05-23,,17.25,-546221492.0900006,.
409000438620',2017-05-23,AEPS Indiaforensic INCOME 220517,,2017-05-23,,81325.26,-546140166.8300006,.
409000438620',2017-05-23,AEPS Indiaforensic S TAX 220517,,2017-05-23,,12198.79,-546127968.0400007,.
409000438620',2017-05-23,Indiaforensic AEPS NPCI WDL SET,,2017-05-23,,15486317.0,-530641651.0400007,.
409000438620',2017-05-23,Indfor RIF AEPS NPCI WDL SET,,2017-05-23,,10000.0,-530631651.0400007,.
409000438620',2017-05-23,Indiaforensic AEPS NPCI DEP SET,,2017-05-23,9939786.0,,-540571437.0400007,.
409000438620',2017-05-23,TRF TO  Indiaforensic SERVICES I,,2017-05-23,5700000.0,,-546271437.0400007,.
409000438620',2017-05-24,AEPS Indiaforensic INCOME 230517,,2017-05-24,,79403.61,-546192033.4300007,.
409000438620',2017-05-24,AEPS Indiaforensic S TAX 230517,,2017-05-24,,11910.54,-546180122.8900007,.
409000438620',2017-05-24,Indiaforensic AEPS NPCI WDL SET,,2017-05-24,,15029432.0,-531150690.8900007,.
409000438620',2017-05-24,Indiaforensic AEPS NPCI DEP SET,,2017-05-24,10715305.0,,-541865995.8900007,.
409000438620',2017-05-25,AEPS Indiaforensic INCOME 240517,,2017-05-25,,80106.46,-541785889.4300007,.
409000438620',2017-05-25,AEPS Indiaforensic S TAX 240517,,2017-05-25,,12015.97,-541773873.4600006,.
409000438620',2017-05-25,Indiaforensic AEPS NPCI WDL SET,,2017-05-25,,15320351.0,-526453522.46000063,.
409000438620',2017-05-25,Indiaforensic AEPS NPCI DEP SET,,2017-05-25,10740330.0,,-537193852.4600006,.
409000438620',2017-05-25,Indfor RIF AEPS NPCI DEP SET,,2017-05-25,3000.0,,-537196852.4600006,.
409000438620',2017-05-25,MAW/5029649804298685/GORA,,2017-05-25,,1500.0,-537195352.4600006,.
409000438620',2017-05-25,MAW/5029649804298701/GORA,,2017-05-25,,3100.0,-537192252.4600006,.
409000438620',2017-05-25,MAW/5029649807382494 /THA,,2017-05-25,,2100.0,-537190152.4600006,.
409000438620',2017-05-25,TRF TO  Indiaforensic SERVICES I,,2017-05-25,9100000.0,,-546290152.4600006,.
409000438620',2017-05-25,MAW/5029649804758852/NAGA,,2017-05-25,,1400.0,-546288752.4600006,.
409000438620',2017-05-26,AEPS ACQUIRING ADJ FEES 2,,2017-05-26,,11.5,-546288740.9600006,.
409000438620',2017-05-26,AEPS Indiaforensic INCOME 250517,,2017-05-26,,83806.5,-546204934.4600006,.
409000438620',2017-05-26,AEPS Indiaforensic S TAX 250517,,2017-05-26,,12570.98,-546192363.4800006,.
409000438620',2017-05-26,Indiaforensic AEPS NPCI WDL SET,,2017-05-26,,15625575.0,-530566788.4800006,.
409000438620',2017-05-26,Indiaforensic AEPS NPCI DEP SET,,2017-05-26,10329135.0,,-540895923.4800006,.
409000438620',2017-05-26,TRF TO  Indiaforensic SERVICES I,,2017-05-26,5400000.0,,-546295923.4800006,.
409000438620',2017-05-29,CB711119093728/RMCPL09875/2,,2017-05-29,6000.0,,-546301923.4800006,.
409000438620',2017-05-29,Indiaforensic AEPS NPCI WDL SET,,2017-05-29,,14502449.0,-531799474.4800006,.
409000438620',2017-05-29,Indiaforensic AEPS NPCI WDL SET,,2017-05-29,,11458381.0,-520341093.4800006,.
409000438620',2017-05-29,Indfor RIF AEPS NPCI WDL SET,,2017-05-29,,15000.0,-520326093.4800006,.
409000438620',2017-05-29,Indiaforensic AEPS NPCI DEP SET,,2017-05-29,10077442.0,,-530403535.4800006,.
409000438620',2017-05-29,Indiaforensic AEPS NPCI DEP SET,,2017-05-29,7326961.0,,-537730496.4800006,.
409000438620',2017-05-29,TRF TO  Indiaforensic SERVICES I,,2017-05-29,4500000.0,,-542230496.4800006,.
409000438620',2017-05-29,TRF TO  Indiaforensic SERVICES I,,2017-05-29,4000000.0,,-546230496.4800006,.
409000438620',2017-05-29,Indiaforensic AEPS NPCI WDL SET,,2017-05-29,,8749620.0,-537480876.4800006,.
409000438620',2017-05-29,Indiaforensic AEPS NPCI DEP SET,,2017-05-29,6454049.0,,-543934925.4800006,.
409000438620',2017-05-30,TRF TO  Indiaforensic SERVICES I,,2017-05-30,1500000.0,,-545434925.4800006,.
409000438620',2017-05-30,Indiaforensic AEPS NPCI WDL SET,,2017-05-30,,16931051.0,-528503874.4800006,.
409000438620',2017-05-30,Indfor RIF AEPS NPCI WDL SET,,2017-05-30,,1400.0,-528502474.4800006,.
409000438620',2017-05-30,Indiaforensic AEPS NPCI DEP SET,,2017-05-30,11650385.0,,-540152859.4800006,.
409000438620',2017-05-30,TRF TO  Indiaforensic SERVICES I,,2017-05-30,6100000.0,,-546252859.4800006,.
409000438620',2017-05-31,Indiaforensic AEPS NPCI WDL SET,,2017-05-31,,16624083.0,-529628776.4800006,.
409000438620',2017-05-31,Indfor RIF AEPS NPCI WDL SET,,2017-05-31,,4500.0,-529624276.4800006,.
409000438620',2017-05-31,MAW/5029649806340691/DAMO,,2017-05-31,,4050.0,-529620226.4800006,.
409000438620',2017-05-31,Indiaforensic AEPS NPCI DEP SET,,2017-05-31,12013388.0,,-541633614.4800006,.
409000438620',2017-05-31,Indfor RIF AEPS NPCI DEP SET,,2017-05-31,8000.0,,-541641614.4800006,.
409000438620',2017-05-31,TRF TO  Indiaforensic SERVICES I,,2017-05-31,3000000.0,,-544641614.4800006,.
409000438620',2017-06-01,Indiaforensic AEPS NPCI WDL SET,,2017-06-01,,16658404.0,-527983210.4800006,.
409000438620',2017-06-01,Indfor RIF AEPS NPCI WDL SET,,2017-06-01,,17000.0,-527966210.4800006,.
409000438620',2017-06-01,Indiaforensic AEPS NPCI DEP SET,,2017-06-01,11181896.0,,-539148106.4800006,.
409000438620',2017-06-01,TRF TO  Indiaforensic SERVICES I,,2017-06-01,7100000.0,,-546248106.4800006,.
409000438620',2017-06-02,AEPS ACQUIRING ADJ FEES 0,,2017-06-02,17.25,,-546248123.7300006,.
409000438620',2017-06-02,Indiaforensic AEPS NPCI WDL SET,,2017-06-02,,18194071.0,-528054052.7300006,.
409000438620',2017-06-02,Indfor-RIF AEPS NPCI WDL SET,,2017-06-02,,2000.0,-528052052.7300006,.
409000438620',2017-06-02,Indiaforensic AEPS NPCI DEP SET,,2017-06-02,11887345.0,,-539939397.7300006,.
409000438620',2017-06-02,TRF TO  Indiaforensic SERVICES I,,2017-06-02,6300000.0,,-546239397.7300006,.
409000438620',2017-06-03,Indiaforensic AEPS NPCI WDL SET,,2017-06-03,,16913569.0,-529325828.7300006,.
409000438620',2017-06-03,Indiaforensic AEPS NPCI DEP SET,,2017-06-03,11974931.0,,-541300759.7300006,.
409000438620',2017-06-03,TRF TO  Indiaforensic SERVICES I,,2017-06-03,5000000.0,,-546300759.7300006,.
409000438620',2017-06-03,MAW/5029649804274496DEORI,,2017-06-03,,1098.0,-546299661.7300006,.
409000438620',2017-06-03,MAW/5029649800489031/NAGA,,2017-06-03,,830.0,-546298831.7300006,.
409000438620',2017-06-05,Indiaforensic AEPS NPCI WDL SET,,2017-06-05,,14664985.0,-531633846.7300006,.
409000438620',2017-06-05,Indiaforensic AEPS NPCI WDL SET,,2017-06-05,,10062502.0,-521571344.7300006,.
409000438620',2017-06-05,Indiaforensic AEPS NPCI DEP SET,,2017-06-05,10407057.0,,-531978401.7300006,.
409000438620',2017-06-05,Indfor RIF AEPS NPCI DEP SET,,2017-06-05,4000.0,,-531982401.7300006,.
409000438620',2017-06-05,Indiaforensic AEPS NPCI DEP SET,,2017-06-05,7542935.0,,-539525336.7300006,.
409000438620',2017-06-05,TRF TO  Indiaforensic SERVICES I,,2017-06-05,6700000.0,,-546225336.7300006,.
409000438620',2017-06-05,MAW/5029649804298701 GORA,,2017-06-05,,3400.0,-546221936.7300006,.
409000438620',2017-06-05,MAW/5029649800488587 NAGA,,2017-06-05,,1000.0,-546220936.7300006,.
409000438620',2017-06-06,AEPS ACQUIRING ADJ FEES 0,,2017-06-06,17.25,,-546220953.9800006,.
409000438620',2017-06-06,AEPS ACQUIRING ADJ FEES 2,,2017-06-06,28.75,,-546220982.7300006,.
409000438620',2017-06-06,Indiaforensic AEPS NPCI WDL SET,,2017-06-06,,15927474.0,-530293508.7300006,.
409000438620',2017-06-06,Indfor RIF AEPS NPCI WDL SET,,2017-06-06,,2390.0,-530291118.7300006,.
409000438620',2017-06-06,Indiaforensic AEPS NPCI DEP SET,,2017-06-06,10002752.0,,-540293870.7300006,.
409000438620',2017-06-06,TRF TO  Indiaforensic SERVICES I,,2017-06-06,6000000.0,,-546293870.7300006,.
409000438620',2017-06-07,Indiaforensic AEPS NPCI WDL SET,,2017-06-07,,19241312.0,-527052558.7300006,.
409000438620',2017-06-07,Indfor RIF AEPS NPCI WDL SET,,2017-06-07,,2000.0,-527050558.7300006,.
409000438620',2017-06-07,Indiaforensic AEPS NPCI DEP SET,,2017-06-07,12914080.0,,-539964638.7300006,.
409000438620',2017-06-07,AEPS ACQUIRING ADJ FEES 0,,2017-06-07,,17.25,-539964621.4800006,.
409000438620',2017-06-07,TRF TO  Indiaforensic SERVICES I,,2017-06-07,6300000.0,,-546264621.4800006,.
409000438620',2017-06-08,Indiaforensic AEPS NPCI WDL SET,,2017-06-08,,18984251.0,-527280370.4800006,.
409000438620',2017-06-08,Indfor RIF AEPS NPCI WDL SET,,2017-06-08,,5000.0,-527275370.4800006,.
409000438620',2017-06-08,Indiaforensic AEPS NPCI DEP SET,,2017-06-08,12803527.0,,-540078897.4800006,.
409000438620',2017-06-08,Indiaforensic AEPS NPCI DEP SET,,2017-06-08,4000.0,,-540082897.4800006,.
409000438620',2017-06-08,TRF TO  Indiaforensic SERVICES I,,2017-06-08,6200000.0,,-546282897.4800006,.
409000438620',2017-06-09,Indiaforensic AEPS NPCI WDL SET,,2017-06-09,,21627846.0,-524655051.4800006,.
409000438620',2017-06-09,Indfor RIF AEPS NPCI WDL SET,,2017-06-09,,10600.0,-524644451.4800006,.
409000438620',2017-06-09,Indiaforensic AEPS NPCI DEP SET,,2017-06-09,12925896.0,,-537570347.4800006,.
409000438620',2017-06-09,Indiaforensic AEPS NPCI DEP SET,,2017-06-09,12000.0,,-537582347.4800006,.
409000438620',2017-06-09,TRF TO  Indiaforensic SERVICES I,,2017-06-09,8700000.0,,-546282347.4800006,.
409000438620',2017-06-12,Indiaforensic AEPS NPCI WDL SET,,2017-06-12,,21453000.0,-524829347.4800006,.
409000438620',2017-06-12,Indiaforensic AEPS NPCI WDL SET,,2017-06-12,,19917681.0,-504911666.4800006,.
409000438620',2017-06-12,Indfor RIF AEPS NPCI WDL SET,,2017-06-12,,10000.0,-504901666.4800006,.
409000438620',2017-06-12,Indiaforensic AEPS NPCI DEP SET,,2017-06-12,13896859.0,,-518798525.4800006,.
409000438620',2017-06-12,Indiaforensic AEPS NPCI DEP SET,,2017-06-12,10778748.0,,-529577273.4800006,.
409000438620',2017-06-12,TRF TO  Indiaforensic SERVICES I,,2017-06-12,15000000.0,,-544577273.4800006,.
409000438620',2017-06-12,TRF TO  Indiaforensic SERVICES I,,2017-06-12,1700000.0,,-546277273.4800006,.
409000438620',2017-06-12,Indiaforensic AEPS NPCI WDL SET,,2017-06-12,,13814477.0,-532462796.4800006,.
409000438620',2017-06-12,CB713515041241/RMCPL13922/1,,2017-06-12,4000.0,,-532466796.4800006,.
409000438620',2017-06-12,Indiaforensic AEPS NPCI DEP SET,,2017-06-12,7920724.0,,-540387520.4800006,.
409000438620',2017-06-13,TRF TO  Indiaforensic SERVICES I,,2017-06-13,5900000.0,,-546287520.4800006,.
409000438620',2017-06-13,Indiaforensic AEPS NPCI WDL SET,,2017-06-13,,23156661.0,-523130859.4800006,.
409000438620',2017-06-13,Indfor-RIF AEPS NPCI WDL SET,,2017-06-13,,7000.0,-523123859.4800006,.
409000438620',2017-06-13,Indiaforensic AEPS NPCI DEP SET,,2017-06-13,12907310.0,,-536031169.4800006,.
409000438620',2017-06-13,Indfor-RIF AEPS NPCI DEP SET,,2017-06-13,10000.0,,-536041169.4800006,.
409000438620',2017-06-13,Indfor-RIF AEPS NPCI WDL SET,,2017-06-13,,7500.0,-536033669.4800006,.
409000438620',2017-06-13,TRF TO  Indiaforensic SERVICES I,,2017-06-13,2000000.0,,-538033669.4800006,.
409000438620',2017-06-13,TRF TO  Indiaforensic SERVICES I,,2017-06-13,4000000.0,,-542033669.4800006,.
409000438620',2017-06-13,MAW/5029649802998401 NAGA,,2017-06-13,,1500.0,-542032169.4800006,.
409000438620',2017-06-13,MAW/5029649802999011 NAGA,,2017-06-13,,1500.0,-542030669.4800006,.
409000438620',2017-06-13,MAW/5029649802998971 NAGA,,2017-06-13,,1500.0,-542029169.4800006,.
409000438620',2017-06-14,Indiaforensic AEPS NPCI WDL SET,,2017-06-14,,23015604.0,-519013565.4800006,.
409000438620',2017-06-14,Indfor-RIF AEPS NPCI WDL SET,,2017-06-14,,14500.0,-518999065.4800006,.
409000438620',2017-06-14,Indiaforensic AEPS NPCI DEP SET,,2017-06-14,14404617.0,,-533403682.4800006,.
409000438620',2017-06-14,TRF TO  Indiaforensic SERVICES I,,2017-06-14,12900000.0,,-546303682.4800006,.
409000438620',2017-06-15,Indiaforensic AEPS NPCI WDL SET,,2017-06-15,,24894725.0,-521408957.4800006,.
409000438620',2017-06-15,Indfor-RIF AEPS NPCI WDL SET,,2017-06-15,,1850.0,-521407107.4800006,.
409000438620',2017-06-15,Indiaforensic AEPS NPCI DEP SET,,2017-06-15,15729149.0,,-537136256.4800006,.
409000438620',2017-06-15,TRF TO  Indiaforensic SERVICES I,,2017-06-15,9100000.0,,-546236256.4800006,.
409000438620',2017-06-15,CB713515041241/RMCPL13922/1,,2017-06-15,,4000.0,-546232256.4800006,.
409000438620',2017-06-16,Indiaforensic AEPS NPCI WDL SET,,2017-06-16,,22221994.0,-524010262.4800006,.
409000438620',2017-06-16,Indfor-RIF AEPS NPCI WDL SET,,2017-06-16,,300.0,-524009962.4800006,.
409000438620',2017-06-16,Indiaforensic AEPS NPCI DEP SET,,2017-06-16,14806941.0,,-538816903.4800006,.
409000438620',2017-06-16,TRF TO  Indiaforensic SERVICES I,,2017-06-16,7400000.0,,-546216903.4800006,.
409000438620',2017-06-17,Indiaforensic AEPS NPCI WDL SET,,2017-06-17,,20561833.0,-525655070.4800006,.
409000438620',2017-06-17,AEPS ACQUIRING ADJ FEES 1,,2017-06-17,617.9,,-525655688.3800006,.
409000438620',2017-06-17,CR713217018343/RMCPL12312/1,,2017-06-17,5050.0,,-525660738.3800006,.
409000438620',2017-06-17,CR713217034879/RMCPL11850/1,,2017-06-17,2500.0,,-525663238.3800006,.
409000438620',2017-06-17,CR713217293527/RMCPL10425/1,,2017-06-17,800.0,,-525664038.3800006,.
409000438620',2017-06-17,CR713217303199/RMCPL13904/1,,2017-06-17,500.0,,-525664538.3800006,.
409000438620',2017-06-17,CR713217102355/RMCPL13375/1,,2017-06-17,2000.0,,-525666538.3800006,.
409000438620',2017-06-17,CR713517263731/RMCPL12251/1,,2017-06-17,1000.0,,-525667538.3800006,.
409000438620',2017-06-17,CR713517284167/RMCPL12472/1,,2017-06-17,1500.0,,-525669038.3800006,.
409000438620',2017-06-17,CR713517318955/RMCPL00845/1,,2017-06-17,1050.0,,-525670088.3800006,.
409000438620',2017-06-17,CR713517393055/RMCPL13597/1,,2017-06-17,3000.0,,-525673088.3800006,.
409000438620',2017-06-17,CR713517387283/RMCPL06758/1,,2017-06-17,10000.0,,-525683088.3800006,.
409000438620',2017-06-17,CR714612264580/RMCPL13859/2,,2017-06-17,1510.0,,-525684598.3800006,.
409000438620',2017-06-17,CR715314668198/RMCPL12946/0,,2017-06-17,2000.0,,-525686598.3800006,.
409000438620',2017-06-17,CR715211488903/RMCPL11158/0,,2017-06-17,3000.0,,-525689598.3800006,.
409000438620',2017-06-17,CR715211225652/RMCPL03589/0,,2017-06-17,1000.0,,-525690598.3800006,.
409000438620',2017-06-17,CR715415299139/RMCPL14102/0,,2017-06-17,1010.0,,-525691608.3800006,.
409000438620',2017-06-17,CR715415299069/RMCPL09786/0,,2017-06-17,10000.0,,-525701608.3800006,.
409000438620',2017-06-17,CR715415298919/RMCPL13036/0,,2017-06-17,3000.0,,-525704608.3800006,.
409000438620',2017-06-17,CR715415299064/RMCPL14079/0,,2017-06-17,500.0,,-525705108.3800006,.
409000438620',2017-06-17,CR715415299051/RMCPL12964/0,,2017-06-17,5500.0,,-525710608.3800006,.
409000438620',2017-06-17,CR715415299033/RMCPL11275/0,,2017-06-17,2000.0,,-525712608.3800006,.
409000438620',2017-06-17,CR715415300095/RMCPL11275/0,,2017-06-17,2000.0,,-525714608.3800006,.
409000438620',2017-06-17,CR715415300005/RMCPL12253/0,,2017-06-17,5000.0,,-525719608.3800006,.
409000438620',2017-06-17,CR715415300107/RMCPL11852/0,,2017-06-17,500.0,,-525720108.3800006,.
409000438620',2017-06-17,CR715415300111/RMCPL13036/0,,2017-06-17,3000.0,,-525723108.3800006,.
409000438620',2017-06-17,CR715415300416/RMCPL12572/0,,2017-06-17,5200.0,,-525728308.3800006,.
409000438620',2017-06-17,CR715415300350/RMCPL14102/0,,2017-06-17,1010.0,,-525729318.3800006,.
409000438620',2017-06-17,CR715415301055/RMCPL12253/0,,2017-06-17,5000.0,,-525734318.3800006,.
409000438620',2017-06-17,CR715415301275/RMCPL10196/0,,2017-06-17,10000.0,,-525744318.3800006,.
409000438620',2017-06-17,CR715415301281/RMCPL14683/0,,2017-06-17,1500.0,,-525745818.3800006,.
409000438620',2017-06-17,CR715416320691/RMCPL04006/0,,2017-06-17,2000.0,,-525747818.3800006,.
409000438620',2017-06-17,CR715416320875/RMCPL09924/0,,2017-06-17,500.0,,-525748318.3800006,.
409000438620',2017-06-17,CR715612401058/RMCPL11624/0,,2017-06-17,100.0,,-525748418.3800006,.
409000438620',2017-06-17,CR715612401152/RMCPL12494/0,,2017-06-17,1000.0,,-525749418.3800006,.
409000438620',2017-06-17,CR715612401195/RMCPL10418/0,,2017-06-17,220.0,,-525749638.3800006,.
409000438620',2017-06-17,CR715612403011/RMCPL11937/0,,2017-06-17,2000.0,,-525751638.3800006,.
409000438620',2017-06-17,CR715612404822/RMCPL14776/0,,2017-06-17,100.0,,-525751738.3800006,.
409000438620',2017-06-17,CR715613406825/RMCPL12264/0,,2017-06-17,700.0,,-525752438.3800006,.
409000438620',2017-06-17,CR715613406865/RMCPL09583/0,,2017-06-17,4394.0,,-525756832.3800006,.
409000438620',2017-06-17,CR715613408206/RMCPL04861/0,,2017-06-17,5000.0,,-525761832.3800006,.
409000438620',2017-06-17,CR715613408491/RMCPL08948/0,,2017-06-17,5000.0,,-525766832.3800006,.
409000438620',2017-06-17,CR715613413197/RMCPL11909/0,,2017-06-17,3000.0,,-525769832.3800006,.
409000438620',2017-06-17,CR715613414189/RMCPL11167/0,,2017-06-17,400.0,,-525770232.3800006,.
409000438620',2017-06-17,CR715613416535/RMCPL09680/0,,2017-06-17,500.0,,-525770732.3800006,.
409000438620',2017-06-17,CR715613416616/RMCPL13344/0,,2017-06-17,2500.0,,-525773232.3800006,.
409000438620',2017-06-17,CR715613420436/RMCPL09939/0,,2017-06-17,310.0,,-525773542.3800006,.
409000438620',2017-06-17,CR715613420569/RMCPL10373/0,,2017-06-17,500.0,,-525774042.3800006,.
409000438620',2017-06-17,CR715811524174/RMCPL13150/0,,2017-06-17,3000.0,,-525777042.3800006,.
409000438620',2017-06-17,CR715811524318/RMCPL14000/0,,2017-06-17,2000.0,,-525779042.3800006,.
409000438620',2017-06-17,CR715811524370/RMCPL11318/0,,2017-06-17,1000.0,,-525780042.3800006,.
409000438620',2017-06-17,CR715811524399/RMCPL10732/0,,2017-06-17,2000.0,,-525782042.3800006,.
409000438620',2017-06-17,CR715811524533/RMCPL14594/0,,2017-06-17,100.0,,-525782142.3800006,.
409000438620',2017-06-17,CR715811524505/RMCPL12037/0,,2017-06-17,2000.0,,-525784142.3800006,.
409000438620',2017-06-17,CR715811526285/RMCPL11473/0,,2017-06-17,1000.0,,-525785142.3800006,.
409000438620',2017-06-17,CR715811526355/RMCPL11793/0,,2017-06-17,3100.0,,-525788242.3800006,.
409000438620',2017-06-17,CR715811530275/RMCPL09050/0,,2017-06-17,800.0,,-525789042.3800006,.
409000438620',2017-06-17,CR715811530323/RMCPL13598/0,,2017-06-17,2000.0,,-525791042.3800006,.
409000438620',2017-06-17,Indiaforensic AEPS NPCI DEP SET,,2017-06-17,13944755.0,,-539735797.3800006,.
409000438620',2017-06-17,TRF TO  Indiaforensic SERVICES I,,2017-06-17,4000000.0,,-543735797.3800006,.
409000438620',2017-06-17,TRF TO  Indiaforensic SERVICES I,,2017-06-17,2000000.0,,-545735797.3800006,.
409000438620',2017-06-19,AEPS ACQUIRING ADJ FEES 1,,2017-06-19,17.25,,-545735814.6300006,.
409000438620',2017-06-19,Indiaforensic AEPS NPCI WDL SET,,2017-06-19,,17963610.0,-527772204.6300006,.
409000438620',2017-06-19,Indiaforensic AEPS NPCI WDL SET,,2017-06-19,,12637877.0,-515134327.6300006,.
409000438620',2017-06-19,Indiaforensic AEPS NPCI DEP SET,,2017-06-19,11458733.0,,-526593060.6300006,.
409000438620',2017-06-19,Indiaforensic AEPS NPCI DEP SET,,2017-06-19,7528767.0,,-534121827.6300006,.
409000438620',2017-06-19,CB716311244526/RMCPL04296/1,,2017-06-19,6000.0,,-534127827.6300006,.
409000438620',2017-06-19,TRF TO  Indiaforensic SERVICES I,,2017-06-19,12100000.0,,-546227827.6300006,.
409000438620',2017-06-20,Indiaforensic AEPS NPCI WDL SET,,2017-06-20,,20262490.0,-525965337.6300006,.
409000438620',2017-06-20,Indfor-RIF AEPS NPCI WDL SET,,2017-06-20,,1300.0,-525964037.6300006,.
409000438620',2017-06-20,Indiaforensic AEPS NPCI DEP SET,,2017-06-20,11454744.0,,-537418781.6300006,.
409000438620',2017-06-20,TRF TO  Indiaforensic SERVICES I,,2017-06-20,8800000.0,,-546218781.6300006,.
409000438620',2017-06-21,Indiaforensic AEPS NPCI WDL SET,,2017-06-21,,17464964.0,-528753817.6300006,.
409000438620',2017-06-21,Indiaforensic AEPS NPCI DEP SET,,2017-06-21,11479384.0,,-540233201.6300006,.
409000438620',2017-06-21,TRF TO  Indiaforensic SERVICES I,,2017-06-21,6000000.0,,-546233201.6300006,.
409000438620',2017-06-22,AEPS ACQUIRING ADJ FEES 2,,2017-06-22,17.25,,-546233218.8800006,.
409000438620',2017-06-22,Indiaforensic AEPS NPCI WDL SET,,2017-06-22,,19013187.0,-527220031.8800006,.
409000438620',2017-06-22,Indiaforensic AEPS NPCI DEP SET,,2017-06-22,13133602.0,,-540353633.8800006,.
409000438620',2017-06-22,TRF TO  Indiaforensic SERVICES I,,2017-06-22,5900000.0,,-546253633.8800006,.
409000438620',2017-06-22,COMMISSION CHARGES,,2017-06-22,250.0,,-546253883.8800006,.
409000438620',2017-06-22,SERVICE TAX,,2017-06-22,35.0,,-546253918.8800006,.
409000438620',2017-06-22,SWACHH BHARAT CESS,,2017-06-22,1.25,,-546253920.1300006,.
409000438620',2017-06-22,KRISHI KALYAN CESS,,2017-06-22,1.25,,-546253921.3800006,.
409000438620',2017-06-23,Indiaforensic AEPS NPCI WDL SET,,2017-06-23,,17856735.0,-528397186.3800006,.
409000438620',2017-06-23,Indfor RIF AEPS NPCI WDL SET,,2017-06-23,,100.0,-528397086.3800006,.
409000438620',2017-06-23,CR716119537328 RMCPL13441 1,,2017-06-23,1000.0,,-528398086.3800006,.
409000438620',2017-06-23,CR716310224317 RMCPL00566 1,,2017-06-23,400.0,,-528398486.3800006,.
409000438620',2017-06-23,CR716310224351 RMCPL11535 1,,2017-06-23,6000.0,,-528404486.3800006,.
409000438620',2017-06-23,CR716310224621 RMCPL13166 1,,2017-06-23,1000.0,,-528405486.3800006,.
409000438620',2017-06-23,CR716310224852 RMCPL14234 1,,2017-06-23,1000.0,,-528406486.3800006,.
409000438620',2017-06-23,CR716310224838 RMCPL05123 1,,2017-06-23,2000.0,,-528408486.3800006,.
409000438620',2017-06-23,CR716310224908 RMCPL12201 1,,2017-06-23,700.0,,-528409186.3800006,.
409000438620',2017-06-23,CR716310226353 RMCPL12737 1,,2017-06-23,2000.0,,-528411186.3800006,.
409000438620',2017-06-23,CR716310228001 RMCPL00024 1,,2017-06-23,520.0,,-528411706.3800006,.
409000438620',2017-06-23,CR716310228260 RMCPL09211 1,,2017-06-23,4000.0,,-528415706.3800006,.
409000438620',2017-06-23,CR716310228226 RMCPL13021 1,,2017-06-23,1800.0,,-528417506.3800006,.
409000438620',2017-06-23,CR716310228290 RMCPL11680 1,,2017-06-23,103.0,,-528417609.3800006,.
409000438620',2017-06-23,CR716310229558 RMCPL14592 1,,2017-06-23,1500.0,,-528419109.3800006,.
409000438620',2017-06-23,CR716310229653 RMCPL12052 1,,2017-06-23,610.0,,-528419719.3800006,.
409000438620',2017-06-23,CR716310229698 RMCPL11749 1,,2017-06-23,600.0,,-528420319.3800006,.
409000438620',2017-06-23,CR716310229868 RMCPL12814 1,,2017-06-23,3000.0,,-528423319.3800006,.
409000438620',2017-06-23,CR716310229882 RMCPL11065 1,,2017-06-23,10000.0,,-528433319.3800006,.
409000438620',2017-06-23,CR716310229996 RMCPL14835 1,,2017-06-23,1000.0,,-528434319.3800006,.
409000438620',2017-06-23,CR716310230710 RMCPL13123 1,,2017-06-23,800.0,,-528435119.3800006,.
409000438620',2017-06-23,CR716310230913 RMCPL10937 1,,2017-06-23,500.0,,-528435619.3800006,.
409000438620',2017-06-23,CR716310230953 RMCPL13559 1,,2017-06-23,730.0,,-528436349.3800006,.
409000438620',2017-06-23,CR716310230938 RMCPL11680 1,,2017-06-23,103.0,,-528436452.3800006,.
409000438620',2017-06-23,CR716310233381 RMCPL09071 1,,2017-06-23,1200.0,,-528437652.3800006,.
409000438620',2017-06-23,CR716310233540 RMCPL11248 1,,2017-06-23,300.0,,-528437952.3800006,.
409000438620',2017-06-23,CR716311242327 RMCPL12312 1,,2017-06-23,520.0,,-528438472.3800006,.
409000438620',2017-06-23,CR716311243551 RMCPL13559 1,,2017-06-23,730.0,,-528439202.3800006,.
409000438620',2017-06-23,CR716311244177 RMCPL14447 1,,2017-06-23,1500.0,,-528440702.3800006,.
409000438620',2017-06-23,CR716311244335 RMCPL09389 1,,2017-06-23,700.0,,-528441402.3800006,.
409000438620',2017-06-23,CR716311244287 RMCPL11442 1,,2017-06-23,3000.0,,-528444402.3800006,.
409000438620',2017-06-23,CR716311245031 RMCPL00146 1,,2017-06-23,700.0,,-528445102.3800006,.
409000438620',2017-06-23,CR716311245296 RMCPL13559 1,,2017-06-23,730.0,,-528445832.3800006,.
409000438620',2017-06-23,CR716311245355 RMCPL12057 1,,2017-06-23,1000.0,,-528446832.3800006,.
409000438620',2017-06-23,CR716311245329 RMCPL14594 1,,2017-06-23,5000.0,,-528451832.3800006,.
409000438620',2017-06-23,CR716311255788 RMCPL15079 1,,2017-06-23,1000.0,,-528452832.3800006,.
409000438620',2017-06-23,CR716311255834 RMCPL07564 1,,2017-06-23,500.0,,-528453332.3800006,.
409000438620',2017-06-23,CR716311255852 RMCPL13922 1,,2017-06-23,4000.0,,-528457332.3800006,.
409000438620',2017-06-23,CR716311257047 RMCPL13691 1,,2017-06-23,2000.0,,-528459332.3800006,.
409000438620',2017-06-23,CR716311257212 RMCPL11824 1,,2017-06-23,4000.0,,-528463332.3800006,.
409000438620',2017-06-23,CR716311257835 RMCPL12208 1,,2017-06-23,2000.0,,-528465332.3800006,.
409000438620',2017-06-23,CR716311258084 RMCPL11794 1,,2017-06-23,1000.0,,-528466332.3800006,.
409000438620',2017-06-23,CR716311258073 RMCPL13598 1,,2017-06-23,2000.0,,-528468332.3800006,.
409000438620',2017-06-23,CR716311258102 RMCPL13566 1,,2017-06-23,730.0,,-528469062.3800006,.
409000438620',2017-06-23,CR716311258685 RMCPL14208 1,,2017-06-23,3000.0,,-528472062.3800006,.
409000438620',2017-06-23,CR716311258855 RMCPL13973 1,,2017-06-23,320.0,,-528472382.3800006,.
409000438620',2017-06-23,CR716312275804 RMCPL11959 1,,2017-06-23,3030.0,,-528475412.3800006,.
409000438620',2017-06-23,CR716312275856 RMCPL14469 1,,2017-06-23,5000.0,,-528480412.3800006,.
409000438620',2017-06-23,CR716312282580 RMCPL00146 1,,2017-06-23,5000.0,,-528485412.3800006,.
409000438620',2017-06-23,CR716312304551 RMCPL11626 1,,2017-06-23,1010.0,,-528486422.3800006,.
409000438620',2017-06-23,CR716313313050 RMCPL12312 1,,2017-06-23,2030.0,,-528488452.3800006,.
409000438620',2017-06-23,CR716313313063 RMCPL12935 1,,2017-06-23,10000.0,,-528498452.3800006,.
409000438620',2017-06-23,CR716411849955 RMCPL10245 1,,2017-06-23,1000.0,,-528499452.3800006,.
409000438620',2017-06-23,CR716411851300 RMCPL00020 1,,2017-06-23,3500.0,,-528502952.3800006,.
409000438620',2017-06-23,CR716411862648 RMCPL09810 1,,2017-06-23,1500.0,,-528504452.3800006,.
409000438620',2017-06-23,CR716411862750 RMCPL09501 1,,2017-06-23,5756.0,,-528510208.3800006,.
409000438620',2017-06-23,CR716411865152 RMCPL09587 1,,2017-06-23,500.0,,-528510708.3800006,.
409000438620',2017-06-23,CR716411865618 RMCPL10070 1,,2017-06-23,3510.0,,-528514218.3800006,.
409000438620',2017-06-23,CR716411865699 RMCPL09925 1,,2017-06-23,10000.0,,-528524218.3800006,.
409000438620',2017-06-23,CR716411865633 RMCPL13692 1,,2017-06-23,10000.0,,-528534218.3800006,.
409000438620',2017-06-23,CR716411868138 RMCPL14596 1,,2017-06-23,100.0,,-528534318.3800006,.
409000438620',2017-06-23,CR716411868428 RMCPL11793 1,,2017-06-23,1000.0,,-528535318.3800006,.
409000438620',2017-06-23,CR716411868926 RMCPL14780 1,,2017-06-23,5000.0,,-528540318.3800006,.
409000438620',2017-06-23,CR716411868940 RMCPL12022 1,,2017-06-23,10000.0,,-528550318.3800006,.
409000438620',2017-06-23,CR716411868928 RMCPL11321 1,,2017-06-23,100.0,,-528550418.3800006,.
409000438620',2017-06-23,CR716411869030 RMCPL11206 1,,2017-06-23,10000.0,,-528560418.3800006,.
409000438620',2017-06-23,CR716411869047 RMCPL12562 1,,2017-06-23,1520.0,,-528561938.3800006,.
409000438620',2017-06-23,CR716611943343 RMCPL10086 1,,2017-06-23,600.0,,-528562538.3800006,.
409000438620',2017-06-23,CR716808970127 RMCPL02803 1,,2017-06-23,510.0,,-528563048.3800006,.
409000438620',2017-06-23,CR716809978796 RMCPL11793 1,,2017-06-23,3000.0,,-528566048.3800006,.
409000438620',2017-06-23,CR716809984201 RMCPL12012 1,,2017-06-23,5300.0,,-528571348.3800006,.
409000438620',2017-06-23,CR716809984304 RMCPL15076 1,,2017-06-23,4410.0,,-528575758.3800006,.
409000438620',2017-06-23,CR716809985897 RMCPL04922 1,,2017-06-23,1530.0,,-528577288.3800006,.
409000438620',2017-06-23,CR716809985985 RMCPL13525 1,,2017-06-23,7000.0,,-528584288.3800006,.
409000438620',2017-06-23,CR716809987696 RMCPL10753 1,,2017-06-23,1000.0,,-528585288.3800006,.
409000438620',2017-06-23,CR716809991116 RMCPL11793 1,,2017-06-23,3000.0,,-528588288.3800006,.
409000438620',2017-06-23,CR716809993903 RMCPL14590 1,,2017-06-23,2000.0,,-528590288.3800006,.
409000438620',2017-06-23,CR716809998251 RMCPL12731 1,,2017-06-23,1000.0,,-528591288.3800006,.
409000438620',2017-06-23,CR716809998268 RMCPL13553 1,,2017-06-23,500.0,,-528591788.3800006,.
409000438620',2017-06-23,CR716809998594 RMCPL09999 1,,2017-06-23,110.0,,-528591898.3800006,.
409000438620',2017-06-23,CR716810003929 RMCPL14511 1,,2017-06-23,1000.0,,-528592898.3800006,.
409000438620',2017-06-23,CR716810004720 RMCPL10890 1,,2017-06-23,600.0,,-528593498.3800006,.
409000438620',2017-06-23,CR716810006904 RMCPL11593 1,,2017-06-23,1000.0,,-528594498.3800006,.
409000438620',2017-06-23,CR716810008604 RMCPL09999 1,,2017-06-23,510.0,,-528595008.3800006,.
409000438620',2017-06-23,CR716810008721 RMCPL14819 1,,2017-06-23,2000.0,,-528597008.3800006,.
409000438620',2017-06-23,CR716810008785 RMCPL14005 1,,2017-06-23,10000.0,,-528607008.3800006,.
409000438620',2017-06-23,CR716810008866 RMCPL03249 1,,2017-06-23,5760.0,,-528612768.3800006,.
409000438620',2017-06-23,CR716810008868 RMCPL11140 1,,2017-06-23,520.0,,-528613288.3800006,.
409000438620',2017-06-23,CR716810022064 RMCPL09175 1,,2017-06-23,9000.0,,-528622288.3800006,.
409000438620',2017-06-23,CR717011024649 RMCPL12064 1,,2017-06-23,2000.0,,-528624288.3800006,.
409000438620',2017-06-23,CR717011025766 RMCPL15296 1,,2017-06-23,105.0,,-528624393.3800006,.
409000438620',2017-06-23,CR717011025767 RMCPL12832 1,,2017-06-23,2000.0,,-528626393.3800006,.
409000438620',2017-06-23,CR717011025891 RMCPL13965 1,,2017-06-23,1500.0,,-528627893.3800006,.
409000438620',2017-06-23,CR717011025974 RMCPL11195 1,,2017-06-23,4020.0,,-528631913.3800006,.
409000438620',2017-06-23,CR717011025936 RMCPL03657 1,,2017-06-23,2000.0,,-528633913.3800006,.
409000438620',2017-06-23,CR717011026019 RMCPL14740 1,,2017-06-23,2000.0,,-528635913.3800006,.
409000438620',2017-06-23,CR717011026109 RMCPL13801 1,,2017-06-23,2500.0,,-528638413.3800006,.
409000438620',2017-06-23,CR717011026112 RMCPL10242 1,,2017-06-23,6000.0,,-528644413.3800006,.
409000438620',2017-06-23,CR717011026903 RMCPL00519 1,,2017-06-23,620.0,,-528645033.3800006,.
409000438620',2017-06-23,CR717011027870 RMCPL11352 1,,2017-06-23,1000.0,,-528646033.3800006,.
409000438620',2017-06-23,CR717011027941 RMCPL09998 1,,2017-06-23,5860.0,,-528651893.3800006,.
409000438620',2017-06-23,CR717011029073 RMCPL15604 1,,2017-06-23,3200.0,,-528655093.3800006,.
409000438620',2017-06-23,CR717011029111 RMCPL00145 1,,2017-06-23,4000.0,,-528659093.3800006,.
409000438620',2017-06-23,CR717011029218 RMCPL11371 1,,2017-06-23,500.0,,-528659593.3800006,.
409000438620',2017-06-23,CR717011029821 RMCPL14835 1,,2017-06-23,500.0,,-528660093.3800006,.
409000438620',2017-06-23,CR717011030035 RMCPL11753 1,,2017-06-23,400.0,,-528660493.3800006,.
409000438620',2017-06-23,CR717011030044 RMCPL14426 1,,2017-06-23,5000.0,,-528665493.3800006,.
409000438620',2017-06-23,CR717011035220 RMCPL09587 1,,2017-06-23,2000.0,,-528667493.3800006,.
409000438620',2017-06-23,CR717011035205 RMCPL13376 1,,2017-06-23,1600.0,,-528669093.3800006,.
409000438620',2017-06-23,CR717011035308 RMCPL14805 1,,2017-06-23,1000.0,,-528670093.3800006,.
409000438620',2017-06-23,CR717012073901 RMCPL00119 1,,2017-06-23,520.0,,-528670613.3800006,.
409000438620',2017-06-23,CR717012074228 RMCPL15135 1,,2017-06-23,2200.0,,-528672813.3800006,.
409000438620',2017-06-23,CR717012074237 RMCPL15355 1,,2017-06-23,9000.0,,-528681813.3800006,.
409000438620',2017-06-23,CR717012074277 RMCPL11388 1,,2017-06-23,254.0,,-528682067.3800006,.
409000438620',2017-06-23,CR717012074325 RMCPL00161 1,,2017-06-23,510.0,,-528682577.3800006,.
409000438620',2017-06-23,AEPS ACQUIRING ADJ FEES 2,,2017-06-23,1081.83,,-528683659.2100006,.
409000438620',2017-06-23,CB716310230820 RMCPL01225 1,,2017-06-23,4000.0,,-528687659.2100006,.
409000438620',2017-06-23,Indiaforensic AEPS NPCI DEP SET,,2017-06-23,11762410.0,,-540450069.2100005,.
409000438620',2017-06-23,Indfor RIF AEPS NPCI DEP SET,,2017-06-23,1500.0,,-540451569.2100005,.
409000438620',2017-06-23,TRF TO  Indiaforensic SERVICES I,,2017-06-23,5800000.0,,-546251569.2100005,.
409000438620',2017-06-27,Indiaforensic AEPS NPCI WDL SET,,2017-06-27,,21837636.0,-524413933.2100005,.
409000438620',2017-06-27,Indfor-RIF AEPS NPCI WDL SET,,2017-06-27,,4800.0,-524409133.2100005,.
409000438620',2017-06-27,Indiaforensic AEPS NPCI WDL SET,,2017-06-27,,19563446.0,-504845687.2100005,.
409000438620',2017-06-27,Indiaforensic AEPS NPCI DEP SET,,2017-06-27,14775816.0,,-519621503.2100005,.
409000438620',2017-06-27,Indiaforensic AEPS NPCI DEP SET,,2017-06-27,12428783.0,,-532050286.2100005,.
409000438620',2017-06-27,TRF TO  Indiaforensic SERVICES I,,2017-06-27,14200000.0,,-546250286.2100005,.
409000438620',2017-06-27,Indiaforensic AEPS NPCI WDL SET,,2017-06-27,,11240837.0,-535009449.2100005,.
409000438620',2017-06-27,Indiaforensic AEPS NPCI WDL SET,,2017-06-27,,10388642.0,-524620807.2100005,.
409000438620',2017-06-27,Indiaforensic AEPS NPCI DEP SET,,2017-06-27,8933141.0,,-533553948.2100005,.
409000438620',2017-06-27,Indiaforensic AEPS NPCI DEP SET,,2017-06-27,7883150.0,,-541437098.2100005,.
409000438620',2017-06-27,Indfor-RIF AEPS NPCI DEP SET,,2017-06-27,4000.0,,-541441098.2100005,.
409000438620',2017-06-28,CB716809980278/RMCPL12720/1,,2017-06-28,2000.0,,-541443098.2100005,.
409000438620',2017-06-28,Indiaforensic AEPS NPCI WDL SET,,2017-06-28,,4305611.0,-537137487.2100005,.
409000438620',2017-06-28,Indiaforensic AEPS NPCI DEP SET,,2017-06-28,5170298.0,,-542307785.2100005,.
409000438620',2017-06-28,TRF TO  Indiaforensic SERVICES I,,2017-06-28,4000000.0,,-546307785.2100005,.
409000438620',2017-06-29,Indiaforensic AEPS NPCI WDL SET,,2017-06-29,,22142530.0,-524165255.2100005,.
409000438620',2017-06-29,Indiaforensic AEPS NPCI DEP SET,,2017-06-29,15520061.0,,-539685316.2100005,.
409000438620',2017-06-29,TRF TO  Indiaforensic SERVICES I,,2017-06-29,6600000.0,,-546285316.2100005,.
409000438620',2017-06-30,Indiaforensic AEPS NPCI WDL SET,,2017-06-30,,18947906.0,-527337410.2100005,.
409000438620',2017-06-30,Indiaforensic AEPS NPCI DEP SET,,2017-06-30,13544933.0,,-540882343.2100005,.
409000438620',2017-06-30,TRF TO  Indiaforensic SERVICES I,,2017-06-30,5400000.0,,-546282343.2100005,.
409000438620',2017-07-01,Indiaforensic AEPS NPCI WDL SET,,2017-07-01,,19500267.0,-526782076.2100005,.
409000438620',2017-07-01,Indfor RIF AEPS NPCI WDL SET,,2017-07-01,,10200.0,-526771876.2100005,.
409000438620',2017-07-01,AEPS ACQUIRING ADJ FEES 3,,2017-07-01,1558.67,,-526773434.88000053,.
409000438620',2017-07-01,CR717111565195/RMCPL06976/1,,2017-07-01,200.0,,-526773634.88000053,.
409000438620',2017-07-01,CR717111565305/RMCPL13561/1,,2017-07-01,730.0,,-526774364.88000053,.
409000438620',2017-07-01,CR717111565274/RMCPL14954/1,,2017-07-01,2000.0,,-526776364.88000053,.
409000438620',2017-07-01,CR717111566162/RMCPL14426/1,,2017-07-01,5000.0,,-526781364.88000053,.
409000438620',2017-07-01,CR717111566394/RMCPL14089/1,,2017-07-01,1000.0,,-526782364.88000053,.
409000438620',2017-07-01,CR717111566436/RMCPL13120/1,,2017-07-01,100.0,,-526782464.88000053,.
409000438620',2017-07-01,CR717111568291/RMCPL11246/1,,2017-07-01,500.0,,-526782964.88000053,.
409000438620',2017-07-01,CR717111577464/RMCPL13563/1,,2017-07-01,730.0,,-526783694.88000053,.
409000438620',2017-07-01,CR717111577482/RMCPL13306/1,,2017-07-01,2000.0,,-526785694.88000053,.
409000438620',2017-07-01,CR717111578933/RMCPL13559/1,,2017-07-01,500.0,,-526786194.88000053,.
409000438620',2017-07-01,CR717111579002/RMCPL11897/1,,2017-07-01,2200.0,,-526788394.88000053,.
409000438620',2017-07-01,CR717111579925/RMCPL13973/1,,2017-07-01,100.0,,-526788494.88000053,.
409000438620',2017-07-01,CR717111579943/RMCPL11943/1,,2017-07-01,1020.0,,-526789514.88000053,.
409000438620',2017-07-01,CR717111579956/RMCPL14730/1,,2017-07-01,2006.0,,-526791520.88000053,.
409000438620',2017-07-01,CR717111580047/RMCPL15135/1,,2017-07-01,800.0,,-526792320.88000053,.
409000438620',2017-07-01,CR717111580170/RMCPL09806/1,,2017-07-01,7000.0,,-526799320.88000053,.
409000438620',2017-07-01,CR717111581165/RMCPL11752/1,,2017-07-01,5050.0,,-526804370.88000053,.
409000438620',2017-07-01,CR717111582124/RMCPL15195/1,,2017-07-01,1500.0,,-526805870.88000053,.
409000438620',2017-07-01,CR717111582122/RMCPL10631/1,,2017-07-01,5000.0,,-526810870.88000053,.
409000438620',2017-07-01,CR717111594776/RMCPL15309/1,,2017-07-01,1000.0,,-526811870.88000053,.
409000438620',2017-07-01,CR717111594773/RMCPL14704/1,,2017-07-01,500.0,,-526812370.88000053,.
409000438620',2017-07-01,CR717111595549/RMCPL05050/1,,2017-07-01,4040.0,,-526816410.88000053,.
409000438620',2017-07-01,CR717111595884/RMCPL04922/1,,2017-07-01,3060.0,,-526819470.88000053,.
409000438620',2017-07-01,CR717111595128/RMCPL14979/1,,2017-07-01,1600.0,,-526821070.88000053,.
409000438620',2017-07-01,CR717111595721/RMCPL15215/1,,2017-07-01,300.0,,-526821370.88000053,.
409000438620',2017-07-01,CR717111595509/RMCPL00093/1,,2017-07-01,500.0,,-526821870.88000053,.
409000438620',2017-07-01,CR717112626904/RMCPL00010/1,,2017-07-01,1000.0,,-526822870.88000053,.
409000438620',2017-07-01,CR717112628829/RMCPL03182/1,,2017-07-01,530.0,,-526823400.88000053,.
409000438620',2017-07-01,CR717112630084/RMCPL13803/1,,2017-07-01,3000.0,,-526826400.88000053,.
409000438620',2017-07-01,CR717112630006/RMCPL14735/1,,2017-07-01,1500.0,,-526827900.88000053,.
409000438620',2017-07-01,CR717112630437/RMCPL14547/1,,2017-07-01,1000.0,,-526828900.88000053,.
409000438620',2017-07-01,CR717112630894/RMCPL10712/1,,2017-07-01,1400.0,,-526830300.88000053,.
409000438620',2017-07-01,CR717112631112/RMCPL12826/1,,2017-07-01,2124.0,,-526832424.88000053,.
409000438620',2017-07-01,CR717112631245/RMCPL11959/1,,2017-07-01,1010.0,,-526833434.88000053,.
409000438620',2017-07-01,CR717112631107/RMCPL14862/1,,2017-07-01,3010.0,,-526836444.88000053,.
409000438620',2017-07-01,CR717112631185/RMCPL11611/1,,2017-07-01,800.0,,-526837244.88000053,.
409000438620',2017-07-01,CR717112632974/RMCPL04232/1,,2017-07-01,2500.0,,-526839744.88000053,.
409000438620',2017-07-01,CR717112633005/RMCPL14995/1,,2017-07-01,910.0,,-526840654.88000053,.
409000438620',2017-07-01,CR717112633829/RMCPL00024/1,,2017-07-01,1020.0,,-526841674.88000053,.
409000438620',2017-07-01,CR717113642245/RMCPL13965/1,,2017-07-01,1000.0,,-526842674.88000053,.
409000438620',2017-07-01,CR717119828901/RMCPL13626/1,,2017-07-01,520.0,,-526843194.88000053,.
409000438620',2017-07-01,CR717119830114/RMCPL15301/1,,2017-07-01,2040.0,,-526845234.88000053,.
409000438620',2017-07-01,CR717119830264/RMCPL15710/1,,2017-07-01,290.0,,-526845524.88000053,.
409000438620',2017-07-01,CR717119831757/RMCPL01282/1,,2017-07-01,10000.0,,-526855524.88000053,.
409000438620',2017-07-01,CR717211109254/RMCPL14740/1,,2017-07-01,1500.0,,-526857024.88000053,.
409000438620',2017-07-01,CR717211109255/RMCPL08471/1,,2017-07-01,500.0,,-526857524.88000053,.
409000438620',2017-07-01,CR717211109595/RMCPL12219/1,,2017-07-01,5000.0,,-526862524.88000053,.
409000438620',2017-07-01,CR717211109764/RMCPL10066/1,,2017-07-01,1000.0,,-526863524.88000053,.
409000438620',2017-07-01,CR717211109773/RMCPL13176/1,,2017-07-01,1000.0,,-526864524.88000053,.
409000438620',2017-07-01,CR717211110676/RMCPL09249/1,,2017-07-01,1600.0,,-526866124.88000053,.
409000438620',2017-07-01,CR717211110598/RMCPL14533/1,,2017-07-01,5000.0,,-526871124.88000053,.
409000438620',2017-07-01,CR717211110611/RMCPL06602/1,,2017-07-01,2000.0,,-526873124.88000053,.
409000438620',2017-07-01,CR717211110615/RMCPL14208/1,,2017-07-01,100.0,,-526873224.88000053,.
409000438620',2017-07-01,CR717211111284/RMCPL13374/1,,2017-07-01,1000.0,,-526874224.88000053,.
409000438620',2017-07-01,CR717211120537/RMCPL15328/1,,2017-07-01,2000.0,,-526876224.88000053,.
409000438620',2017-07-01,CR717211120570/RMCPL10811/1,,2017-07-01,2000.0,,-526878224.88000053,.
409000438620',2017-07-01,CR717211120573/RMCPL10326/1,,2017-07-01,300.0,,-526878524.88000053,.
409000438620',2017-07-01,CR717211131484/RMCPL13563/1,,2017-07-01,730.0,,-526879254.88000053,.
409000438620',2017-07-01,CR717211131558/RMCPL00413/1,,2017-07-01,1000.0,,-526880254.88000053,.
409000438620',2017-07-01,CR717211131605/RMCPL13972/1,,2017-07-01,500.0,,-526880754.88000053,.
409000438620',2017-07-01,CR717211131762/RMCPL13973/1,,2017-07-01,100.0,,-526880854.88000053,.
409000438620',2017-07-01,CR717211131626/RMCPL11590/1,,2017-07-01,1000.0,,-526881854.88000053,.
409000438620',2017-07-01,CR717211131669/RMCPL09386/1,,2017-07-01,1900.0,,-526883754.88000053,.
409000438620',2017-07-01,CR717211137833/RMCPL00182/1,,2017-07-01,2000.0,,-526885754.88000053,.
409000438620',2017-07-01,CR717212154476/RMCPL00125/1,,2017-07-01,4500.0,,-526890254.88000053,.
409000438620',2017-07-01,CR717212155606/RMCPL11247/1,,2017-07-01,1800.0,,-526892054.88000053,.
409000438620',2017-07-01,CR717212155893/RMCPL13563/1,,2017-07-01,730.0,,-526892784.88000053,.
409000438620',2017-07-01,CR717212156141/RMCPL14232/1,,2017-07-01,700.0,,-526893484.88000053,.
409000438620',2017-07-01,CR717212156500/RMCPL10452/1,,2017-07-01,2500.0,,-526895984.88000053,.
409000438620',2017-07-01,CR717212156480/RMCPL15293/1,,2017-07-01,1500.0,,-526897484.88000053,.
409000438620',2017-07-01,CR717212157153/RMCPL10423/1,,2017-07-01,1000.0,,-526898484.88000053,.
409000438620',2017-07-01,CR717212157332/RMCPL13959/1,,2017-07-01,400.0,,-526898884.88000053,.
409000438620',2017-07-01,CR717212157479/RMCPL13563/1,,2017-07-01,730.0,,-526899614.88000053,.
409000438620',2017-07-01,CR717212157617/RMCPL15469/1,,2017-07-01,100.0,,-526899714.88000053,.
409000438620',2017-07-01,CR717212157846/RMCPL11056/1,,2017-07-01,1500.0,,-526901214.88000053,.
409000438620',2017-07-01,CR717212160315/RMCPL14965/1,,2017-07-01,300.0,,-526901514.88000053,.
409000438620',2017-07-01,CR717212161500/RMCPL14578/1,,2017-07-01,2000.0,,-526903514.88000053,.
409000438620',2017-07-01,CR717310637714/RMCPL12357/1,,2017-07-01,500.0,,-526904014.88000053,.
409000438620',2017-07-01,CR717311666328/RMCPL00102/1,,2017-07-01,200.0,,-526904214.88000053,.
409000438620',2017-07-01,CR717311666340/RMCPL13837/1,,2017-07-01,400.0,,-526904614.88000053,.
409000438620',2017-07-01,CR717311673843/RMCPL10734/1,,2017-07-01,2000.0,,-526906614.88000053,.
409000438620',2017-07-01,CR717311673862/RMCPL09743/1,,2017-07-01,1000.0,,-526907614.88000053,.
409000438620',2017-07-01,CR717311673870/RMCPL15215/1,,2017-07-01,710.0,,-526908324.88000053,.
409000438620',2017-07-01,CR717311674055/RMCPL13157/1,,2017-07-01,1500.0,,-526909824.88000053,.
409000438620',2017-07-01,CR717311674143/RMCPL14344/1,,2017-07-01,2000.0,,-526911824.88000053,.
409000438620',2017-07-01,CR717311676858/RMCPL11279/1,,2017-07-01,500.0,,-526912324.88000053,.
409000438620',2017-07-01,CR717311676876/RMCPL15358/1,,2017-07-01,500.0,,-526912824.88000053,.
409000438620',2017-07-01,CR717311678478/RMCPL13317/1,,2017-07-01,2000.0,,-526914824.88000053,.
409000438620',2017-07-01,CR717311678632/RMCPL09033/1,,2017-07-01,2700.0,,-526917524.88000053,.
409000438620',2017-07-01,CR717311678644/RMCPL11811/1,,2017-07-01,10000.0,,-526927524.88000053,.
409000438620',2017-07-01,CR717311678724/RMCPL10943/1,,2017-07-01,10000.0,,-526937524.88000053,.
409000438620',2017-07-01,CR717312693464/RMCPL09999/1,,2017-07-01,110.0,,-526937634.88000053,.
409000438620',2017-07-01,CR717312694128/RMCPL12944/1,,2017-07-01,1000.0,,-526938634.88000053,.
409000438620',2017-07-01,CR717312694183/RMCPL10102/1,,2017-07-01,1020.0,,-526939654.88000053,.
409000438620',2017-07-01,CR717312694218/RMCPL13157/1,,2017-07-01,2000.0,,-526941654.88000053,.
409000438620',2017-07-01,CR717312694301/RMCPL00188/1,,2017-07-01,100.0,,-526941754.88000053,.
409000438620',2017-07-01,CR717312694312/RMCPL14838/1,,2017-07-01,1000.0,,-526942754.88000053,.
409000438620',2017-07-01,CR717312703322/RMCPL09810/1,,2017-07-01,100.0,,-526942854.88000053,.
409000438620',2017-07-01,CR717312703476/RMCPL10342/1,,2017-07-01,1000.0,,-526943854.88000053,.
409000438620',2017-07-01,CR717312703513/RMCPL14104/1,,2017-07-01,1005.0,,-526944859.88000053,.
409000438620',2017-07-01,CR717312703533/RMCPL14949/1,,2017-07-01,5000.0,,-526949859.88000053,.
409000438620',2017-07-01,CR717314762383/RMCPL11624/1,,2017-07-01,1050.0,,-526950909.88000053,.
409000438620',2017-07-01,CR717314762398/RMCPL10371/1,,2017-07-01,8000.0,,-526958909.88000053,.
409000438620',2017-07-01,CR717314762446/RMCPL09117/1,,2017-07-01,2400.0,,-526961309.88000053,.
409000438620',2017-07-01,CR717314762545/RMCPL13973/1,,2017-07-01,10000.0,,-526971309.88000053,.
409000438620',2017-07-01,CR717314764263/RMCPL11811/1,,2017-07-01,510.0,,-526971819.88000053,.
409000438620',2017-07-01,CR717314764350/RMCPL14453/1,,2017-07-01,1500.0,,-526973319.88000053,.
409000438620',2017-07-01,CR717314764405/RMCPL14691/1,,2017-07-01,100.0,,-526973419.88000053,.
409000438620',2017-07-01,CR717314765353/RMCPL11811/1,,2017-07-01,4040.0,,-526977459.88000053,.
409000438620',2017-07-01,CR717314765860/RMCPL12008/1,,2017-07-01,1000.0,,-526978459.88000053,.
409000438620',2017-07-01,CR717316823286/RMCPL14740/1,,2017-07-01,10000.0,,-526988459.88000053,.
409000438620',2017-07-01,CR717316823300/RMCPL11535/1,,2017-07-01,1100.0,,-526989559.88000053,.
409000438620',2017-07-01,CR717316823326/RMCPL13062/1,,2017-07-01,3040.0,,-526992599.88000053,.
409000438620',2017-07-01,CR717316823353/RMCPL14735/1,,2017-07-01,10000.0,,-527002599.88000053,.
409000438620',2017-07-01,CR717316823348/RMCPL00052/1,,2017-07-01,510.0,,-527003109.88000053,.
409000438620',2017-07-01,CR717316823355/RMCPL12121/1,,2017-07-01,510.0,,-527003619.88000053,.
409000438620',2017-07-01,CR717316823366/RMCPL13619/1,,2017-07-01,1000.0,,-527004619.88000053,.
409000438620',2017-07-01,CR717316823397/RMCPL13757/1,,2017-07-01,2000.0,,-527006619.88000053,.
409000438620',2017-07-01,CR717316823443/RMCPL00292/1,,2017-07-01,500.0,,-527007119.88000053,.
409000438620',2017-07-01,CR717316824117/RMCPL15015/1,,2017-07-01,2000.0,,-527009119.88000053,.
409000438620',2017-07-01,CR717316824191/RMCPL13619/1,,2017-07-01,1000.0,,-527010119.88000053,.
409000438620',2017-07-01,CR717316825316/RMCPL14546/1,,2017-07-01,500.0,,-527010619.88000053,.
409000438620',2017-07-01,CR717316826205/RMCPL01928/1,,2017-07-01,1500.0,,-527012119.88000053,.
409000438620',2017-07-01,CR717316826305/RMCPL13352/1,,2017-07-01,2500.0,,-527014619.88000053,.
409000438620',2017-07-01,CR717316826380/RMCPL10937/1,,2017-07-01,7000.0,,-527021619.88000053,.
409000438620',2017-07-01,CR717316826393/RMCPL13453/1,,2017-07-01,300.0,,-527021919.88000053,.
409000438620',2017-07-01,CR717316826397/RMCPL12527/1,,2017-07-01,1100.0,,-527023019.88000053,.
409000438620',2017-07-01,CR717316826419/RMCPL09930/1,,2017-07-01,1000.0,,-527024019.88000053,.
409000438620',2017-07-01,CR717316826500/RMCPL13757/1,,2017-07-01,2000.0,,-527026019.88000053,.
409000438620',2017-07-01,CR717316827344/RMCPL15361/1,,2017-07-01,500.0,,-527026519.88000053,.
409000438620',2017-07-01,CR717316827343/RMCPL10242/1,,2017-07-01,1800.0,,-527028319.88000053,.
409000438620',2017-07-01,CR717316827523/RMCPL13453/1,,2017-07-01,300.0,,-527028619.88000053,.
409000438620',2017-07-01,CR717317850033/RMCPL13317/1,,2017-07-01,2500.0,,-527031119.88000053,.
409000438620',2017-07-01,CR717317850129/RMCPL01612/1,,2017-07-01,1000.0,,-527032119.88000053,.
409000438620',2017-07-01,CR717317850130/RMCPL00021/1,,2017-07-01,2000.0,,-527034119.88000053,.
409000438620',2017-07-01,CR717317850158/RMCPL11912/1,,2017-07-01,900.0,,-527035019.88000053,.
409000438620',2017-07-01,CR717317850199/RMCPL15084/1,,2017-07-01,580.0,,-527035599.88000053,.
409000438620',2017-07-01,CR717317850209/RMCPL12807/1,,2017-07-01,500.0,,-527036099.88000053,.
409000438620',2017-07-01,CR717317850259/RMCPL13619/1,,2017-07-01,1800.0,,-527037899.88000053,.
409000438620',2017-07-01,CR717317850284/RMCPL12720/1,,2017-07-01,10000.0,,-527047899.88000053,.
409000438620',2017-07-01,CR717317852512/RMCPL14740/1,,2017-07-01,5000.0,,-527052899.88000053,.
409000438620',2017-07-01,CR717317853695/RMCPL13003/1,,2017-07-01,7640.0,,-527060539.88000053,.
409000438620',2017-07-01,CR717319954538/RMCPL10453/1,,2017-07-01,200.0,,-527060739.88000053,.
409000438620',2017-07-01,CR717319954684/RMCPL03587/1,,2017-07-01,4100.0,,-527064839.88000053,.
409000438620',2017-07-01,CR717319954847/RMCPL10102/1,,2017-07-01,2020.0,,-527066859.88000053,.
409000438620',2017-07-01,CR717319962784/RMCPL15213/1,,2017-07-01,200.0,,-527067059.88000053,.
409000438620',2017-07-01,CR717319962820/RMCPL03733/1,,2017-07-01,10000.0,,-527077059.88000053,.
409000438620',2017-07-01,CR717319962858/RMCPL12579/1,,2017-07-01,1300.0,,-527078359.88000053,.
409000438620',2017-07-01,CR717320998562/RMCPL11358/1,,2017-07-01,4000.0,,-527082359.88000053,.
409000438620',2017-07-01,CR717321022497/RMCPL14937/1,,2017-07-01,500.0,,-527082859.88000053,.
409000438620',2017-07-01,CR717321022591/RMCPL04395/1,,2017-07-01,1031.0,,-527083890.88000053,.
409000438620',2017-07-01,CR717321022650/RMCPL06758/1,,2017-07-01,10000.0,,-527093890.88000053,.
409000438620',2017-07-01,CR717321022785/RMCPL10736/1,,2017-07-01,2000.0,,-527095890.88000053,.
409000438620',2017-07-01,CR717411190092/RMCPL12201/1,,2017-07-01,7000.0,,-527102890.88000053,.
409000438620',2017-07-01,CR717411190553/RMCPL05123/1,,2017-07-01,2500.0,,-527105390.88000053,.
409000438620',2017-07-01,CR717411190620/RMCPL15507/1,,2017-07-01,1600.0,,-527106990.88000053,.
409000438620',2017-07-01,CR717411190679/RMCPL11959/1,,2017-07-01,1020.0,,-527108010.88000053,.
409000438620',2017-07-01,CR717411190791/RMCPL13808/1,,2017-07-01,1002.0,,-527109012.88000053,.
409000438620',2017-07-01,CR717411190757/RMCPL10501/1,,2017-07-01,500.0,,-527109512.88000053,.
409000438620',2017-07-01,CR717411190948/RMCPL15174/1,,2017-07-01,9500.0,,-527119012.88000053,.
409000438620',2017-07-01,CR717411190888/RMCPL14788/1,,2017-07-01,1615.0,,-527120627.88000053,.
409000438620',2017-07-01,CR717411191780/RMCPL13560/1,,2017-07-01,730.0,,-527121357.88000053,.
409000438620',2017-07-01,CR717411191807/RMCPL13553/1,,2017-07-01,1500.0,,-527122857.88000053,.
409000438620',2017-07-01,CR717411191897/RMCPL10817/1,,2017-07-01,1000.0,,-527123857.88000053,.
409000438620',2017-07-01,CR717411191910/RMCPL10768/1,,2017-07-01,5000.0,,-527128857.88000053,.
409000438620',2017-07-01,CR717411192063/RMCPL11445/1,,2017-07-01,1000.0,,-527129857.88000053,.
409000438620',2017-07-01,CR717411192526/RMCPL10638/1,,2017-07-01,8000.0,,-527137857.88000053,.
409000438620',2017-07-01,CR717411193311/RMCPL12036/1,,2017-07-01,1000.0,,-527138857.88000053,.
409000438620',2017-07-01,CR717412225518/RMCPL14546/1,,2017-07-01,2500.0,,-527141357.88000053,.
409000438620',2017-07-01,CR717510691472/RMCPL14108/1,,2017-07-01,1000.0,,-527142357.88000053,.
409000438620',2017-07-01,CR717512751373/RMCPL14600/1,,2017-07-01,2500.0,,-527144857.88000053,.
409000438620',2017-07-01,CR717512752067/RMCPL00257/1,,2017-07-01,500.0,,-527145357.88000053,.
409000438620',2017-07-01,CR717512752037/RMCPL12251/1,,2017-07-01,6565.0,,-527151922.88000053,.
409000438620',2017-07-01,CR717512751834/RMCPL11265/1,,2017-07-01,2230.0,,-527154152.88000053,.
409000438620',2017-07-01,CR717512752050/RMCPL11951/1,,2017-07-01,100.0,,-527154252.88000053,.
409000438620',2017-07-01,CR717512753509/RMCPL00065/1,,2017-07-01,1000.0,,-527155252.88000053,.
409000438620',2017-07-01,CR717517895194/RMCPL11785/1,,2017-07-01,2500.0,,-527157752.88000053,.
409000438620',2017-07-01,CR717517895198/RMCPL11337/1,,2017-07-01,700.0,,-527158452.88000053,.
409000438620',2017-07-01,CR717517895206/RMCPL13973/1,,2017-07-01,100.0,,-527158552.88000053,.
409000438620',2017-07-01,CR717517895226/RMCPL14183/1,,2017-07-01,1500.0,,-527160052.88000053,.
409000438620',2017-07-01,CR717517895252/RMCPL10759/1,,2017-07-01,8000.0,,-527168052.88000053,.
409000438620',2017-07-01,CR717517896115/RMCPL13806/1,,2017-07-01,3000.0,,-527171052.88000053,.
409000438620',2017-07-01,Indiaforensic AEPS NPCI DEP SET,,2017-07-01,12400333.0,,-539571385.8800006,.
409000438620',2017-07-03,Indiaforensic AEPS NPCI WDL SET,,2017-07-03,,9866344.0,-529705041.8800006,.
409000438620',2017-07-03,Indiaforensic AEPS NPCI WDL SET,,2017-07-03,,14673020.0,-515032021.8800006,.
409000438620',2017-07-03,Indfor RIF AEPS NPCI WDL SET,,2017-07-03,,20200.0,-515011821.8800006,.
409000438620',2017-07-03,Indiaforensic AEPS NPCI DEP SET,,2017-07-03,7708925.0,,-522720746.8800006,.
409000438620',2017-07-03,Indiaforensic AEPS NPCI DEP SET,,2017-07-03,9107463.0,,-531828209.8800006,.
409000438620',2017-07-03,Indfor RIF AEPS NPCI DEP SET,,2017-07-03,10300.0,,-531838509.8800006,.
409000438620',2017-07-03,TRF TO  Indiaforensic SERVICES I,,2017-07-03,14400000.0,,-546238509.8800006,.
409000438620',2017-07-04,GF CB706412580482/050317,,2017-07-04,4000.0,,-546242509.8800006,.
409000438620',2017-07-04,AEPS ACQUIRING ADJ FEES 0,,2017-07-04,17.25,,-546242527.1300006,.
409000438620',2017-07-04,AEPS Indiaforensic INCOME 260517,,2017-07-04,,59708.64,-546182818.4900006,.
409000438620',2017-07-04,AEPS Indiaforensic S TAX 260517,,2017-07-04,,8956.3,-546173862.1900007,.
409000438620',2017-07-04,AEPS Indiaforensic INCOME 270517,,2017-07-04,,46806.16,-546127056.0300007,.
409000438620',2017-07-04,AEPS Indiaforensic S TAX 270517,,2017-07-04,,7020.92,-546120035.1100007,.
409000438620',2017-07-04,AEPS Indiaforensic INCOME 280517,,2017-07-04,,37817.85,-546082217.2600007,.
409000438620',2017-07-04,AEPS Indiaforensic S TAX 280517,,2017-07-04,,5672.68,-546076544.5800008,.
409000438620',2017-07-04,AEPS Indiaforensic INCOME 290517,,2017-07-04,,69412.96,-546007131.6200007,.
409000438620',2017-07-04,AEPS Indiaforensic S TAX 290517,,2017-07-04,,10411.94,-545996719.6800007,.
409000438620',2017-07-04,AEPS Indiaforensic INCOME 300517,,2017-07-04,,68199.56,-545928520.1200007,.
409000438620',2017-07-04,AEPS Indiaforensic S TAX 300517,,2017-07-04,,10229.93,-545918290.1900008,.
409000438620',2017-07-04,AEPS Indiaforensic INCOME 310517,,2017-07-04,,66003.64,-545852286.5500008,.
409000438620',2017-07-04,AEPS Indiaforensic S TAX 310517,,2017-07-04,,9900.55,-545842386.0000008,.
409000438620',2017-07-04,AEPS Indiaforensic INCOME 010617,,2017-07-04,,70425.8,-545771960.2000009,.
409000438620',2017-07-04,AEPS Indiaforensic S TAX 010617,,2017-07-04,,10563.87,-545761396.3300009,.
409000438620',2017-07-04,AEPS Indiaforensic INCOME 020617,,2017-07-04,,68784.33,-545692612.0000008,.
409000438620',2017-07-04,AEPS Indiaforensic S TAX 020617,,2017-07-04,,10317.65,-545682294.3500009,.
409000438620',2017-07-04,AEPS Indiaforensic INCOME 030617,,2017-07-04,,60576.65,-545621717.7000009,.
409000438620',2017-07-04,AEPS Indiaforensic S TAX 030617,,2017-07-04,,9086.5,-545612631.2000009,.
409000438620',2017-07-04,AEPS Indiaforensic INCOME 040617,,2017-07-04,,44271.84,-545568359.3600008,.
409000438620',2017-07-04,AEPS Indiaforensic S TAX 040617,,2017-07-04,,6640.78,-545561718.5800009,.
409000438620',2017-07-04,AEPS Indiaforensic INCOME 050617,,2017-07-04,,63897.69,-545497820.8900008,.
409000438620',2017-07-04,AEPS Indiaforensic S TAX 050617,,2017-07-04,,9584.65,-545488236.2400008,.
409000438620',2017-07-04,AEPS Indiaforensic INCOME 060617,,2017-07-04,,78118.83,-545410117.4100008,.
409000438620',2017-07-04,AEPS Indiaforensic S TAX 060617,,2017-07-04,,11717.82,-545398399.5900007,.
409000438620',2017-07-04,AEPS Indiaforensic INCOME 070617,,2017-07-04,,77332.67,-545321066.9200008,.
409000438620',2017-07-04,AEPS Indiaforensic S TAX 070617,,2017-07-04,,11599.9,-545309467.0200008,.
409000438620',2017-07-04,AEPS Indiaforensic INCOME 080617,,2017-07-04,,84254.63,-545225212.3900008,.
409000438620',2017-07-04,AEPS Indiaforensic S TAX 080617,,2017-07-04,,12638.19,-545212574.2000008,.
409000438620',2017-07-04,AEPS Indiaforensic INCOME 090617,,2017-07-04,,86083.49,-545126490.7100008,.
409000438620',2017-07-04,AEPS Indiaforensic S TAX 090617,,2017-07-04,,12912.52,-545113578.1900008,.
409000438620',2017-07-04,AEPS Indiaforensic INCOME 100617,,2017-07-04,,75738.79,-545037839.4000008,.
409000438620',2017-07-04,AEPS Indiaforensic S TAX 100617,,2017-07-04,,11360.82,-545026478.5800008,.
409000438620',2017-07-04,AEPS Indiaforensic INCOME 110617,,2017-07-04,,55271.03,-544971207.5500008,.
409000438620',2017-07-04,AEPS Indiaforensic S TAX 110617,,2017-07-04,,8290.65,-544962916.9000008,.
409000438620',2017-07-04,AEPS Indiaforensic INCOME 120617,,2017-07-04,,87859.99,-544875056.9100008,.
409000438620',2017-07-04,AEPS Indiaforensic S TAX 120617,,2017-07-04,,13179.0,-544861877.9100008,.
409000438620',2017-07-04,Indiaforensic AEPS NPCI WDL SET,,2017-07-04,,16163031.0,-528698846.9100008,.
409000438620',2017-07-04,Indfor RIF AEPS NPCI WDL SET,,2017-07-04,,25900.0,-528672946.9100008,.
409000438620',2017-07-04,AEPS Indiaforensic INCOME 130617,,2017-07-04,,88731.42,-528584215.4900008,.
409000438620',2017-07-04,AEPS Indiaforensic S TAX 130617,,2017-07-04,,13309.71,-528570905.7800008,.
409000438620',2017-07-04,AEPS Indiaforensic INCOME 140617,,2017-07-04,,96833.93,-528474071.8500008,.
409000438620',2017-07-04,AEPS Indiaforensic S TAX 140617,,2017-07-04,,14525.09,-528459546.7600008,.
409000438620',2017-07-04,AEPS Indiaforensic INCOME 150617,,2017-07-04,,88536.09,-528371010.67000085,.
409000438620',2017-07-04,AEPS Indiaforensic S TAX 150617,,2017-07-04,,13280.41,-528357730.2600008,.
409000438620',2017-07-04,AEPS Indiaforensic INCOME 160617,,2017-07-04,,83275.23,-528274455.0300008,.
409000438620',2017-07-04,AEPS Indiaforensic S TAX 160617,,2017-07-04,,12491.28,-528261963.75000083,.
409000438620',2017-07-04,AEPS Indiaforensic INCOME 170617,,2017-07-04,,70950.5,-528191013.25000083,.
409000438620',2017-07-04,AEPS Indiaforensic S TAX 170617,,2017-07-04,,10642.58,-528180370.67000085,.
409000438620',2017-07-04,AEPS Indiaforensic INCOME 180617,,2017-07-04,,51205.1,-528129165.5700008,.
409000438620',2017-07-04,AEPS Indiaforensic S TAX 180617,,2017-07-04,,7680.77,-528121484.80000085,.
409000438620',2017-07-04,AEPS Indiaforensic INCOME 190617,,2017-07-04,,78506.43,-528042978.37000084,.
409000438620',2017-07-04,AEPS Indiaforensic S TAX 190617,,2017-07-04,,11775.96,-528031202.41000086,.
409000438620',2017-07-04,AEPS Indiaforensic INCOME 200617,,2017-07-04,,69819.06,-527961383.35000086,.
409000438620',2017-07-04,AEPS Indiaforensic S TAX 200617,,2017-07-04,,10472.86,-527950910.49000084,.
409000438620',2017-07-04,AEPS Indiaforensic INCOME 210617,,2017-07-04,,77785.63,-527873124.86000085,.
409000438620',2017-07-04,AEPS Indiaforensic S TAX 210617,,2017-07-04,,11667.84,-527861457.0200009,.
409000438620',2017-07-04,AEPS Indiaforensic INCOME 220617,,2017-07-04,,71918.0,-527789539.0200009,.
409000438620',2017-07-04,AEPS Indiaforensic S TAX 220617,,2017-07-04,,10787.7,-527778751.3200009,.
409000438620',2017-07-04,AEPS Indiaforensic INCOME 230617,,2017-07-04,,88160.07,-527690591.2500009,.
409000438620',2017-07-04,AEPS Indiaforensic S TAX 230617,,2017-07-04,,13224.01,-527677367.2400009,.
409000438620',2017-07-04,AEPS Indiaforensic INCOME 240617,,2017-07-04,,78204.74,-527599162.5000009,.
409000438620',2017-07-04,AEPS Indiaforensic S TAX 240617,,2017-07-04,,11730.71,-527587431.7900009,.
409000438620',2017-07-04,AEPS Indiaforensic INCOME 250617,,2017-07-04,,50145.26,-527537286.5300009,.
409000438620',2017-07-04,AEPS Indiaforensic S TAX 250617,,2017-07-04,,7521.79,-527529764.7400009,.
409000438620',2017-07-04,AEPS Indiaforensic INCOME 260617,,2017-07-04,,46448.23,-527483316.5100009,.
409000438620',2017-07-04,AEPS Indiaforensic S TAX 260617,,2017-07-04,,6967.23,-527476349.28000087,.
409000438620',2017-07-04,AEPS Indiaforensic INCOME 270617,,2017-07-04,,23150.83,-527453198.4500009,.
409000438620',2017-07-04,AEPS Indiaforensic S TAX 270617,,2017-07-04,,3472.62,-527449725.8300009,.
409000438620',2017-07-04,AEPS Indiaforensic INCOME 280617,,2017-07-04,,93124.67,-527356601.16000086,.
409000438620',2017-07-04,AEPS Indiaforensic S TAX 280617,,2017-07-04,,13968.7,-527342632.4600009,.
409000438620',2017-07-04,AEPS Indiaforensic INCOME 290617,,2017-07-04,,77789.92,-527264842.54000086,.
409000438620',2017-07-04,AEPS Indiaforensic S TAX 290617,,2017-07-04,,11668.49,-527253174.05000085,.
409000438620',2017-07-04,AEPS Indiaforensic INCOME 300617,,2017-07-04,,78103.54,-527175070.5100008,.
409000438620',2017-07-04,AEPS Indiaforensic S TAX 300617,,2017-07-04,,11715.53,-527163354.98000085,.
409000438620',2017-07-04,Indiaforensic AEPS NPCI DEP SET,,2017-07-04,10034199.0,,-537197553.9800009,.
409000438620',2017-07-04,Indfor RIF AEPS NPCI DEP SET,,2017-07-04,10000.0,,-537207553.9800009,.
409000438620',2017-07-04,CB717319962929/RMCPL11504/2,,2017-07-04,10000.0,,-537217553.9800009,.
409000438620',2017-07-04,TRF TO  Indiaforensic SERVICES I,,2017-07-04,5000000.0,,-542217553.9800009,.
409000438620',2017-07-04,TRF TO  Indiaforensic SERVICES I,,2017-07-04,4000000.0,,-546217553.9800009,.
409000438620',2017-07-04,AEPS Indiaforensic INCOME 010717,,2017-07-04,,42644.22,-546174909.7600008,.
409000438620',2017-07-04,AEPS Indiaforensic S TAX 010717,,2017-07-04,,7675.96,-546167233.8000008,.
409000438620',2017-07-04,AEPS Indiaforensic INCOME 020717,,2017-07-04,,60003.23,-546107230.5700008,.
409000438620',2017-07-04,AEPS Indiaforensic S TAX 020717,,2017-07-04,,10800.58,-546096429.9900007,.
409000438620',2017-07-04,AEPS Indiaforensic INCOME 030717,,2017-07-04,,64309.89,-546032120.1000007,.
409000438620',2017-07-04,AEPS Indiaforensic S TAX 030717,,2017-07-04,,11575.78,-546020544.3200008,.
409000438620',2017-07-05,AEPS ACQUIRING ADJ FEES 0,,2017-07-05,17.7,,-546020562.0200008,.
409000438620',2017-07-05,AEPS Indiaforensic INCOME 040717,,2017-07-05,,64246.79,-545956315.2300009,.
409000438620',2017-07-05,AEPS Indiaforensic S TAX 040717,,2017-07-05,,11564.42,-545944750.8100009,.
409000438620',2017-07-05,Indiaforensic AEPS NPCI WDL SET,,2017-07-05,,15595093.0,-530349657.8100009,.
409000438620',2017-07-05,Indfor RIF AEPS NPCI WDL SET,,2017-07-05,,5600.0,-530344057.8100009,.
409000438620',2017-07-05,Indiaforensic AEPS NPCI DEP SET,,2017-07-05,10584706.0,,-540928763.8100009,.
409000438620',2017-07-05,TRF TO  Indiaforensic SERVICES I,,2017-07-05,5300000.0,,-546228763.8100009,.
409000438620',2017-07-06,CB718410880536/RMCPL08948/0,,2017-07-06,4500.0,,-546233263.8100009,.
409000438620',2017-07-06,AEPS Indiaforensic INCOME 050717,,2017-07-06,,81412.4,-546151851.4100009,.
409000438620',2017-07-06,AEPS Indiaforensic S TAX 050717,,2017-07-06,,14654.23,-546137197.1800009,.
409000438620',2017-07-06,Indiaforensic AEPS NPCI WDL SET,,2017-07-06,,19662234.0,-526474963.1800009,.
409000438620',2017-07-06,Indfor RIF AEPS NPCI WDL SET,,2017-07-06,,800.0,-526474163.1800009,.
409000438620',2017-07-06,TRF TO  Indiaforensic SERVICES I,,2017-07-06,2000000.0,,-528474163.1800009,.
409000438620',2017-07-06,TRF TO  Indiaforensic SERVICES I,,2017-07-06,3000000.0,,-531474163.1800009,.
409000438620',2017-07-06,Indiaforensic AEPS NPCI DEP SET,,2017-07-06,13864118.0,,-545338281.1800009,.
409000438620',2017-07-07,AEPS Indiaforensic INCOME 010717,,2017-07-07,,85575.63,-545252705.5500009,.
409000438620',2017-07-07,AEPS Indiaforensic S TAX 010717,,2017-07-07,,15403.61,-545237301.9400009,.
409000438620',2017-07-07,Indiaforensic AEPS NPCI WDL SET,,2017-07-07,,19950035.0,-525287266.9400009,.
409000438620',2017-07-07,Indiaforensic AEPS NPCI DEP SET,,2017-07-07,14983135.0,,-540270401.9400009,.
409000438620',2017-07-07,TRF TO  Indiaforensic SERVICES I,,2017-07-07,6000000.0,,-546270401.9400009,.
409000438620',2017-07-10,AEPS Indiaforensic INCOME 070717,,2017-07-10,,70760.34,-546199641.6000009,.
409000438620',2017-07-10,AEPS Indiaforensic S TAX 070717,,2017-07-10,,12736.86,-546186904.7400008,.
409000438620',2017-07-10,AEPS Indiaforensic INCOME 080717,,2017-07-10,,86328.48,-546100576.2600008,.
409000438620',2017-07-10,AEPS Indiaforensic S TAX 080717,,2017-07-10,,15539.13,-546085037.1300008,.
409000438620',2017-07-10,AEPS Indiaforensic INCOME 090717,,2017-07-10,,64221.35,-546020815.7800008,.
409000438620',2017-07-10,AEPS Indiaforensic S TAX 090717,,2017-07-10,,11559.84,-546009255.9400008,.
409000438620',2017-07-10,Indiaforensic AEPS NPCI WDL SET,,2017-07-10,,17440432.0,-528568823.9400008,.
409000438620',2017-07-10,Indiaforensic AEPS NPCI WDL SET,,2017-07-10,,21718961.0,-506849862.9400008,.
409000438620',2017-07-10,Indfor RIF AEPS NPCI WDL SET,,2017-07-10,,6100.0,-506843762.9400008,.
409000438620',2017-07-10,Indiaforensic AEPS NPCI WDL SET,,2017-07-10,,14682733.0,-492161029.9400008,.
409000438620',2017-07-10,Indiaforensic AEPS NPCI DEP SET,,2017-07-10,11328648.0,,-503489677.9400008,.
409000438620',2017-07-10,Indiaforensic AEPS NPCI DEP SET,,2017-07-10,12448277.0,,-515937954.9400008,.
409000438620',2017-07-10,Indiaforensic AEPS NPCI DEP SET,,2017-07-10,10747609.0,,-526685563.9400008,.
409000438620',2017-07-10,TRANSFER TO  Indiaforensic SERVI,,2017-07-10,15000000.0,,-541685563.9400008,.
409000438620',2017-07-10,TRANSFER TO  Indiaforensic SERVI,,2017-07-10,4600000.0,,-546285563.9400008,.
409000438620',2017-07-11,AEPS Indiaforensic INCOME 100717,,2017-07-11,,89541.43,-546196022.5100008,.
409000438620',2017-07-11,AEPS Indiaforensic S TAX 100717,,2017-07-11,,16117.46,-546179905.0500008,.
409000438620',2017-07-11,Indiaforensic AEPS NPCI WDL SET,,2017-07-11,,22647272.0,-523532633.0500008,.
409000438620',2017-07-11,Indfor RIF AEPS NPCI WDL SET,,2017-07-11,,18000.0,-523514633.0500008,.
409000438620',2017-07-11,Indiaforensic AEPS NPCI DEP SET,,2017-07-11,13876638.0,,-537391271.0500008,.
409000438620',2017-07-11,TRF TO  Indiaforensic SERVICES I,,2017-07-11,8900000.0,,-546291271.0500008,.
409000438620',2017-07-12,AEPS ACQUIRING ADJ FEES 1,,2017-07-12,11.36,,-546291282.4100008,.
409000438620',2017-07-12,AEPS Indiaforensic INCOME 110717,,2017-07-12,,87348.0,-546203934.4100008,.
409000438620',2017-07-12,AEPS Indiaforensic S TAX 110717,,2017-07-12,,15722.64,-546188211.7700008,.
409000438620',2017-07-12,Indiaforensic AEPS NPCI WDL SET,,2017-07-12,,22130548.0,-524057663.7700008,.
409000438620',2017-07-12,Indiaforensic AEPS NPCI DEP SET,,2017-07-12,13594535.0,,-537652198.7700008,.
409000438620',2017-07-12,TRF TO  Indiaforensic SERVICES I,,2017-07-12,8600000.0,,-546252198.7700008,.
409000438620',2017-07-13,AEPS ACQUIRING ADJ FEES 1,,2017-07-13,2.95,,-546252201.7200009,.
409000438620',2017-07-13,AEPS Indiaforensic INCOME 120717,,2017-07-13,,81367.85,-546170833.8700008,.
409000438620',2017-07-13,AEPS Indiaforensic S TAX 120717,,2017-07-13,,14646.21,-546156187.6600008,.
409000438620',2017-07-13,Indiaforensic AEPS NPCI WDL SET,,2017-07-13,,20714774.0,-525441413.6600008,.
409000438620',2017-07-13,Indiaforensic AEPS NPCI DEP SET,,2017-07-13,12134978.0,,-537576391.6600008,.
409000438620',2017-07-13,TRF TO  Indiaforensic SERVICES I,,2017-07-13,8700000.0,,-546276391.6600008,.
409000438620',2017-07-14,Indiaforensic AEPS NPCI WDL SET,,2017-07-14,,24112028.0,-522164363.6600008,.
409000438620',2017-07-14,Indfor RIF AEPS NPCI WDL SET,,2017-07-14,,8000.0,-522156363.6600008,.
409000438620',2017-07-14,AEPS ACQUIRING ADJ FEES 1,,2017-07-14,11.92,,-522156375.5800008,.
409000438620',2017-07-14,AEPS ACQ CR ADJ FEES 1307,,2017-07-14,2365.28,,-522158740.8600008,.
409000438620',2017-07-14,CR718417056076/RMCPL02554/0,,2017-07-14,3000.0,,-522161740.8600008,.
409000438620',2017-07-14,CR718412931108/RMCPL14173/0,,2017-07-14,1400.0,,-522163140.8600008,.
409000438620',2017-07-14,CR718410879087/RMCPL11350/0,,2017-07-14,200.0,,-522163340.8600008,.
409000438620',2017-07-14,CR718410879539/RMCPL11785/0,,2017-07-14,100.0,,-522163440.8600008,.
409000438620',2017-07-14,CR718410879548/RMCPL09666/0,,2017-07-14,110.0,,-522163550.8600008,.
409000438620',2017-07-14,CR718410879546/RMCPL13062/0,,2017-07-14,3010.0,,-522166560.8600008,.
409000438620',2017-07-14,CR718412935269/RMCPL10735/0,,2017-07-14,2000.0,,-522168560.8600008,.
409000438620',2017-07-14,CR718413955779/RMCPL15296/0,,2017-07-14,2040.0,,-522170600.8600008,.
409000438620',2017-07-14,CR718416015283/RMCPL12440/0,,2017-07-14,6400.0,,-522177000.8600008,.
409000438620',2017-07-14,CR718410880950/RMCPL10901/0,,2017-07-14,6700.0,,-522183700.8600008,.
409000438620',2017-07-14,CR718410880949/RMCPL15126/0,,2017-07-14,100.0,,-522183800.8600008,.
409000438620',2017-07-14,CR718418068484/RMCPL14793/0,,2017-07-14,600.0,,-522184400.8600008,.
409000438620',2017-07-14,CR718416015315/RMCPL13033/0,,2017-07-14,500.0,,-522184900.8600008,.
409000438620',2017-07-14,CR718412936733/RMCPL11912/0,,2017-07-14,500.0,,-522185400.8600008,.
409000438620',2017-07-14,CR718412936741/RMCPL12851/0,,2017-07-14,1000.0,,-522186400.8600008,.
409000438620',2017-07-14,CR718413953879/RMCPL11389/0,,2017-07-14,530.0,,-522186930.8600008,.
409000438620',2017-07-14,CR718412936178/RMCPL00152/0,,2017-07-14,1010.0,,-522187940.8600008,.
409000438620',2017-07-14,CR718412936201/RMCPL10937/0,,2017-07-14,5000.0,,-522192940.8600008,.
409000438620',2017-07-14,CR718412936224/RMCPL12836/0,,2017-07-14,3132.0,,-522196072.8600008,.
409000438620',2017-07-14,CR718412929253/RMCPL11152/0,,2017-07-14,1000.0,,-522197072.8600008,.
409000438620',2017-07-14,CR718410878996/RMCPL14985/0,,2017-07-14,5000.0,,-522202072.8600008,.
409000438620',2017-07-14,CR718410879048/RMCPL05271/0,,2017-07-14,2020.0,,-522204092.8600008,.
409000438620',2017-07-14,CR718412937184/RMCPL15451/0,,2017-07-14,300.0,,-522204392.8600008,.
409000438620',2017-07-14,CR718415995340/RMCPL14536/0,,2017-07-14,200.0,,-522204592.8600008,.
409000438620',2017-07-14,CR718413947436/RMCPL13562/0,,2017-07-14,730.0,,-522205322.8600008,.
409000438620',2017-07-14,CR718410880530/RMCPL15107/0,,2017-07-14,2300.0,,-522207622.8600008,.
409000438620',2017-07-14,CR718410880570/RMCPL14185/0,,2017-07-14,1140.0,,-522208762.8600008,.
409000438620',2017-07-14,CR718410880578/RMCPL12036/0,,2017-07-14,4000.0,,-522212762.8600008,.
409000438620',2017-07-14,CR718417034004/RMCPL12748/0,,2017-07-14,510.0,,-522213272.8600008,.
409000438620',2017-07-14,CR718415994366/RMCPL11446/0,,2017-07-14,3000.0,,-522216272.8600008,.
409000438620',2017-07-14,CR718415994407/RMCPL01294/0,,2017-07-14,1110.0,,-522217382.8600008,.
409000438620',2017-07-14,CR718415994480/RMCPL11707/0,,2017-07-14,1000.0,,-522218382.8600008,.
409000438620',2017-07-14,CR718415995902/RMCPL15388/0,,2017-07-14,1000.0,,-522219382.8600008,.
409000438620',2017-07-14,CR718415995921/RMCPL14117/0,,2017-07-14,1000.0,,-522220382.8600008,.
409000438620',2017-07-14,CR718415995962/RMCPL09033/0,,2017-07-14,4060.0,,-522224442.8600008,.
409000438620',2017-07-14,CR718413945590/RMCPL13525/0,,2017-07-14,1000.0,,-522225442.8600008,.
409000438620',2017-07-14,CR718411899139/RMCPL15030/0,,2017-07-14,900.0,,-522226342.8600008,.
409000438620',2017-07-14,CR718412935303/RMCPL11912/0,,2017-07-14,500.0,,-522226842.8600008,.
409000438620',2017-07-14,CR718412935325/RMCPL14596/0,,2017-07-14,8000.0,,-522234842.8600008,.
409000438620',2017-07-14,CR718412936248/RMCPL15612/0,,2017-07-14,400.0,,-522235242.8600008,.
409000438620',2017-07-14,CR718412936147/RMCPL15030/0,,2017-07-14,10000.0,,-522245242.8600008,.
409000438620',2017-07-14,CR718417053415/RMCPL07667/0,,2017-07-14,2000.0,,-522247242.8600008,.
409000438620',2017-07-14,CR718411883415/RMCPL11811/0,,2017-07-14,10000.0,,-522257242.8600008,.
409000438620',2017-07-14,CR718411883426/RMCPL15190/0,,2017-07-14,1000.0,,-522258242.8600008,.
409000438620',2017-07-14,CR718412936231/RMCPL13369/0,,2017-07-14,2200.0,,-522260442.8600008,.
409000438620',2017-07-14,CR718412935687/RMCPL09008/0,,2017-07-14,1000.0,,-522261442.8600008,.
409000438620',2017-07-14,CR718412936691/RMCPL00020/0,,2017-07-14,10000.0,,-522271442.8600008,.
409000438620',2017-07-14,CR718412936726/RMCPL15373/0,,2017-07-14,1025.0,,-522272467.8600008,.
409000438620',2017-07-14,CR718417034838/RMCPL12720/0,,2017-07-14,400.0,,-522272867.8600008,.
409000438620',2017-07-14,CR718413955620/RMCPL14019/0,,2017-07-14,10000.0,,-522282867.8600008,.
409000438620',2017-07-14,CR718413955744/RMCPL12377/0,,2017-07-14,520.0,,-522283387.8600008,.
409000438620',2017-07-14,CR718413944935/RMCPL12291/0,,2017-07-14,10000.0,,-522293387.8600008,.
409000438620',2017-07-14,CR718413944950/RMCPL16198/0,,2017-07-14,1000.0,,-522294387.8600008,.
409000438620',2017-07-14,CR718413944970/RMCPL15045/0,,2017-07-14,210.0,,-522294597.8600008,.
409000438620',2017-07-14,CR718413948164/RMCPL13668/0,,2017-07-14,100.0,,-522294697.8600008,.
409000438620',2017-07-14,CR718413949081/RMCPL10709/0,,2017-07-14,5000.0,,-522299697.8600008,.
409000438620',2017-07-14,CR718413949109/RMCPL13549/0,,2017-07-14,3000.0,,-522302697.8600008,.
409000438620',2017-07-14,CR718413949002/RMCPL15388/0,,2017-07-14,300.0,,-522302997.8600008,.
409000438620',2017-07-14,CR718413951432/RMCPL11389/0,,2017-07-14,530.0,,-522303527.8600008,.
409000438620',2017-07-14,CR718410880545/RMCPL10735/0,,2017-07-14,2020.0,,-522305547.8600008,.
409000438620',2017-07-14,CR718514416403/RMCPL15777/0,,2017-07-14,800.0,,-522306347.8600008,.
409000438620',2017-07-14,CR718514417308/RMCPL13304/0,,2017-07-14,3000.0,,-522309347.8600008,.
409000438620',2017-07-14,CR718514417288/RMCPL13637/0,,2017-07-14,3000.0,,-522312347.8600008,.
409000438620',2017-07-14,CR718513388077/RMCPL00543/0,,2017-07-14,520.0,,-522312867.8600008,.
409000438620',2017-07-14,CR718513388046/RMCPL15388/0,,2017-07-14,1000.0,,-522313867.8600008,.
409000438620',2017-07-14,CR718513400190/RMCPL13575/0,,2017-07-14,5000.0,,-522318867.8600008,.
409000438620',2017-07-14,CR718515457984/RMCPL12946/0,,2017-07-14,400.0,,-522319267.8600008,.
409000438620',2017-07-14,CR718515458108/RMCPL15072/0,,2017-07-14,4000.0,,-522323267.8600008,.
409000438620',2017-07-14,CR718516475582/RMCPL14601/0,,2017-07-14,1050.0,,-522324317.8600008,.
409000438620',2017-07-14,CR718515460681/RMCPL12666/0,,2017-07-14,1020.0,,-522325337.8600008,.
409000438620',2017-07-14,CR718515460813/RMCPL15817/0,,2017-07-14,4700.0,,-522330037.8600008,.
409000438620',2017-07-14,CR718515460859/RMCPL15709/0,,2017-07-14,1000.0,,-522331037.8600008,.
409000438620',2017-07-14,CR718515460990/RMCPL11881/0,,2017-07-14,1010.0,,-522332047.8600008,.
409000438620',2017-07-14,CR718515461092/RMCPL11676/0,,2017-07-14,300.0,,-522332347.8600008,.
409000438620',2017-07-14,CR718515460985/RMCPL13846/0,,2017-07-14,500.0,,-522332847.8600008,.
409000438620',2017-07-14,CR718515460971/RMCPL15449/0,,2017-07-14,4950.0,,-522337797.8600008,.
409000438620',2017-07-14,CR718513386721/RMCPL10315/0,,2017-07-14,1000.0,,-522338797.8600008,.
409000438620',2017-07-14,CR718513386723/RMCPL12022/0,,2017-07-14,300.0,,-522339097.8600008,.
409000438620',2017-07-14,CR718513386759/RMCPL13973/0,,2017-07-14,100.0,,-522339197.8600008,.
409000438620',2017-07-14,CR718511324630/RMCPL13376/0,,2017-07-14,1600.0,,-522340797.8600008,.
409000438620',2017-07-14,CR718514417402/RMCPL11241/0,,2017-07-14,300.0,,-522341097.8600008,.
409000438620',2017-07-14,CR718512371083/RMCPL09562/0,,2017-07-14,8000.0,,-522349097.8600008,.
409000438620',2017-07-14,CR718510315101/RMCPL10086/0,,2017-07-14,1000.0,,-522350097.8600008,.
409000438620',2017-07-14,CR718510315134/RMCPL16081/0,,2017-07-14,730.0,,-522350827.8600008,.
409000438620',2017-07-14,CR718510315082/RMCPL13836/0,,2017-07-14,1000.0,,-522351827.8600008,.
409000438620',2017-07-14,CR718514417151/RMCPL15403/0,,2017-07-14,500.0,,-522352327.8600008,.
409000438620',2017-07-14,CR718514417249/RMCPL14090/0,,2017-07-14,2024.0,,-522354351.8600008,.
409000438620',2017-07-14,CR718514417315/RMCPL09562/0,,2017-07-14,2000.0,,-522356351.8600008,.
409000438620',2017-07-14,CR718512370679/RMCPL14195/0,,2017-07-14,1400.0,,-522357751.8600008,.
409000438620',2017-07-14,CR718511323973/RMCPL14457/0,,2017-07-14,10000.0,,-522367751.8600008,.
409000438620',2017-07-14,CR718514416474/RMCPL16198/0,,2017-07-14,100.0,,-522367851.8600008,.
409000438620',2017-07-14,CR718514416528/RMCPL10734/0,,2017-07-14,500.0,,-522368351.8600008,.
409000438620',2017-07-14,CR718514416569/RMCPL15300/0,,2017-07-14,7000.0,,-522375351.8600008,.
409000438620',2017-07-14,CR718514416563/RMCPL15030/0,,2017-07-14,100.0,,-522375451.8600008,.
409000438620',2017-07-14,CR718514416579/RMCPL13420/0,,2017-07-14,1500.0,,-522376951.8600008,.
409000438620',2017-07-14,CR718514418146/RMCPL13858/0,,2017-07-14,4010.0,,-522380961.8600008,.
409000438620',2017-07-14,CR718514417099/RMCPL12312/0,,2017-07-14,1010.0,,-522381971.8600008,.
409000438620',2017-07-14,CR718611868178/RMCPL15384/0,,2017-07-14,1000.0,,-522382971.8600008,.
409000438620',2017-07-14,CR718612871940/RMCPL07220/0,,2017-07-14,100.0,,-522383071.8600008,.
409000438620',2017-07-14,CR718612869587/RMCPL16161/0,,2017-07-14,110.0,,-522383181.8600008,.
409000438620',2017-07-14,CR718612870029/RMCPL14412/0,,2017-07-14,2000.0,,-522385181.8600008,.
409000438620',2017-07-14,CR718612870053/RMCPL13980/0,,2017-07-14,500.0,,-522385681.8600008,.
409000438620',2017-07-14,CR718611864704/RMCPL15447/0,,2017-07-14,1110.0,,-522386791.8600008,.
409000438620',2017-07-14,CR718611864985/RMCPL11611/0,,2017-07-14,515.0,,-522387306.8600008,.
409000438620',2017-07-14,CR718611868145/RMCPL11616/0,,2017-07-14,100.0,,-522387406.8600008,.
409000438620',2017-07-14,CR718611863576/RMCPL15450/0,,2017-07-14,1000.0,,-522388406.8600008,.
409000438620',2017-07-14,CR718611863963/RMCPL12450/0,,2017-07-14,3000.0,,-522391406.8600008,.
409000438620',2017-07-14,CR718611864089/RMCPL11247/0,,2017-07-14,2100.0,,-522393506.8600008,.
409000438620',2017-07-14,CR718611866462/RMCPL14712/0,,2017-07-14,2000.0,,-522395506.8600008,.
409000438620',2017-07-14,CR718611867044/RMCPL10453/0,,2017-07-14,200.0,,-522395706.8600008,.
409000438620',2017-07-14,CR718612871919/RMCPL11265/0,,2017-07-14,520.0,,-522396226.8600008,.
409000438620',2017-07-14,CR718612871937/RMCPL13098/0,,2017-07-14,10000.0,,-522406226.8600008,.
409000438620',2017-07-14,CR718610814753/RMCPL11018/0,,2017-07-14,1020.0,,-522407246.8600008,.
409000438620',2017-07-14,CR718613927489/RMCPL09112/0,,2017-07-14,3000.0,,-522410246.8600008,.
409000438620',2017-07-14,CR718613927532/RMCPL14156/0,,2017-07-14,5000.0,,-522415246.8600008,.
409000438620',2017-07-14,CR718612869338/RMCPL14572/0,,2017-07-14,2000.0,,-522417246.8600008,.
409000438620',2017-07-14,CR718612869364/RMCPL14835/0,,2017-07-14,500.0,,-522417746.8600008,.
409000438620',2017-07-14,CR718613927571/RMCPL15284/0,,2017-07-14,3150.0,,-522420896.8600008,.
409000438620',2017-07-14,CR718613927567/RMCPL14208/0,,2017-07-14,3000.0,,-522423896.8600008,.
409000438620',2017-07-14,CR718611866182/RMCPL14876/0,,2017-07-14,5100.0,,-522428996.8600008,.
409000438620',2017-07-14,CR718611866363/RMCPL13506/0,,2017-07-14,2000.0,,-522430996.8600008,.
409000438620',2017-07-14,CR718611863997/RMCPL15014/0,,2017-07-14,10000.0,,-522440996.8600008,.
409000438620',2017-07-14,CR718611864144/RMCPL14972/0,,2017-07-14,405.0,,-522441401.8600008,.
409000438620',2017-07-14,CR718613927744/RMCPL10946/0,,2017-07-14,10000.0,,-522451401.8600008,.
409000438620',2017-07-14,CR718612876326/RMCPL10373/0,,2017-07-14,600.0,,-522452001.8600008,.
409000438620',2017-07-14,CR718612876361/RMCPL14248/0,,2017-07-14,3000.0,,-522455001.8600008,.
409000438620',2017-07-14,CR718613923401/RMCPL09038/0,,2017-07-14,400.0,,-522455401.8600008,.
409000438620',2017-07-14,CR718613923422/RMCPL15577/0,,2017-07-14,300.0,,-522455701.8600008,.
409000438620',2017-07-14,CR718613923465/RMCPL02417/0,,2017-07-14,501.0,,-522456202.8600008,.
409000438620',2017-07-14,CR718613923541/RMCPL14813/0,,2017-07-14,885.0,,-522457087.8600008,.
409000438620',2017-07-14,CR718613923579/RMCPL15414/0,,2017-07-14,5000.0,,-522462087.8600008,.
409000438620',2017-07-14,CR718712370886/RMCPL14572/0,,2017-07-14,600.0,,-522462687.8600008,.
409000438620',2017-07-14,CR718712370885/RMCPL13972/0,,2017-07-14,200.0,,-522462887.8600008,.
409000438620',2017-07-14,CR718712370663/RMCPL11281/0,,2017-07-14,5000.0,,-522467887.8600008,.
409000438620',2017-07-14,CR718712370997/RMCPL14534/0,,2017-07-14,3000.0,,-522470887.8600008,.
409000438620',2017-07-14,CR718716495022/RMCPL12312/0,,2017-07-14,1010.0,,-522471897.8600008,.
409000438620',2017-07-14,CR718716496739/RMCPL11992/0,,2017-07-14,100.0,,-522471997.8600008,.
409000438620',2017-07-14,CR718708255911/RMCPL00162/0,,2017-07-14,2124.0,,-522474121.8600008,.
409000438620',2017-07-14,CR718716496653/RMCPL11519/0,,2017-07-14,5000.0,,-522479121.8600008,.
409000438620',2017-07-14,CR718716496692/RMCPL13323/0,,2017-07-14,500.0,,-522479621.8600008,.
409000438620',2017-07-14,CR718716496947/RMCPL11073/0,,2017-07-14,1000.0,,-522480621.8600008,.
409000438620',2017-07-14,CR718716497100/RMCPL09561/0,,2017-07-14,1800.0,,-522482421.8600008,.
409000438620',2017-07-14,CR718712370778/RMCPL15667/0,,2017-07-14,900.0,,-522483321.8600008,.
409000438620',2017-07-14,CR718712371013/RMCPL16294/0,,2017-07-14,2600.0,,-522485921.8600008,.
409000438620',2017-07-14,CR718716497873/RMCPL11251/0,,2017-07-14,10000.0,,-522495921.8600008,.
409000438620',2017-07-14,CR718716497918/RMCPL15350/0,,2017-07-14,10000.0,,-522505921.8600008,.
409000438620',2017-07-14,CR718712370195/RMCPL13561/0,,2017-07-14,730.0,,-522506651.8600008,.
409000438620',2017-07-14,CR718712370168/RMCPL15905/0,,2017-07-14,200.0,,-522506851.8600008,.
409000438620',2017-07-14,CR718712369956/RMCPL14731/0,,2017-07-14,1002.0,,-522507853.8600008,.
409000438620',2017-07-14,CR718712369978/RMCPL15190/0,,2017-07-14,3000.0,,-522510853.8600008,.
409000438620',2017-07-14,CR718712370858/RMCPL16314/0,,2017-07-14,110.0,,-522510963.8600008,.
409000438620',2017-07-14,CR718716496147/RMCPL10778/0,,2017-07-14,10000.0,,-522520963.8600008,.
409000438620',2017-07-14,CR718712369853/RMCPL13906/0,,2017-07-14,1200.0,,-522522163.8600008,.
409000438620',2017-07-14,CR718712369868/RMCPL12832/0,,2017-07-14,3000.0,,-522525163.8600008,.
409000438620',2017-07-14,CR718712369941/RMCPL14596/0,,2017-07-14,10000.0,,-522535163.8600008,.
409000438620',2017-07-14,CR718712370059/RMCPL15193/0,,2017-07-14,2000.0,,-522537163.8600008,.
409000438620',2017-07-14,CR718712370118/RMCPL16053/0,,2017-07-14,3500.0,,-522540663.8600008,.
409000438620',2017-07-14,CR718712369846/RMCPL02286/0,,2017-07-14,1080.0,,-522541743.8600008,.
409000438620',2017-07-14,CR718811851848/RMCPL13364/0,,2017-07-14,1020.0,,-522542763.8600008,.
409000438620',2017-07-14,CR718811851865/RMCPL00956/0,,2017-07-14,1620.0,,-522544383.8600008,.
409000438620',2017-07-14,CR718811851889/RMCPL14638/0,,2017-07-14,1000.0,,-522545383.8600008,.
409000438620',2017-07-14,CR718812864574/RMCPL12549/0,,2017-07-14,750.0,,-522546133.8600008,.
409000438620',2017-07-14,CR718812873297/RMCPL13598/0,,2017-07-14,3000.0,,-522549133.8600008,.
409000438620',2017-07-14,CR718812873376/RMCPL14914/0,,2017-07-14,1000.0,,-522550133.8600008,.
409000438620',2017-07-14,CR718812859244/RMCPL16081/0,,2017-07-14,730.0,,-522550863.8600008,.
409000438620',2017-07-14,CR718812864618/RMCPL13790/0,,2017-07-14,2500.0,,-522553363.8600008,.
409000438620',2017-07-14,CR718812864628/RMCPL11104/0,,2017-07-14,100.0,,-522553463.8600008,.
409000438620',2017-07-14,CR718817996060/RMCPL11393/0,,2017-07-14,6000.0,,-522559463.8600008,.
409000438620',2017-07-14,CR718812874428/RMCPL13562/0,,2017-07-14,730.0,,-522560193.8600008,.
409000438620',2017-07-14,CR718811842551/RMCPL12330/0,,2017-07-14,5000.0,,-522565193.8600008,.
409000438620',2017-07-14,CR718812864662/RMCPL14242/0,,2017-07-14,100.0,,-522565293.8600008,.
409000438620',2017-07-14,CR718809770845/RMCPL13301/0,,2017-07-14,2000.0,,-522567293.8600008,.
409000438620',2017-07-14,CR718811847868/RMCPL11950/0,,2017-07-14,420.0,,-522567713.8600008,.
409000438620',2017-07-14,CR718812865648/RMCPL12277/0,,2017-07-14,200.0,,-522567913.8600008,.
409000438620',2017-07-14,CR718812865826/RMCPL09150/0,,2017-07-14,100.0,,-522568013.8600008,.
409000438620',2017-07-14,CR718811848068/RMCPL16282/0,,2017-07-14,1000.0,,-522569013.8600008,.
409000438620',2017-07-14,CR718811842478/RMCPL00271/0,,2017-07-14,710.0,,-522569723.8600008,.
409000438620',2017-07-14,CR718811842525/RMCPL12896/0,,2017-07-14,4000.0,,-522573723.8600008,.
409000438620',2017-07-14,CR718811842549/RMCPL14780/0,,2017-07-14,5000.0,,-522578723.8600008,.
409000438620',2017-07-14,CR718811842559/RMCPL11361/0,,2017-07-14,5000.0,,-522583723.8600008,.
409000438620',2017-07-14,CR718811843323/RMCPL13875/0,,2017-07-14,5500.0,,-522589223.8600008,.
409000438620',2017-07-14,CR718811843366/RMCPL15729/0,,2017-07-14,5000.0,,-522594223.8600008,.
409000438620',2017-07-14,CR718811843428/RMCPL16018/0,,2017-07-14,2400.0,,-522596623.8600008,.
409000438620',2017-07-14,CR718811843466/RMCPL14958/0,,2017-07-14,1000.0,,-522597623.8600008,.
409000438620',2017-07-14,CR718810819576/RMCPL14179/0,,2017-07-14,2100.0,,-522599723.8600008,.
409000438620',2017-07-14,CR718812863358/RMCPL14060/0,,2017-07-14,2000.0,,-522601723.8600008,.
409000438620',2017-07-14,CR718812863346/RMCPL14242/0,,2017-07-14,310.0,,-522602033.8600008,.
409000438620',2017-07-14,CR718816973841/RMCPL14232/0,,2017-07-14,10000.0,,-522612033.8600008,.
409000438620',2017-07-14,CR718813886772/RMCPL16337/0,,2017-07-14,100.0,,-522612133.8600008,.
409000438620',2017-07-14,CR718813886861/RMCPL11609/0,,2017-07-14,1032.0,,-522613165.8600008,.
409000438620',2017-07-14,CR718813887089/RMCPL14700/0,,2017-07-14,3000.0,,-522616165.8600008,.
409000438620',2017-07-14,CR718812872460/RMCPL13598/0,,2017-07-14,3000.0,,-522619165.8600008,.
409000438620',2017-07-14,CR718811824092/RMCPL14704/0,,2017-07-14,500.0,,-522619665.8600008,.
409000438620',2017-07-14,CR718812872515/RMCPL01251/0,,2017-07-14,3030.0,,-522622695.8600008,.
409000438620',2017-07-14,CR718812853663/RMCPL12065/0,,2017-07-14,1590.0,,-522624285.8600008,.
409000438620',2017-07-14,CR718812853669/RMCPL15888/0,,2017-07-14,1000.0,,-522625285.8600008,.
409000438620',2017-07-14,CR718812864773/RMCPL14594/0,,2017-07-14,100.0,,-522625385.8600008,.
409000438620',2017-07-14,CR718812870281/RMCPL15817/0,,2017-07-14,8000.0,,-522633385.8600008,.
409000438620',2017-07-14,CR718812870277/RMCPL15126/0,,2017-07-14,100.0,,-522633485.8600008,.
409000438620',2017-07-14,CR718812859178/RMCPL11611/0,,2017-07-14,110.0,,-522633595.8600008,.
409000438620',2017-07-14,CR718812859189/RMCPL15213/0,,2017-07-14,1500.0,,-522635095.8600008,.
409000438620',2017-07-14,CR718812853720/RMCPL12170/0,,2017-07-14,2560.0,,-522637655.8600008,.
409000438620',2017-07-14,CR718812856187/RMCPL11968/0,,2017-07-14,500.0,,-522638155.8600008,.
409000438620',2017-07-14,CR718812856199/RMCPL09035/0,,2017-07-14,1000.0,,-522639155.8600008,.
409000438620',2017-07-14,CR718812864719/RMCPL12624/0,,2017-07-14,100.0,,-522639255.8600008,.
409000438620',2017-07-14,CR718816962344/RMCPL10778/0,,2017-07-14,10000.0,,-522649255.8600008,.
409000438620',2017-07-14,CR718816962955/RMCPL00388/0,,2017-07-14,220.0,,-522649475.8600008,.
409000438620',2017-07-14,CR718816962520/RMCPL09609/0,,2017-07-14,10000.0,,-522659475.8600008,.
409000438620',2017-07-14,CR718816962984/RMCPL13973/0,,2017-07-14,100.0,,-522659575.8600008,.
409000438620',2017-07-14,CR718817997032/RMCPL15778/0,,2017-07-14,1000.0,,-522660575.8600008,.
409000438620',2017-07-14,CR718811849179/RMCPL13565/0,,2017-07-14,730.0,,-522661305.8600008,.
409000438620',2017-07-14,CR718812856241/RMCPL14251/0,,2017-07-14,600.0,,-522661905.8600008,.
409000438620',2017-07-14,CR718812863445/RMCPL12684/0,,2017-07-14,1200.0,,-522663105.8600008,.
409000438620',2017-07-14,CR718812868079/RMCPL10236/0,,2017-07-14,2000.0,,-522665105.8600008,.
409000438620',2017-07-14,CR718810819674/RMCPL14183/0,,2017-07-14,100.0,,-522665205.8600008,.
409000438620',2017-07-14,CR718810819766/RMCPL15267/0,,2017-07-14,3000.0,,-522668205.8600008,.
409000438620',2017-07-14,CR718810819747/RMCPL15431/0,,2017-07-14,500.0,,-522668705.8600008,.
409000438620',2017-07-14,CR718810819801/RMCPL06797/0,,2017-07-14,300.0,,-522669005.8600008,.
409000438620',2017-07-14,CR718810819750/RMCPL14458/0,,2017-07-14,3500.0,,-522672505.8600008,.
409000438620',2017-07-14,CR718810819932/RMCPL02113/0,,2017-07-14,10000.0,,-522682505.8600008,.
409000438620',2017-07-14,CR718811851000/RMCPL13807/0,,2017-07-14,500.0,,-522683005.8600008,.
409000438620',2017-07-14,CR718811850873/RMCPL11263/0,,2017-07-14,1520.0,,-522684525.8600008,.
409000438620',2017-07-14,CR718811850860/RMCPL15031/0,,2017-07-14,450.0,,-522684975.8600008,.
409000438620',2017-07-14,CR718811851255/RMCPL11611/0,,2017-07-14,110.0,,-522685085.8600008,.
409000438620',2017-07-14,CR718811851327/RMCPL12208/0,,2017-07-14,500.0,,-522685585.8600008,.
409000438620',2017-07-14,CR718812873527/RMCPL12897/0,,2017-07-14,600.0,,-522686185.8600008,.
409000438620',2017-07-14,CR718811824695/RMCPL13807/0,,2017-07-14,500.0,,-522686685.8600008,.
409000438620',2017-07-14,CR718816964250/RMCPL14806/0,,2017-07-14,1062.0,,-522687747.8600008,.
409000438620',2017-07-14,CR718811843250/RMCPL12628/0,,2017-07-14,200.0,,-522687947.8600008,.
409000438620',2017-07-14,CR718817996874/RMCPL13123/0,,2017-07-14,5000.0,,-522692947.8600008,.
409000438620',2017-07-14,CR718811847814/RMCPL11212/0,,2017-07-14,1200.0,,-522694147.8600008,.
409000438620',2017-07-14,CR718809770361/RMCPL14958/0,,2017-07-14,5050.0,,-522699197.8600008,.
409000438620',2017-07-14,CR718809770448/RMCPL13729/0,,2017-07-14,3670.0,,-522702867.8600008,.
409000438620',2017-07-14,CR718809770541/RMCPL13441/0,,2017-07-14,1040.0,,-522703907.8600008,.
409000438620',2017-07-14,CR718811847894/RMCPL15739/0,,2017-07-14,5000.0,,-522708907.8600008,.
409000438620',2017-07-14,CR718809770699/RMCPL16094/0,,2017-07-14,1000.0,,-522709907.8600008,.
409000438620',2017-07-14,CR718809770703/RMCPL15648/0,,2017-07-14,5000.0,,-522714907.8600008,.
409000438620',2017-07-14,CR718812865596/RMCPL14000/0,,2017-07-14,300.0,,-522715207.8600008,.
409000438620',2017-07-14,CR718812868613/RMCPL06976/0,,2017-07-14,100.0,,-522715307.8600008,.
409000438620',2017-07-14,CR718811824066/RMCPL15708/0,,2017-07-14,500.0,,-522715807.8600008,.
409000438620',2017-07-14,CR718812879955/RMCPL11811/0,,2017-07-14,5050.0,,-522720857.8600008,.
409000438620',2017-07-14,CR718816964335/RMCPL14811/0,,2017-07-14,1020.0,,-522721877.8600008,.
409000438620',2017-07-14,CR718816964503/RMCPL11278/0,,2017-07-14,3000.0,,-522724877.8600008,.
409000438620',2017-07-14,CR718812872692/RMCPL03287/0,,2017-07-14,2020.0,,-522726897.8600008,.
409000438620',2017-07-14,CR718812872674/RMCPL15105/0,,2017-07-14,1500.0,,-522728397.8600008,.
409000438620',2017-07-14,CR718811851010/RMCPL13364/0,,2017-07-14,1020.0,,-522729417.8600008,.
409000438620',2017-07-14,CR718811849643/RMCPL15613/0,,2017-07-14,200.0,,-522729617.8600008,.
409000438620',2017-07-14,CR718811849673/RMCPL15190/0,,2017-07-14,1000.0,,-522730617.8600008,.
409000438620',2017-07-14,CR718811849762/RMCPL14780/0,,2017-07-14,5000.0,,-522735617.8600008,.
409000438620',2017-07-14,CR718811849772/RMCPL15027/0,,2017-07-14,10000.0,,-522745617.8600008,.
409000438620',2017-07-14,CR718811849801/RMCPL12342/0,,2017-07-14,10000.0,,-522755617.8600008,.
409000438620',2017-07-14,CR718909282837/RMCPL15388/0,,2017-07-14,1000.0,,-522756617.8600008,.
409000438620',2017-07-14,CR719110107984/RMCPL16034/1,,2017-07-14,510.0,,-522757127.8600008,.
409000438620',2017-07-14,CR719110108042/RMCPL13796/1,,2017-07-14,3000.0,,-522760127.8600008,.
409000438620',2017-07-14,CR719110108568/RMCPL14412/1,,2017-07-14,5170.0,,-522765297.8600008,.
409000438620',2017-07-14,CR719110105875/RMCPL10068/1,,2017-07-14,800.0,,-522766097.8600008,.
409000438620',2017-07-14,CR719110105917/RMCPL11371/1,,2017-07-14,2000.0,,-522768097.8600008,.
409000438620',2017-07-14,CR719110107914/RMCPL15765/1,,2017-07-14,520.0,,-522768617.8600008,.
409000438620',2017-07-14,CR719110107971/RMCPL12311/1,,2017-07-14,500.0,,-522769117.8600008,.
409000438620',2017-07-14,CR719110106405/RMCPL04395/1,,2017-07-14,100.0,,-522769217.8600008,.
409000438620',2017-07-14,CR719110106430/RMCPL14040/1,,2017-07-14,5000.0,,-522774217.8600008,.
409000438620',2017-07-14,CR719110106454/RMCPL11139/1,,2017-07-14,100.0,,-522774317.8600008,.
409000438620',2017-07-14,CR719111139006/RMCPL15140/1,,2017-07-14,10000.0,,-522784317.8600008,.
409000438620',2017-07-14,AEPS ACQUIRING ADJ FEES 1,,2017-07-14,,11.36,-522784306.5000008,.
409000438620',2017-07-14,AEPS Indiaforensic INCOME 130717,,2017-07-14,,95644.13,-522688662.3700008,.
409000438620',2017-07-14,AEPS Indiaforensic S TAX 130717,,2017-07-14,,17215.94,-522671446.4300008,.
409000438620',2017-07-14,Indiaforensic AEPS NPCI DEP SET,,2017-07-14,14376307.0,,-537047753.4300008,.
409000438620',2017-07-14,TRF TO  Indiaforensic SERVICES I,,2017-07-14,9200000.0,,-546247753.4300008,.
409000438620',2017-07-15,AEPS ACQUIRING ADJ FEES 1,,2017-07-15,,2.95,-546247750.4800007,.
409000438620',2017-07-15,CB719211639802/RMCPL10937/1,,2017-07-15,520.0,,-546248270.4800007,.
409000438620',2017-07-15,CB719211630206/RMCPL10937/1,,2017-07-15,1500.0,,-546249770.4800007,.
409000438620',2017-07-15,AEPS Indiaforensic INCOME 140717,,2017-07-15,,96267.37,-546153503.1100007,.
409000438620',2017-07-15,AEPS Indiaforensic S TAX 140717,,2017-07-15,,17328.13,-546136174.9800007,.
409000438620',2017-07-15,Indiaforensic AEPS NPCI WDL SET,,2017-07-15,,24719388.0,-521416786.98000073,.
409000438620',2017-07-15,Indiaforensic AEPS NPCI DEP SET,,2017-07-15,14333549.0,,-535750335.98000073,.
409000438620',2017-07-17,TRF TO  Indiaforensic SERVICES I,,2017-07-17,10500000.0,,-546250335.9800007,.
409000438620',2017-07-17,AEPS ACQUIRING ADJ FEES 1,,2017-07-17,15.0,,-546250350.9800007,.
409000438620',2017-07-17,AEPS Indiaforensic INCOME 150717,,2017-07-17,,92056.21,-546158294.7700007,.
409000438620',2017-07-17,AEPS Indiaforensic S TAX 150717,,2017-07-17,,16570.12,-546141724.6500007,.
409000438620',2017-07-17,AEPS Indiaforensic INCOME 160717,,2017-07-17,,77571.52,-546064153.1300007,.
409000438620',2017-07-17,AEPS Indiaforensic S TAX 160717,,2017-07-17,,13962.87,-546050190.2600007,.
409000438620',2017-07-17,Indiaforensic AEPS NPCI WDL SET,,2017-07-17,,22680563.0,-523369627.2600007,.
409000438620',2017-07-17,Indiaforensic AEPS NPCI WDL SET,,2017-07-17,,18811238.0,-504558389.2600007,.
409000438620',2017-07-17,Indiaforensic AEPS NPCI DEP SET,,2017-07-17,14317921.0,,-518876310.2600007,.
409000438620',2017-07-17,Indiaforensic AEPS NPCI DEP SET,,2017-07-17,11515525.0,,-530391835.2600007,.
409000438620',2017-07-17,TRF TO  Indiaforensic SERVICES I,,2017-07-17,15000000.0,,-545391835.2600007,.
409000438620',2017-07-18,AEPS ACQUIRING ADJ FEES 1,,2017-07-18,1136.35,,-545392971.6100007,.
409000438620',2017-07-18,CR717810961370/RMCPL14958/1,,2017-07-18,2000.0,,-545394971.6100007,.
409000438620',2017-07-18,CR717810962020/RMCPL14181/1,,2017-07-18,2040.0,,-545397011.6100007,.
409000438620',2017-07-18,CR717810976898/RMCPL04093/1,,2017-07-18,500.0,,-545397511.6100007,.
409000438620',2017-07-18,CR717810978049/RMCPL14957/1,,2017-07-18,310.0,,-545397821.6100007,.
409000438620',2017-07-18,CR717906367312/RMCPL14108/1,,2017-07-18,3000.0,,-545400821.6100007,.
409000438620',2017-07-18,CR717910456127/RMCPL14923/1,,2017-07-18,600.0,,-545401421.6100007,.
409000438620',2017-07-18,CR717910457185/RMCPL12201/1,,2017-07-18,1000.0,,-545402421.6100007,.
409000438620',2017-07-18,CR717911469167/RMCPL13875/1,,2017-07-18,1900.0,,-545404321.6100007,.
409000438620',2017-07-18,CR717911469839/RMCPL00695/1,,2017-07-18,210.0,,-545404531.6100007,.
409000438620',2017-07-18,CR717911470435/RMCPL10314/1,,2017-07-18,5000.0,,-545409531.6100007,.
409000438620',2017-07-18,CR717911470481/RMCPL15379/1,,2017-07-18,10000.0,,-545419531.6100007,.
409000438620',2017-07-18,CR717911470442/RMCPL14426/1,,2017-07-18,2000.0,,-545421531.6100007,.
409000438620',2017-07-18,CR717911471000/RMCPL11850/1,,2017-07-18,1000.0,,-545422531.6100007,.
409000438620',2017-07-18,CR717911471040/RMCPL09651/1,,2017-07-18,7070.0,,-545429601.6100007,.
409000438620',2017-07-18,CR717911471083/RMCPL12590/1,,2017-07-18,2010.0,,-545431611.6100007,.
409000438620',2017-07-18,CR717911470970/RMCPL09119/1,,2017-07-18,2000.0,,-545433611.6100007,.
409000438620',2017-07-18,CR717912504423/RMCPL13925/1,,2017-07-18,500.0,,-545434111.6100007,.
409000438620',2017-07-18,CR717912504610/RMCPL11611/1,,2017-07-18,310.0,,-545434421.6100007,.
409000438620',2017-07-18,CR717912504560/RMCPL11153/1,,2017-07-18,10000.0,,-545444421.6100007,.
409000438620',2017-07-18,CR717912504554/RMCPL13846/1,,2017-07-18,120.0,,-545444541.6100007,.
409000438620',2017-07-18,CR717912504585/RMCPL13553/1,,2017-07-18,1000.0,,-545445541.6100007,.
409000438620',2017-07-18,CR717912505261/RMCPL15027/1,,2017-07-18,1200.0,,-545446741.6100007,.
409000438620',2017-07-18,CR717912505648/RMCPL09617/1,,2017-07-18,3500.0,,-545450241.6100007,.
409000438620',2017-07-18,CR717912505667/RMCPL05257/1,,2017-07-18,7000.0,,-545457241.6100007,.
409000438620',2017-07-18,CR717912505708/RMCPL13875/1,,2017-07-18,7500.0,,-545464741.6100007,.
409000438620',2017-07-18,CR717912505776/RMCPL13352/1,,2017-07-18,500.0,,-545465241.6100007,.
409000438620',2017-07-18,CR717912505984/RMCPL14426/1,,2017-07-18,2000.0,,-545467241.6100007,.
409000438620',2017-07-18,CR717912506563/RMCPL15414/1,,2017-07-18,2500.0,,-545469741.6100007,.
409000438620',2017-07-18,CR717912506617/RMCPL13679/1,,2017-07-18,1200.0,,-545470941.6100007,.
409000438620',2017-07-18,CR718011968261/RMCPL09617/1,,2017-07-18,10000.0,,-545480941.6100007,.
409000438620',2017-07-18,CR718011968334/RMCPL13833/1,,2017-07-18,2000.0,,-545482941.6100007,.
409000438620',2017-07-18,CR718011968953/RMCPL12579/1,,2017-07-18,800.0,,-545483741.6100007,.
409000438620',2017-07-18,CR718011969073/RMCPL15121/1,,2017-07-18,230.0,,-545483971.6100007,.
409000438620',2017-07-18,CR718011969225/RMCPL15447/1,,2017-07-18,505.0,,-545484476.6100007,.
409000438620',2017-07-18,CR718011969213/RMCPL15215/1,,2017-07-18,2020.0,,-545486496.6100007,.
409000438620',2017-07-18,CR718011969409/RMCPL11264/1,,2017-07-18,2000.0,,-545488496.6100007,.
409000438620',2017-07-18,CR718012986790/RMCPL11246/1,,2017-07-18,1008.0,,-545489504.6100007,.
409000438620',2017-07-18,CR718012986878/RMCPL13639/1,,2017-07-18,500.0,,-545490004.6100007,.
409000438620',2017-07-18,CR718012986975/RMCPL09117/1,,2017-07-18,630.0,,-545490634.6100007,.
409000438620',2017-07-18,CR718012992905/RMCPL03038/1,,2017-07-18,2012.0,,-545492646.6100007,.
409000438620',2017-07-18,CR718012992907/RMCPL00175/1,,2017-07-18,500.0,,-545493146.6100007,.
409000438620',2017-07-18,CR718012992968/RMCPL13143/1,,2017-07-18,2000.0,,-545495146.6100007,.
409000438620',2017-07-18,CR718012994091/RMCPL10901/1,,2017-07-18,1100.0,,-545496246.6100007,.
409000438620',2017-07-18,CR718012994098/RMCPL09516/1,,2017-07-18,3525.0,,-545499771.6100007,.
409000438620',2017-07-18,CR718012994620/RMCPL11246/1,,2017-07-18,1000.0,,-545500771.6100007,.
409000438620',2017-07-18,CR718012994875/RMCPL11457/1,,2017-07-18,2000.0,,-545502771.6100007,.
409000438620',2017-07-18,CR718012995336/RMCPL11634/1,,2017-07-18,100.0,,-545502871.6100007,.
409000438620',2017-07-18,CR718012996115/RMCPL09927/1,,2017-07-18,310.0,,-545503181.6100007,.
409000438620',2017-07-18,CR718012996108/RMCPL15267/1,,2017-07-18,3000.0,,-545506181.6100007,.
409000438620',2017-07-18,CR718012996066/RMCPL11265/1,,2017-07-18,5030.0,,-545511211.6100007,.
409000438620',2017-07-18,CR718012995897/RMCPL09119/1,,2017-07-18,600.0,,-545511811.6100007,.
409000438620',2017-07-18,CR718012995910/RMCPL02981/1,,2017-07-18,1000.0,,-545512811.6100007,.
409000438620',2017-07-18,CR718012996254/RMCPL12987/1,,2017-07-18,100.0,,-545512911.6100007,.
409000438620',2017-07-18,CR718012003188/RMCPL12043/1,,2017-07-18,10000.0,,-545522911.6100007,.
409000438620',2017-07-18,CR718012003634/RMCPL10800/1,,2017-07-18,4020.0,,-545526931.6100007,.
409000438620',2017-07-18,CR718012003665/RMCPL15582/1,,2017-07-18,100.0,,-545527031.6100007,.
409000438620',2017-07-18,CR718012003676/RMCPL00152/1,,2017-07-18,1510.0,,-545528541.6100007,.
409000438620',2017-07-18,CR718012003724/RMCPL09435/1,,2017-07-18,210.0,,-545528751.6100007,.
409000438620',2017-07-18,CR718012003716/RMCPL11457/1,,2017-07-18,1500.0,,-545530251.6100007,.
409000438620',2017-07-18,CR718012004652/RMCPL09512/1,,2017-07-18,100.0,,-545530351.6100007,.
409000438620',2017-07-18,CR718012005185/RMCPL14914/1,,2017-07-18,1000.0,,-545531351.6100007,.
409000438620',2017-07-18,CR718012005262/RMCPL12201/1,,2017-07-18,3000.0,,-545534351.6100007,.
409000438620',2017-07-18,CR718012005300/RMCPL09386/1,,2017-07-18,500.0,,-545534851.6100007,.
409000438620',2017-07-18,CR718012005376/RMCPL04988/1,,2017-07-18,1000.0,,-545535851.6100007,.
409000438620',2017-07-18,CR718012005468/RMCPL11457/1,,2017-07-18,1500.0,,-545537351.6100007,.
409000438620',2017-07-18,CR718012006365/RMCPL10790/1,,2017-07-18,500.0,,-545537851.6100007,.
409000438620',2017-07-18,CR718012007675/RMCPL09927/1,,2017-07-18,310.0,,-545538161.6100007,.
409000438620',2017-07-18,CR718015089966/RMCPL14954/1,,2017-07-18,500.0,,-545538661.6100007,.
409000438620',2017-07-18,CR718015090013/RMCPL11676/1,,2017-07-18,2500.0,,-545541161.6100007,.
409000438620',2017-07-18,CR718108384100/RMCPL09839/1,,2017-07-18,600.0,,-545541761.6100007,.
409000438620',2017-07-18,CR718108384260/RMCPL14592/1,,2017-07-18,1000.0,,-545542761.6100007,.
409000438620',2017-07-18,CR718108384279/RMCPL13298/1,,2017-07-18,500.0,,-545543261.6100007,.
409000438620',2017-07-18,CR718108384132/RMCPL14249/1,,2017-07-18,10000.0,,-545553261.6100007,.
409000438620',2017-07-18,CR718108384298/RMCPL14005/1,,2017-07-18,10000.0,,-545563261.6100007,.
409000438620',2017-07-18,CR718108384149/RMCPL15803/1,,2017-07-18,590.0,,-545563851.6100007,.
409000438620',2017-07-18,CR718108384345/RMCPL09892/1,,2017-07-18,2124.0,,-545565975.6100007,.
409000438620',2017-07-18,CR718108384347/RMCPL11144/1,,2017-07-18,200.0,,-545566175.6100007,.
409000438620',2017-07-18,CR718112502827/RMCPL00226/1,,2017-07-18,2000.0,,-545568175.6100007,.
409000438620',2017-07-18,CR718112502833/RMCPL11265/1,,2017-07-18,1020.0,,-545569195.6100007,.
409000438620',2017-07-18,CR718112502608/RMCPL09827/1,,2017-07-18,1000.0,,-545570195.6100007,.
409000438620',2017-07-18,CR718112502756/RMCPL13558/1,,2017-07-18,730.0,,-545570925.6100007,.
409000438620',2017-07-18,CR718112503956/RMCPL00355/1,,2017-07-18,5000.0,,-545575925.6100007,.
409000438620',2017-07-18,CR718112504079/RMCPL12187/1,,2017-07-18,10000.0,,-545585925.6100007,.
409000438620',2017-07-18,CR718112504123/RMCPL15491/1,,2017-07-18,7000.0,,-545592925.6100007,.
409000438620',2017-07-18,CR718112504311/RMCPL09050/1,,2017-07-18,5000.0,,-545597925.6100007,.
409000438620',2017-07-18,CR718112504158/RMCPL00119/1,,2017-07-18,5050.0,,-545602975.6100007,.
409000438620',2017-07-18,CR718112504264/RMCPL14670/1,,2017-07-18,3000.0,,-545605975.6100007,.
409000438620',2017-07-18,CR718112504434/RMCPL14982/1,,2017-07-18,200.0,,-545606175.6100007,.
409000438620',2017-07-18,CR718112504192/RMCPL13398/1,,2017-07-18,1200.0,,-545607375.6100007,.
409000438620',2017-07-18,CR718112505050/RMCPL14992/1,,2017-07-18,105.0,,-545607480.6100007,.
409000438620',2017-07-18,CR718112505079/RMCPL12252/1,,2017-07-18,510.0,,-545607990.6100007,.
409000438620',2017-07-18,CR718112505671/RMCPL03515/1,,2017-07-18,2000.0,,-545609990.6100007,.
409000438620',2017-07-18,CR718112505703/RMCPL13602/1,,2017-07-18,300.0,,-545610290.6100007,.
409000438620',2017-07-18,CR718112505693/RMCPL13079/1,,2017-07-18,2000.0,,-545612290.6100007,.
409000438620',2017-07-18,CR718112505773/RMCPL11227/1,,2017-07-18,4200.0,,-545616490.6100007,.
409000438620',2017-07-18,CR718112505775/RMCPL09630/1,,2017-07-18,1500.0,,-545617990.6100007,.
409000438620',2017-07-18,CR718112505818/RMCPL15197/1,,2017-07-18,1000.0,,-545618990.6100007,.
409000438620',2017-07-18,CR718112505830/RMCPL12325/1,,2017-07-18,1000.0,,-545619990.6100007,.
409000438620',2017-07-18,CR718115612423/RMCPL12960/1,,2017-07-18,2600.0,,-545622590.6100007,.
409000438620',2017-07-18,CR718115612414/RMCPL12814/1,,2017-07-18,1000.0,,-545623590.6100007,.
409000438620',2017-07-18,CR718116618173/RMCPL14108/1,,2017-07-18,1800.0,,-545625390.6100007,.
409000438620',2017-07-18,CR718116618238/RMCPL10778/1,,2017-07-18,2000.0,,-545627390.6100007,.
409000438620',2017-07-18,CR718116626796/RMCPL14667/1,,2017-07-18,3000.0,,-545630390.6100007,.
409000438620',2017-07-18,CR718116627182/RMCPL11909/1,,2017-07-18,1500.0,,-545631890.6100007,.
409000438620',2017-07-18,CR718118694923/RMCPL11850/1,,2017-07-18,5000.0,,-545636890.6100007,.
409000438620',2017-07-18,CR718118696179/RMCPL13846/1,,2017-07-18,5000.0,,-545641890.6100007,.
409000438620',2017-07-18,CR718118696244/RMCPL12060/1,,2017-07-18,9000.0,,-545650890.6100007,.
409000438620',2017-07-18,CR718118698665/RMCPL11360/1,,2017-07-18,110.0,,-545651000.6100007,.
409000438620',2017-07-18,CR718118698779/RMCPL00174/1,,2017-07-18,10000.0,,-545661000.6100007,.
409000438620',2017-07-18,CR718118698778/RMCPL10307/1,,2017-07-18,5000.0,,-545666000.6100007,.
409000438620',2017-07-18,CR718118698918/RMCPL01289/1,,2017-07-18,520.0,,-545666520.6100007,.
409000438620',2017-07-18,CR718118698969/RMCPL10086/1,,2017-07-18,2000.0,,-545668520.6100007,.
409000438620',2017-07-18,CR718118703193/RMCPL11223/1,,2017-07-18,10000.0,,-545678520.6100007,.
409000438620',2017-07-18,CR718118704029/RMCPL12042/1,,2017-07-18,500.0,,-545679020.6100007,.
409000438620',2017-07-18,CR718210930948/RMCPL15087/1,,2017-07-18,3030.0,,-545682050.6100007,.
409000438620',2017-07-18,CR718210931063/RMCPL11912/1,,2017-07-18,1500.0,,-545683550.6100007,.
409000438620',2017-07-18,CR718210931149/RMCPL15776/1,,2017-07-18,300.0,,-545683850.6100007,.
409000438620',2017-07-18,CR718210931061/RMCPL11616/1,,2017-07-18,100.0,,-545683950.6100007,.
409000438620',2017-07-18,CR718210931899/RMCPL13602/1,,2017-07-18,300.0,,-545684250.6100007,.
409000438620',2017-07-18,CR718210931857/RMCPL15450/1,,2017-07-18,730.0,,-545684980.6100007,.
409000438620',2017-07-18,CR718210943118/RMCPL12311/1,,2017-07-18,500.0,,-545685480.6100007,.
409000438620',2017-07-18,CR718210943307/RMCPL13904/1,,2017-07-18,1300.0,,-545686780.6100007,.
409000438620',2017-07-18,CR718210943893/RMCPL15446/1,,2017-07-18,2020.0,,-545688800.6100007,.
409000438620',2017-07-18,CR718210943927/RMCPL14626/1,,2017-07-18,600.0,,-545689400.6100007,.
409000438620',2017-07-18,CR718210944965/RMCPL12914/1,,2017-07-18,1000.0,,-545690400.6100007,.
409000438620',2017-07-18,CR718210944932/RMCPL15811/1,,2017-07-18,100.0,,-545690500.6100007,.
409000438620',2017-07-18,CR718210944988/RMCPL15573/1,,2017-07-18,500.0,,-545691000.6100007,.
409000438620',2017-07-18,CR718211969946/RMCPL07498/1,,2017-07-18,9500.0,,-545700500.6100007,.
409000438620',2017-07-18,CR718211969893/RMCPL11248/1,,2017-07-18,820.0,,-545701320.6100007,.
409000438620',2017-07-18,CR718211969931/RMCPL00165/1,,2017-07-18,4040.0,,-545705360.6100007,.
409000438620',2017-07-18,CR718211970976/RMCPL15368/1,,2017-07-18,2400.0,,-545707760.6100007,.
409000438620',2017-07-18,CR718211980336/RMCPL10987/1,,2017-07-18,600.0,,-545708360.6100007,.
409000438620',2017-07-18,CR718211980901/RMCPL11641/1,,2017-07-18,1500.0,,-545709860.6100007,.
409000438620',2017-07-18,CR718211981018/RMCPL14161/1,,2017-07-18,1000.0,,-545710860.6100007,.
409000438620',2017-07-18,CR718211981062/RMCPL14183/1,,2017-07-18,200.0,,-545711060.6100007,.
409000438620',2017-07-18,CR718211981071/RMCPL10725/1,,2017-07-18,10000.0,,-545721060.6100007,.
409000438620',2017-07-18,CR718212009211/RMCPL15314/1,,2017-07-18,2000.0,,-545723060.6100007,.
409000438620',2017-07-18,CR718212009258/RMCPL14733/1,,2017-07-18,10000.0,,-545733060.6100007,.
409000438620',2017-07-18,CR718212009256/RMCPL10689/1,,2017-07-18,1000.0,,-545734060.6100007,.
409000438620',2017-07-18,CR718214071243/RMCPL09435/1,,2017-07-18,504.0,,-545734564.6100007,.
409000438620',2017-07-18,CR718214071265/RMCPL15151/1,,2017-07-18,1248.0,,-545735812.6100007,.
409000438620',2017-07-18,CR718215108043/RMCPL12731/1,,2017-07-18,2040.0,,-545737852.6100007,.
409000438620',2017-07-18,CR718215108021/RMCPL13285/1,,2017-07-18,1820.0,,-545739672.6100007,.
409000438620',2017-07-18,AEPS Indiaforensic INCOME 170717,,2017-07-18,,92328.58,-545647344.0300007,.
409000438620',2017-07-18,AEPS Indiaforensic S TAX 170717,,2017-07-18,,16619.14,-545630724.8900007,.
409000438620',2017-07-18,Indiaforensic AEPS NPCI WDL SET,,2017-07-18,,22736236.0,-522894488.8900007,.
409000438620',2017-07-18,Indiaforensic AEPS NPCI DEP SET,,2017-07-18,14503980.0,,-537398468.8900007,.
409000438620',2017-07-18,TRF TO  Indiaforensic SERVICES I,,2017-07-18,8900000.0,,-546298468.8900007,.
409000438620',2017-07-19,AEPS ACQUIRING ADJ FEES 1,,2017-07-19,41.3,,-546298510.1900007,.
409000438620',2017-07-19,AEPS Indiaforensic INCOME 180717,,2017-07-19,,97246.68,-546201263.5100007,.
409000438620',2017-07-19,AEPS Indiaforensic S TAX 180717,,2017-07-19,,17504.4,-546183759.1100007,.
409000438620',2017-07-19,Indiaforensic AEPS NPCI WDL SET,,2017-07-19,,23400982.0,-522782777.1100007,.
409000438620',2017-07-19,Indiaforensic AEPS NPCI DEP SET,,2017-07-19,15847987.0,,-538630764.1100007,.
409000438620',2017-07-19,TRF TO  Indiaforensic SERVICES I,,2017-07-19,7600000.0,,-546230764.1100007,.
409000438620',2017-07-20,Indiaforensic AEPS NPCI WDL SET,,2017-07-20,,18664624.0,-527566140.1100007,.
409000438620',2017-07-20,Indiaforensic AEPS NPCI DEP SET,,2017-07-20,13611428.0,,-541177568.1100007,.
409000438620',2017-07-20,AEPS ACQUIRING ADJ FEES 1,,2017-07-20,62.25,,-541177630.3600007,.
409000438620',2017-07-20,CB719413710236/RMCPL16223/1,,2017-07-20,4000.0,,-541181630.3600007,.
409000438620',2017-07-20,CB719217844191/RMCPL12064/1,,2017-07-20,500.0,,-541182130.3600007,.
409000438620',2017-07-20,CB719210620075/RMCPL12042/1,,2017-07-20,1500.0,,-541183630.3600007,.
409000438620',2017-07-20,AEPS Indiaforensic INCOME 190717,,2017-07-20,,78947.94,-541104682.4200007,.
409000438620',2017-07-20,AEPS Indiaforensic S TAX 190717,,2017-07-20,,14210.63,-541090471.7900007,.
409000438620',2017-07-20,TRF TO  Indiaforensic SERVICES I,,2017-07-20,5100000.0,,-546190471.7900007,.
409000438620',2017-07-21,Indiaforensic AEPS NPCI WDL SET,,2017-07-21,,19106971.0,-527083500.7900007,.
409000438620',2017-07-21,Indiaforensic AEPS NPCI DEP SET,,2017-07-21,12448623.0,,-539532123.7900007,.
409000438620',2017-07-21,TRF TO  Indiaforensic SERVICES I,,2017-07-21,6700000.0,,-546232123.7900007,.
409000438620',2017-07-21,AEPS ACQUIRING ADJ FEES 2,,2017-07-21,4.13,,-546232127.9200007,.
409000438620',2017-07-21,CB717911470993/RMCPL09058/2,,2017-07-21,3000.0,,-546235127.9200007,.
409000438620',2017-07-21,AEPS ACQ REP ADJ FEES 200,,2017-07-21,,11.8,-546235116.1200007,.
409000438620',2017-07-21,AEPS Indiaforensic INCOME 210717,,2017-07-21,,80643.65,-546154472.4700007,.
409000438620',2017-07-21,AEPS Indiaforensic S TAX 210717,,2017-07-21,,14515.86,-546139956.6100007,.
409000438620',2017-07-24,Indiaforensic AEPS NPCI WDL SET,,2017-07-24,,21894603.0,-524245353.6100007,.
409000438620',2017-07-24,Indfor RIF AEPS NPCI WDL SET,,2017-07-24,,1500.0,-524243853.6100007,.
409000438620',2017-07-24,Indiaforensic AEPS NPCI WDL SET,,2017-07-24,,19109138.0,-505134715.6100007,.
409000438620',2017-07-24,Indiaforensic AEPS NPCI WDL SET,,2017-07-24,,13194924.0,-491939791.6100007,.
409000438620',2017-07-24,Indiaforensic AEPS NPCI DEP SET,,2017-07-24,15267871.0,,-507207662.6100007,.
409000438620',2017-07-24,Indiaforensic AEPS NPCI DEP SET,,2017-07-24,12424306.0,,-519631968.6100007,.
409000438620',2017-07-24,Indiaforensic AEPS NPCI DEP SET,,2017-07-24,9263819.0,,-528895787.6100007,.
409000438620',2017-07-24,AEPS ACQUIRING ADJ FEES 2,,2017-07-24,58.83,,-528895846.4400007,.
409000438620',2017-07-24,CB719512166081/RMCPL07509/1,,2017-07-24,2500.0,,-528898346.4400007,.
409000438620',2017-07-24,CB719411644168/RMCPL11139/1,,2017-07-24,3200.0,,-528901546.4400007,.
409000438620',2017-07-24,CB719211637565/RMCPL14185/1,,2017-07-24,2050.0,,-528903596.4400007,.
409000438620',2017-07-24,CB719911993275/RMCPL02803/1,,2017-07-24,3200.0,,-528906796.4400007,.
409000438620',2017-07-24,AEPS Indiaforensic INCOME 210717,,2017-07-24,,92218.17,-528814578.2700007,.
409000438620',2017-07-24,AEPS Indiaforensic S TAX 210717,,2017-07-24,,16599.27,-528797979.0000007,.
409000438620',2017-07-24,AEPS Indiaforensic INCOME 220717,,2017-07-24,,79616.04,-528718362.9600007,.
409000438620',2017-07-24,AEPS Indiaforensic S TAX 220717,,2017-07-24,,14330.89,-528704032.0700007,.
409000438620',2017-07-24,AEPS Indiaforensic INCOME 230717,,2017-07-24,,58821.11,-528645210.9600007,.
409000438620',2017-07-24,AEPS Indiaforensic S TAX 230717,,2017-07-24,,10587.8,-528634623.1600007,.
409000438620',2017-07-25,TRF TO  Indiaforensic SERVICES I,,2017-07-25,15000000.0,,-543634623.1600007,.
409000438620',2017-07-25,AEPS ACQ CR ADJ FEES 2407,,2017-07-25,11.8,,-543634634.9600006,.
409000438620',2017-07-25,CB718615980935/RMCPL10752/0,,2017-07-25,2000.0,,-543636634.9600006,.
409000438620',2017-07-25,AEPS ACQ CB 719911993787/,,2017-07-25,10000.0,,-543646634.9600006,.
409000438620',2017-07-25,AEPS ACQ CB 719911978310/,,2017-07-25,400.0,,-543647034.9600006,.
409000438620',2017-07-25,AEPS ACQ CB 719816668123/,,2017-07-25,1050.0,,-543648084.9600006,.
409000438620',2017-07-25,AEPS ACQ CB 719813573526/,,2017-07-25,2020.0,,-543650104.9600006,.
409000438620',2017-07-25,AEPS ACQ CB 719213701589/,,2017-07-25,500.0,,-543650604.9600006,.
409000438620',2017-07-25,AEPS Indiaforensic INCOME 240717,,2017-07-25,,72728.24,-543577876.7200006,.
409000438620',2017-07-25,AEPS Indiaforensic S TAX 240717,,2017-07-25,,13091.08,-543564785.6400006,.
409000438620',2017-07-25,Indiaforensic AEPS NPCI WDL SET,,2017-07-25,,17087717.0,-526477068.6400006,.
409000438620',2017-07-25,Indiaforensic AEPS NPCI DEP SET,,2017-07-25,11733936.0,,-538211004.6400006,.
409000438620',2017-07-25,TRF TO  Indiaforensic SERVICES I,,2017-07-25,8100000.0,,-546311004.6400006,.
409000438620',2017-07-26,AEPS ACQUIRING ADJ FEES 2,,2017-07-26,27.14,,-546311031.7800006,.
409000438620',2017-07-26,AEPS ACQUIRING REP ADJ FE,,2017-07-26,,17.7,-546311014.0800005,.
409000438620',2017-07-26,AEPS Indiaforensic INCOME 250717,,2017-07-26,,104569.57,-546206444.5100005,.
409000438620',2017-07-26,AEPS Indiaforensic S TAX 250717,,2017-07-26,,18822.52,-546187621.9900005,.
409000438620',2017-07-26,Indiaforensic AEPS NPCI WDL SET,,2017-07-26,,24163704.0,-522023917.9900005,.
409000438620',2017-07-26,Indiaforensic AEPS NPCI DEP SET,,2017-07-26,17396734.0,,-539420651.9900005,.
409000438620',2017-07-27,TRF TO  Indiaforensic SERVICES I,,2017-07-27,6800000.0,,-546220651.9900005,.
409000438620',2017-07-27,AEPS ACQUIRING ADJ FEES 2,,2017-07-27,4.13,,-546220656.1200005,.
409000438620',2017-07-27,AEPS ACQ CR ADJ FEES 2607,,2017-07-27,4878.08,,-546225534.2000005,.
409000438620',2017-07-27,Indiaforensic AEPS NPCI WDL SET,,2017-07-27,,23135740.0,-523089794.2000005,.
409000438620',2017-07-27,Indiaforensic AEPS NPCI DEP SET,,2017-07-27,16081455.0,,-539171249.2000005,.
409000438620',2017-07-27,CR719209572315/RMCPL12922/1,,2017-07-27,5020.0,,-539176269.2000005,.
409000438620',2017-07-27,CR719212682802/RMCPL15388/1,,2017-07-27,6000.0,,-539182269.2000005,.
409000438620',2017-07-27,CR719212682764/RMCPL13631/1,,2017-07-27,3000.0,,-539185269.2000005,.
409000438620',2017-07-27,CR719212682844/RMCPL16008/1,,2017-07-27,500.0,,-539185769.2000005,.
409000438620',2017-07-27,CR719212685396/RMCPL12483/1,,2017-07-27,520.0,,-539186289.2000005,.
409000438620',2017-07-27,CR719212685387/RMCPL12698/1,,2017-07-27,1000.0,,-539187289.2000005,.
409000438620',2017-07-27,CR719212685474/RMCPL13499/1,,2017-07-27,1020.0,,-539188309.2000005,.
409000438620',2017-07-27,CR719212685133/RMCPL16047/1,,2017-07-27,7000.0,,-539195309.2000005,.
409000438620',2017-07-27,CR719212685331/RMCPL14411/1,,2017-07-27,5000.0,,-539200309.2000005,.
409000438620',2017-07-27,CR719212683223/RMCPL10048/1,,2017-07-27,100.0,,-539200409.2000005,.
409000438620',2017-07-27,CR719211638694/RMCPL13157/1,,2017-07-27,2000.0,,-539202409.2000005,.
409000438620',2017-07-27,CR719210611026/RMCPL00165/1,,2017-07-27,5050.0,,-539207459.2000005,.
409000438620',2017-07-27,CR719210610961/RMCPL10111/1,,2017-07-27,10000.0,,-539217459.2000005,.
409000438620',2017-07-27,CR719212688312/RMCPL15105/1,,2017-07-27,2000.0,,-539219459.2000005,.
409000438620',2017-07-27,CR719212688462/RMCPL09616/1,,2017-07-27,5302.0,,-539224761.2000005,.
409000438620',2017-07-27,CR719212688478/RMCPL00152/1,,2017-07-27,1110.0,,-539225871.2000005,.
409000438620',2017-07-27,CR719212688519/RMCPL12277/1,,2017-07-27,1500.0,,-539227371.2000005,.
409000438620',2017-07-27,CR719211630271/RMCPL14746/1,,2017-07-27,10000.0,,-539237371.2000005,.
409000438620',2017-07-27,CR719211630260/RMCPL13562/1,,2017-07-27,1460.0,,-539238831.2000005,.
409000438620',2017-07-27,CR719211630319/RMCPL13564/1,,2017-07-27,730.0,,-539239561.2000005,.
409000438620',2017-07-27,CR719211640138/RMCPL13562/1,,2017-07-27,1460.0,,-539241021.2000005,.
409000438620',2017-07-27,CR719217842172/RMCPL14597/1,,2017-07-27,8000.0,,-539249021.2000005,.
409000438620',2017-07-27,CR719217842235/RMCPL00024/1,,2017-07-27,230.0,,-539249251.2000005,.
409000438620',2017-07-27,CR719217842268/RMCPL09767/1,,2017-07-27,300.0,,-539249551.2000005,.
409000438620',2017-07-27,CR719217842284/RMCPL09827/1,,2017-07-27,2020.0,,-539251571.2000005,.
409000438620',2017-07-27,CR719217842296/RMCPL11360/1,,2017-07-27,2020.0,,-539253591.2000005,.
409000438620',2017-07-27,CR719217842371/RMCPL15407/1,,2017-07-27,4000.0,,-539257591.2000005,.
409000438620',2017-07-27,CR719217842389/RMCPL01289/1,,2017-07-27,3400.0,,-539260991.2000005,.
409000438620',2017-07-27,CR719217842409/RMCPL12803/1,,2017-07-27,5000.0,,-539265991.2000005,.
409000438620',2017-07-27,CR719217843207/RMCPL11090/1,,2017-07-27,3000.0,,-539268991.2000005,.
409000438620',2017-07-27,CR719217843247/RMCPL15388/1,,2017-07-27,1000.0,,-539269991.2000005,.
409000438620',2017-07-27,CR719217843253/RMCPL15518/1,,2017-07-27,250.0,,-539270241.2000005,.
409000438620',2017-07-27,CR719217843338/RMCPL09883/1,,2017-07-27,3550.0,,-539273791.2000005,.
409000438620',2017-07-27,CR719217844282/RMCPL11947/1,,2017-07-27,1000.0,,-539274791.2000005,.
409000438620',2017-07-27,CR719211637617/RMCPL13149/1,,2017-07-27,2000.0,,-539276791.2000005,.
409000438620',2017-07-27,CR719211637664/RMCPL13830/1,,2017-07-27,320.0,,-539277111.2000005,.
409000438620',2017-07-27,CR719213713788/RMCPL11247/1,,2017-07-27,600.0,,-539277711.2000005,.
409000438620',2017-07-27,CR719211629718/RMCPL13135/1,,2017-07-27,1000.0,,-539278711.2000005,.
409000438620',2017-07-27,CR719213699881/RMCPL16034/1,,2017-07-27,10000.0,,-539288711.2000005,.
409000438620',2017-07-27,CR719212683427/RMCPL12576/1,,2017-07-27,5000.0,,-539293711.2000005,.
409000438620',2017-07-27,CR719210622980/RMCPL09297/1,,2017-07-27,3000.0,,-539296711.2000005,.
409000438620',2017-07-27,CR719211638707/RMCPL13859/1,,2017-07-27,6020.0,,-539302731.2000005,.
409000438620',2017-07-27,CR719211639039/RMCPL15572/1,,2017-07-27,2000.0,,-539304731.2000005,.
409000438620',2017-07-27,CR719212688572/RMCPL00292/1,,2017-07-27,1000.0,,-539305731.2000005,.
409000438620',2017-07-27,CR719213699703/RMCPL03048/1,,2017-07-27,550.0,,-539306281.2000005,.
409000438620',2017-07-27,CR719212682810/RMCPL02389/1,,2017-07-27,5000.0,,-539311281.2000005,.
409000438620',2017-07-27,CR719212683309/RMCPL15995/1,,2017-07-27,1000.0,,-539312281.2000005,.
409000438620',2017-07-27,CR719210617965/RMCPL11131/1,,2017-07-27,4000.0,,-539316281.2000005,.
409000438620',2017-07-27,CR719212683339/RMCPL15031/1,,2017-07-27,100.0,,-539316381.2000005,.
409000438620',2017-07-27,CR719212683398/RMCPL12330/1,,2017-07-27,100.0,,-539316481.2000005,.
409000438620',2017-07-27,CR719212683316/RMCPL15326/1,,2017-07-27,2000.0,,-539318481.2000005,.
409000438620',2017-07-27,CR719211637489/RMCPL14596/1,,2017-07-27,5000.0,,-539323481.2000005,.
409000438620',2017-07-27,CR719211637578/RMCPL13322/1,,2017-07-27,100.0,,-539323581.2000005,.
409000438620',2017-07-27,CR719211637670/RMCPL12813/1,,2017-07-27,2600.0,,-539326181.2000005,.
409000438620',2017-07-27,CR719211637740/RMCPL15571/1,,2017-07-27,1000.0,,-539327181.2000005,.
409000438620',2017-07-27,CR719217843030/RMCPL10928/1,,2017-07-27,220.0,,-539327401.2000005,.
409000438620',2017-07-27,CR719217843126/RMCPL10752/1,,2017-07-27,500.0,,-539327901.2000005,.
409000438620',2017-07-27,CR719217843151/RMCPL10425/1,,2017-07-27,900.0,,-539328801.2000005,.
409000438620',2017-07-27,CR719217843171/RMCPL11742/1,,2017-07-27,5000.0,,-539333801.2000005,.
409000438620',2017-07-27,CR719210609424/RMCPL14509/1,,2017-07-27,2000.0,,-539335801.2000005,.
409000438620',2017-07-27,CR719209573214/RMCPL10086/1,,2017-07-27,10000.0,,-539345801.2000005,.
409000438620',2017-07-27,CR719209573233/RMCPL15907/1,,2017-07-27,6260.0,,-539352061.2000005,.
409000438620',2017-07-27,CR719209573211/RMCPL15755/1,,2017-07-27,4248.0,,-539356309.2000005,.
409000438620',2017-07-27,CR719209573149/RMCPL07498/1,,2017-07-27,5000.0,,-539361309.2000005,.
409000438620',2017-07-27,CR719212684139/RMCPL13525/1,,2017-07-27,300.0,,-539361609.2000005,.
409000438620',2017-07-27,CR719212684212/RMCPL10073/1,,2017-07-27,600.0,,-539362209.2000005,.
409000438620',2017-07-27,CR719209588136/RMCPL11247/1,,2017-07-27,500.0,,-539362709.2000005,.
409000438620',2017-07-27,CR719212687141/RMCPL16279/1,,2017-07-27,300.0,,-539363009.2000005,.
409000438620',2017-07-27,CR719212687240/RMCPL15868/1,,2017-07-27,5500.0,,-539368509.2000005,.
409000438620',2017-07-27,CR719212687293/RMCPL15554/1,,2017-07-27,1000.0,,-539369509.2000005,.
409000438620',2017-07-27,CR719212687574/RMCPL12720/1,,2017-07-27,200.0,,-539369709.2000005,.
409000438620',2017-07-27,CR719212687690/RMCPL11393/1,,2017-07-27,2500.0,,-539372209.2000005,.
409000438620',2017-07-27,CR719212687696/RMCPL13631/1,,2017-07-27,3000.0,,-539375209.2000005,.
409000438620',2017-07-27,CR719211639764/RMCPL16185/1,,2017-07-27,5000.0,,-539380209.2000005,.
409000438620',2017-07-27,CR719210612271/RMCPL11375/1,,2017-07-27,1030.0,,-539381239.2000005,.
409000438620',2017-07-27,CR719211654756/RMCPL15045/1,,2017-07-27,4500.0,,-539385739.2000005,.
409000438620',2017-07-27,CR719211654944/RMCPL13882/1,,2017-07-27,910.0,,-539386649.2000005,.
409000438620',2017-07-27,CR719210619853/RMCPL15388/1,,2017-07-27,10000.0,,-539396649.2000005,.
409000438620',2017-07-27,CR719212685248/RMCPL00010/1,,2017-07-27,500.0,,-539397149.2000005,.
409000438620',2017-07-27,CR719211639736/RMCPL14185/1,,2017-07-27,1000.0,,-539398149.2000005,.
409000438620',2017-07-27,CR719211639790/RMCPL13002/1,,2017-07-27,3000.0,,-539401149.2000005,.
409000438620',2017-07-27,CR719211639851/RMCPL12221/1,,2017-07-27,1010.0,,-539402159.2000005,.
409000438620',2017-07-27,CR719210612332/RMCPL09883/1,,2017-07-27,5000.0,,-539407159.2000005,.
409000438620',2017-07-27,CR719211639586/RMCPL13878/1,,2017-07-27,300.0,,-539407459.2000005,.
409000438620',2017-07-27,CR719210612437/RMCPL12277/1,,2017-07-27,1500.0,,-539408959.2000005,.
409000438620',2017-07-27,CR719210612436/RMCPL13600/1,,2017-07-27,10000.0,,-539418959.2000005,.
409000438620',2017-07-27,CR719210619958/RMCPL11389/1,,2017-07-27,220.0,,-539419179.2000005,.
409000438620',2017-07-27,CR719210620032/RMCPL16106/1,,2017-07-27,2000.0,,-539421179.2000005,.
409000438620',2017-07-27,CR719213699835/RMCPL11784/1,,2017-07-27,300.0,,-539421479.2000005,.
409000438620',2017-07-27,CR719213699806/RMCPL14957/1,,2017-07-27,500.0,,-539421979.2000005,.
409000438620',2017-07-27,CR719213699823/RMCPL09667/1,,2017-07-27,500.0,,-539422479.2000005,.
409000438620',2017-07-27,CR719212685282/RMCPL12566/1,,2017-07-27,200.0,,-539422679.2000005,.
409000438620',2017-07-27,CR719212685470/RMCPL10110/1,,2017-07-27,1000.0,,-539423679.2000005,.
409000438620',2017-07-27,CR719213700362/RMCPL14128/1,,2017-07-27,500.0,,-539424179.2000005,.
409000438620',2017-07-27,CR719213700385/RMCPL16151/1,,2017-07-27,2010.0,,-539426189.2000005,.
409000438620',2017-07-27,CR719211637737/RMCPL09900/1,,2017-07-27,2000.0,,-539428189.2000005,.
409000438620',2017-07-27,CR719211637755/RMCPL15459/1,,2017-07-27,3000.0,,-539431189.2000005,.
409000438620',2017-07-27,CR719211637777/RMCPL16081/1,,2017-07-27,730.0,,-539431919.2000005,.
409000438620',2017-07-27,CR719211637829/RMCPL11247/1,,2017-07-27,2000.0,,-539433919.2000005,.
409000438620',2017-07-27,CR719211637832/RMCPL15016/1,,2017-07-27,4400.0,,-539438319.2000005,.
409000438620',2017-07-27,CR719209572434/RMCPL13625/1,,2017-07-27,10000.0,,-539448319.2000005,.
409000438620',2017-07-27,CR719213699108/RMCPL15486/1,,2017-07-27,10000.0,,-539458319.2000005,.
409000438620',2017-07-27,CR719213699071/RMCPL15422/1,,2017-07-27,5000.0,,-539463319.2000005,.
409000438620',2017-07-27,CR719213699115/RMCPL09879/1,,2017-07-27,730.0,,-539464049.2000005,.
409000438620',2017-07-27,CR719213699078/RMCPL09990/1,,2017-07-27,5000.0,,-539469049.2000005,.
409000438620',2017-07-27,CR719213701481/RMCPL12838/1,,2017-07-27,2000.0,,-539471049.2000005,.
409000438620',2017-07-27,CR719213701512/RMCPL16185/1,,2017-07-27,1000.0,,-539472049.2000005,.
409000438620',2017-07-27,CR719210619979/RMCPL10048/1,,2017-07-27,2010.0,,-539474059.2000005,.
409000438620',2017-07-27,CR719209572420/RMCPL14249/1,,2017-07-27,1090.0,,-539475149.2000005,.
409000438620',2017-07-27,CR719209572384/RMCPL14111/1,,2017-07-27,2000.0,,-539477149.2000005,.
409000438620',2017-07-27,CR719209573009/RMCPL15998/1,,2017-07-27,510.0,,-539477659.2000005,.
409000438620',2017-07-27,CR719211638385/RMCPL13971/1,,2017-07-27,2000.0,,-539479659.2000005,.
409000438620',2017-07-27,CR719211638393/RMCPL13973/1,,2017-07-27,1760.0,,-539481419.2000005,.
409000438620',2017-07-27,CR719213698779/RMCPL09560/1,,2017-07-27,1500.0,,-539482919.2000005,.
409000438620',2017-07-27,CR719213698880/RMCPL14707/1,,2017-07-27,1250.0,,-539484169.2000005,.
409000438620',2017-07-27,CR719213698946/RMCPL11388/1,,2017-07-27,600.0,,-539484769.2000005,.
409000438620',2017-07-27,CR719213698957/RMCPL13161/1,,2017-07-27,1000.0,,-539485769.2000005,.
409000438620',2017-07-27,CR719213698888/RMCPL15387/1,,2017-07-27,800.0,,-539486569.2000005,.
409000438620',2017-07-27,CR719213698987/RMCPL15698/1,,2017-07-27,4000.0,,-539490569.2000005,.
409000438620',2017-07-27,CR719211637847/RMCPL13317/1,,2017-07-27,6500.0,,-539497069.2000005,.
409000438620',2017-07-27,CR719209590261/RMCPL11139/1,,2017-07-27,100.0,,-539497169.2000005,.
409000438620',2017-07-27,CR719213700305/RMCPL13626/1,,2017-07-27,5100.0,,-539502269.2000005,.
409000438620',2017-07-27,CR719213700507/RMCPL09044/1,,2017-07-27,4000.0,,-539506269.2000005,.
409000438620',2017-07-27,CR719317341339/RMCPL11530/1,,2017-07-27,500.0,,-539506769.2000005,.
409000438620',2017-07-27,CR719317341351/RMCPL117/120,,2017-07-27,700.0,,-539507469.2000005,.
409000438620',2017-07-27,CR719311164187/RMCPL15169/1,,2017-07-27,100.0,,-539507569.2000005,.
409000438620',2017-07-27,CR719311164196/RMCPL10768/1,,2017-07-27,2000.0,,-539509569.2000005,.
409000438620',2017-07-27,CR719311174944/RMCPL13006/1,,2017-07-27,250.0,,-539509819.2000005,.
409000438620',2017-07-27,CR719312187757/RMCPL11218/1,,2017-07-27,2000.0,,-539511819.2000005,.
409000438620',2017-07-27,CR719312188451/RMCPL10242/1,,2017-07-27,7000.0,,-539518819.2000005,.
409000438620',2017-07-27,CR719312187777/RMCPL16338/1,,2017-07-27,5000.0,,-539523819.2000005,.
409000438620',2017-07-27,CR719313238794/RMCPL11827/1,,2017-07-27,1010.0,,-539524829.2000005,.
409000438620',2017-07-27,CR719313238805/RMCPL14840/1,,2017-07-27,8000.0,,-539532829.2000005,.
409000438620',2017-07-27,CR719313239396/RMCPL15388/1,,2017-07-27,1000.0,,-539533829.2000005,.
409000438620',2017-07-27,CR719311164295/RMCPL12254/1,,2017-07-27,3000.0,,-539536829.2000005,.
409000438620',2017-07-27,CR719311165327/RMCPL12741/1,,2017-07-27,5000.0,,-539541829.2000005,.
409000438620',2017-07-27,CR719311165345/RMCPL08968/1,,2017-07-27,9000.0,,-539550829.2000005,.
409000438620',2017-07-27,CR719311165374/RMCPL09579/1,,2017-07-27,800.0,,-539551629.2000005,.
409000438620',2017-07-27,CR719311163440/RMCPL15039/1,,2017-07-27,510.0,,-539552139.2000005,.
409000438620',2017-07-27,CR719311163540/RMCPL12991/1,,2017-07-27,5200.0,,-539557339.2000005,.
409000438620',2017-07-27,CR719311163606/RMCPL14740/1,,2017-07-27,2000.0,,-539559339.2000005,.
409000438620',2017-07-27,CR719310133155/RMCPL03589/1,,2017-07-27,500.0,,-539559839.2000005,.
409000438620',2017-07-27,CR719310133207/RMCPL15267/1,,2017-07-27,1500.0,,-539561339.2000005,.
409000438620',2017-07-27,CR719311168686/RMCPL13561/1,,2017-07-27,730.0,,-539562069.2000005,.
409000438620',2017-07-27,CR719311165384/RMCPL11128/1,,2017-07-27,5050.0,,-539567119.2000005,.
409000438620',2017-07-27,CR719313238915/RMCPL14431/1,,2017-07-27,2000.0,,-539569119.2000005,.
409000438620',2017-07-27,CR719313238978/RMCPL15447/1,,2017-07-27,10000.0,,-539579119.2000005,.
409000438620',2017-07-27,CR719313238977/RMCPL01201/1,,2017-07-27,400.0,,-539579519.2000005,.
409000438620',2017-07-27,CR719310133231/RMCPL15005/1,,2017-07-27,1500.0,,-539581019.2000005,.
409000438620',2017-07-27,CR719313239440/RMCPL16517/1,,2017-07-27,100.0,,-539581119.2000005,.
409000438620',2017-07-27,CR719313239479/RMCPL14596/1,,2017-07-27,700.0,,-539581819.2000005,.
409000438620',2017-07-27,CR719311175586/RMCPL03258/1,,2017-07-27,6000.0,,-539587819.2000005,.
409000438620',2017-07-27,CR719311175640/RMCPL15609/1,,2017-07-27,500.0,,-539588319.2000005,.
409000438620',2017-07-27,CR719411649196/RMCPL14561/1,,2017-07-27,5000.0,,-539593319.2000005,.
409000438620',2017-07-27,CR719411665482/RMCPL14740/1,,2017-07-27,5050.0,,-539598369.2000005,.
409000438620',2017-07-27,CR719411665484/RMCPL13491/1,,2017-07-27,500.0,,-539598869.2000005,.
409000438620',2017-07-27,CR719411665486/RMCPL11446/1,,2017-07-27,500.0,,-539599369.2000005,.
409000438620',2017-07-27,CR719411665504/RMCPL15219/1,,2017-07-27,206.0,,-539599575.2000005,.
409000438620',2017-07-27,CR719411645209/RMCPL14750/1,,2017-07-27,1000.0,,-539600575.2000005,.
409000438620',2017-07-27,CR719411672486/RMCPL15271/1,,2017-07-27,3000.0,,-539603575.2000005,.
409000438620',2017-07-27,CR719411672591/RMCPL11120/1,,2017-07-27,2000.0,,-539605575.2000005,.
409000438620',2017-07-27,CR719411672641/RMCPL05040/1,,2017-07-27,2000.0,,-539607575.2000005,.
409000438620',2017-07-27,CR719411643551/RMCPL16338/1,,2017-07-27,500.0,,-539608075.2000005,.
409000438620',2017-07-27,CR719412675921/RMCPL11748/1,,2017-07-27,1000.0,,-539609075.2000005,.
409000438620',2017-07-27,CR719411651427/RMCPL00277/1,,2017-07-27,5000.0,,-539614075.2000005,.
409000438620',2017-07-27,CR719411651489/RMCPL09136/1,,2017-07-27,5030.0,,-539619105.2000005,.
409000438620',2017-07-27,CR719411668909/RMCPL15862/1,,2017-07-27,100.0,,-539619205.2000005,.
409000438620',2017-07-27,CR719411669039/RMCPL00116/1,,2017-07-27,5100.0,,-539624305.2000005,.
409000438620',2017-07-27,CR719411669006/RMCPL11346/1,,2017-07-27,300.0,,-539624605.2000005,.
409000438620',2017-07-27,CR719411647707/RMCPL07287/1,,2017-07-27,3500.0,,-539628105.2000005,.
409000438620',2017-07-27,CR719413710858/RMCPL09990/1,,2017-07-27,100.0,,-539628205.2000005,.
409000438620',2017-07-27,CR719411663757/RMCPL12164/1,,2017-07-27,2000.0,,-539630205.2000005,.
409000438620',2017-07-27,CR719411652160/RMCPL12121/1,,2017-07-27,310.0,,-539630515.2000005,.
409000438620',2017-07-27,CR719411652213/RMCPL00010/1,,2017-07-27,10000.0,,-539640515.2000005,.
409000438620',2017-07-27,CR719412690275/RMCPL00138/1,,2017-07-27,3100.0,,-539643615.2000005,.
409000438620',2017-07-27,CR719412690975/RMCPL15535/1,,2017-07-27,1000.0,,-539644615.2000005,.
409000438620',2017-07-27,CR719412691035/RMCPL15657/1,,2017-07-27,4000.0,,-539648615.2000005,.
409000438620',2017-07-27,CR719413708608/RMCPL15317/1,,2017-07-27,100.0,,-539648715.2000005,.
409000438620',2017-07-27,CR719411669736/RMCPL16403/1,,2017-07-27,3000.0,,-539651715.2000005,.
409000438620',2017-07-27,CR719413719897/RMCPL10043/1,,2017-07-27,500.0,,-539652215.2000005,.
409000438620',2017-07-27,CR719413719902/RMCPL09851/1,,2017-07-27,1000.0,,-539653215.2000005,.
409000438620',2017-07-27,CR719413719945/RMCPL10458/1,,2017-07-27,1500.0,,-539654715.2000005,.
409000438620',2017-07-27,CR719413719947/RMCPL13744/1,,2017-07-27,2500.0,,-539657215.2000005,.
409000438620',2017-07-27,CR719413719975/RMCPL11685/1,,2017-07-27,1000.0,,-539658215.2000005,.
409000438620',2017-07-27,CR719413719987/RMCPL14108/1,,2017-07-27,1916.0,,-539660131.2000005,.
409000438620',2017-07-27,CR719411646626/RMCPL09829/1,,2017-07-27,2800.0,,-539662931.2000005,.
409000438620',2017-07-27,CR719412674007/RMCPL15030/1,,2017-07-27,3000.0,,-539665931.2000005,.
409000438620',2017-07-27,CR719412674011/RMCPL10418/1,,2017-07-27,430.0,,-539666361.2000005,.
409000438620',2017-07-27,CR719412674052/RMCPL15271/1,,2017-07-27,3000.0,,-539669361.2000005,.
409000438620',2017-07-27,CR719411669789/RMCPL14809/1,,2017-07-27,4000.0,,-539673361.2000005,.
409000438620',2017-07-27,CR719411670681/RMCPL11103/1,,2017-07-27,2575.0,,-539675936.2000005,.
409000438620',2017-07-27,CR719411670749/RMCPL14777/1,,2017-07-27,200.0,,-539676136.2000005,.
409000438620',2017-07-27,CR719413710153/RMCPL09505/1,,2017-07-27,9170.0,,-539685306.2000005,.
409000438620',2017-07-27,CR719412692714/RMCPL16372/1,,2017-07-27,1000.0,,-539686306.2000005,.
409000438620',2017-07-27,CR719412692719/RMCPL15511/1,,2017-07-27,100.0,,-539686406.2000005,.
409000438620',2017-07-27,CR719412692721/RMCPL11596/1,,2017-07-27,900.0,,-539687306.2000005,.
409000438620',2017-07-27,CR719411649451/RMCPL10370/1,,2017-07-27,1500.0,,-539688806.2000005,.
409000438620',2017-07-27,CR719411649309/RMCPL10064/1,,2017-07-27,3000.0,,-539691806.2000005,.
409000438620',2017-07-27,CR719411649245/RMCPL11793/1,,2017-07-27,3000.0,,-539694806.2000005,.
409000438620',2017-07-27,CR719411649913/RMCPL13524/1,,2017-07-27,100.0,,-539694906.2000005,.
409000438620',2017-07-27,CR719413710264/RMCPL11250/1,,2017-07-27,3000.0,,-539697906.2000005,.
409000438620',2017-07-27,CR719412675100/RMCPL10682/1,,2017-07-27,10000.0,,-539707906.2000005,.
409000438620',2017-07-27,CR719412690237/RMCPL12752/1,,2017-07-27,500.0,,-539708406.2000005,.
409000438620',2017-07-27,CR719412678887/RMCPL12329/1,,2017-07-27,300.0,,-539708706.2000005,.
409000438620',2017-07-27,CR719412678895/RMCPL14183/1,,2017-07-27,1560.0,,-539710266.2000005,.
409000438620',2017-07-27,CR719413708733/RMCPL09152/1,,2017-07-27,1500.0,,-539711766.2000005,.
409000438620',2017-07-27,CR719413709073/RMCPL03019/1,,2017-07-27,3000.0,,-539714766.2000005,.
409000438620',2017-07-27,CR719413709630/RMCPL09033/1,,2017-07-27,8100.0,,-539722866.2000005,.
409000438620',2017-07-27,CR719413709647/RMCPL09249/1,,2017-07-27,500.0,,-539723366.2000005,.
409000438620',2017-07-27,CR719413709652/RMCPL15995/1,,2017-07-27,2000.0,,-539725366.2000005,.
409000438620',2017-07-27,CR719413709697/RMCPL11517/1,,2017-07-27,300.0,,-539725666.2000005,.
409000438620',2017-07-27,CR719411649241/RMCPL13369/1,,2017-07-27,500.0,,-539726166.2000005,.
409000438620',2017-07-27,CR719411646536/RMCPL14750/1,,2017-07-27,1000.0,,-539727166.2000005,.
409000438620',2017-07-27,CR719411662377/RMCPL14885/1,,2017-07-27,5000.0,,-539732166.2000005,.
409000438620',2017-07-27,CR719411643571/RMCPL09982/1,,2017-07-27,500.0,,-539732666.2000005,.
409000438620',2017-07-27,CR719411643706/RMCPL15716/1,,2017-07-27,500.0,,-539733166.2000005,.
409000438620',2017-07-27,CR719411643705/RMCPL11140/1,,2017-07-27,520.0,,-539733686.2000005,.
409000438620',2017-07-27,CR719411643742/RMCPL16234/1,,2017-07-27,100.0,,-539733786.2000005,.
409000438620',2017-07-27,CR719411644153/RMCPL11393/1,,2017-07-27,400.0,,-539734186.2000005,.
409000438620',2017-07-27,CR719411644262/RMCPL15755/1,,2017-07-27,2124.0,,-539736310.2000005,.
409000438620',2017-07-27,CR719412678335/RMCPL14732/1,,2017-07-27,206.0,,-539736516.2000005,.
409000438620',2017-07-27,CR719412678369/RMCPL15326/1,,2017-07-27,4000.0,,-539740516.2000005,.
409000438620',2017-07-27,CR719412678853/RMCPL12741/1,,2017-07-27,10000.0,,-539750516.2000005,.
409000438620',2017-07-27,CR719411644655/RMCPL13170/1,,2017-07-27,5300.0,,-539755816.2000005,.
409000438620',2017-07-27,CR719411644677/RMCPL15647/1,,2017-07-27,5050.0,,-539760866.2000005,.
409000438620',2017-07-27,CR719411644715/RMCPL00125/1,,2017-07-27,200.0,,-539761066.2000005,.
409000438620',2017-07-27,CR719411645825/RMCPL10820/1,,2017-07-27,2100.0,,-539763166.2000005,.
409000438620',2017-07-27,CR719411645918/RMCPL14561/1,,2017-07-27,5000.0,,-539768166.2000005,.
409000438620',2017-07-27,CR719411645993/RMCPL13142/1,,2017-07-27,1200.0,,-539769366.2000005,.
409000438620',2017-07-27,CR719411648936/RMCPL10705/1,,2017-07-27,4000.0,,-539773366.2000005,.
409000438620',2017-07-27,CR719411649150/RMCPL11371/1,,2017-07-27,2010.0,,-539775376.2000005,.
409000438620',2017-07-27,CR719411649164/RMCPL11748/1,,2017-07-27,4000.0,,-539779376.2000005,.
409000438620',2017-07-27,CR719411649177/RMCPL12991/1,,2017-07-27,3060.0,,-539782436.2000005,.
409000438620',2017-07-27,CR719511141068/RMCPL13376/1,,2017-07-27,1600.0,,-539784036.2000005,.
409000438620',2017-07-27,CR719511141141/RMCPL11932/1,,2017-07-27,5000.0,,-539789036.2000005,.
409000438620',2017-07-27,CR719511135548/RMCPL15293/1,,2017-07-27,500.0,,-539789536.2000005,.
409000438620',2017-07-27,CR719511136884/RMCPL13619/1,,2017-07-27,2000.0,,-539791536.2000005,.
409000438620',2017-07-27,CR719511136897/RMCPL04395/1,,2017-07-27,100.0,,-539791636.2000005,.
409000438620',2017-07-27,CR719511136971/RMCPL08902/1,,2017-07-27,5000.0,,-539796636.2000005,.
409000438620',2017-07-27,CR719511137020/RMCPL14536/1,,2017-07-27,200.0,,-539796836.2000005,.
409000438620',2017-07-27,CR719511140948/RMCPL12892/1,,2017-07-27,200.0,,-539797036.2000005,.
409000438620',2017-07-27,CR719511140979/RMCPL15601/1,,2017-07-27,10000.0,,-539807036.2000005,.
409000438620',2017-07-27,CR719511134917/RMCPL12892/1,,2017-07-27,200.0,,-539807236.2000005,.
409000438620',2017-07-27,CR719511134934/RMCPL02773/1,,2017-07-27,2450.0,,-539809686.2000005,.
409000438620',2017-07-27,CR719513199264/RMCPL12429/1,,2017-07-27,4080.0,,-539813766.2000005,.
409000438620',2017-07-27,CR719513199278/RMCPL00175/1,,2017-07-27,10000.0,,-539823766.2000005,.
409000438620',2017-07-27,CR719513199281/RMCPL14818/1,,2017-07-27,1040.0,,-539824806.2000005,.
409000438620',2017-07-27,CR719512188417/RMCPL01852/1,,2017-07-27,1000.0,,-539825806.2000005,.
409000438620',2017-07-27,CR719511163651/RMCPL13376/1,,2017-07-27,1650.0,,-539827456.2000005,.
409000438620',2017-07-27,CR719513201159/RMCPL11752/1,,2017-07-27,4000.0,,-539831456.2000005,.
409000438620',2017-07-27,CR719510131557/RMCPL11797/1,,2017-07-27,1000.0,,-539832456.2000005,.
409000438620',2017-07-27,CR719510131562/RMCPL11764/1,,2017-07-27,500.0,,-539832956.2000005,.
409000438620',2017-07-27,CR719510131631/RMCPL15718/1,,2017-07-27,5000.0,,-539837956.2000005,.
409000438620',2017-07-27,CR719511137700/RMCPL14777/1,,2017-07-27,2000.0,,-539839956.2000005,.
409000438620',2017-07-27,CR719511137657/RMCPL10456/1,,2017-07-27,2900.0,,-539842856.2000005,.
409000438620',2017-07-27,CR719511136780/RMCPL09701/1,,2017-07-27,6120.0,,-539848976.2000005,.
409000438620',2017-07-27,CR719513201080/RMCPL14185/1,,2017-07-27,500.0,,-539849476.2000005,.
409000438620',2017-07-27,CR719512186384/RMCPL15094/1,,2017-07-27,4000.0,,-539853476.2000005,.
409000438620',2017-07-27,CR719511132865/RMCPL13567/1,,2017-07-27,730.0,,-539854206.2000005,.
409000438620',2017-07-27,CR719511135550/RMCPL15878/1,,2017-07-27,1000.0,,-539855206.2000005,.
409000438620',2017-07-27,CR719512187731/RMCPL14662/1,,2017-07-27,1700.0,,-539856906.2000005,.
409000438620',2017-07-27,CR719511136168/RMCPL13904/1,,2017-07-27,500.0,,-539857406.2000005,.
409000438620',2017-07-27,CR719513198475/RMCPL13027/1,,2017-07-27,4040.0,,-539861446.2000005,.
409000438620',2017-07-27,CR719511135967/RMCPL11685/1,,2017-07-27,1400.0,,-539862846.2000005,.
409000438620',2017-07-27,CR719511135974/RMCPL11056/1,,2017-07-27,3010.0,,-539865856.2000005,.
409000438620',2017-07-27,CR719511136061/RMCPL14443/1,,2017-07-27,1000.0,,-539866856.2000005,.
409000438620',2017-07-27,CR719511136097/RMCPL16473/1,,2017-07-27,3000.0,,-539869856.2000005,.
409000438620',2017-07-27,CR719513207419/RMCPL15823/1,,2017-07-27,710.0,,-539870566.2000005,.
409000438620',2017-07-27,CR719513209856/RMCPL14818/1,,2017-07-27,1020.0,,-539871586.2000005,.
409000438620',2017-07-27,CR719511141879/RMCPL09851/1,,2017-07-27,10000.0,,-539881586.2000005,.
409000438620',2017-07-27,CR719511141811/RMCPL09883/1,,2017-07-27,3000.0,,-539884586.2000005,.
409000438620',2017-07-27,CR719610605441/RMCPL00529/1,,2017-07-27,1700.0,,-539886286.2000005,.
409000438620',2017-07-27,CR719610584449/RMCPL00292/1,,2017-07-27,1000.0,,-539887286.2000005,.
409000438620',2017-07-27,CR719610584458/RMCPL11158/1,,2017-07-27,500.0,,-539887786.2000005,.
409000438620',2017-07-27,CR719610595753/RMCPL15323/1,,2017-07-27,2020.0,,-539889806.2000005,.
409000438620',2017-07-27,CR719610595728/RMCPL13299/1,,2017-07-27,3000.0,,-539892806.2000005,.
409000438620',2017-07-27,CR719610597930/RMCPL15786/1,,2017-07-27,2000.0,,-539894806.2000005,.
409000438620',2017-07-27,CR719610599137/RMCPL11535/1,,2017-07-27,1200.0,,-539896006.2000005,.
409000438620',2017-07-27,CR719610599230/RMCPL03258/1,,2017-07-27,3000.0,,-539899006.2000005,.
409000438620',2017-07-27,CR719610601233/RMCPL12838/1,,2017-07-27,400.0,,-539899406.2000005,.
409000438620',2017-07-27,CR719610601261/RMCPL11248/1,,2017-07-27,8090.0,,-539907496.2000005,.
409000438620',2017-07-27,CR719610594990/RMCPL15314/1,,2017-07-27,300.0,,-539907796.2000005,.
409000438620',2017-07-27,CR719610595032/RMCPL11227/1,,2017-07-27,2020.0,,-539909816.2000005,.
409000438620',2017-07-27,CR719610595040/RMCPL11754/1,,2017-07-27,500.0,,-539910316.2000005,.
409000438620',2017-07-27,CR719612657542/RMCPL11955/1,,2017-07-27,1000.0,,-539911316.2000005,.
409000438620',2017-07-27,CR719611629356/RMCPL12359/1,,2017-07-27,200.0,,-539911516.2000005,.
409000438620',2017-07-27,CR719610583592/RMCPL11626/1,,2017-07-27,1000.0,,-539912516.2000005,.
409000438620',2017-07-27,CR719610593798/RMCPL11779/1,,2017-07-27,5000.0,,-539917516.2000005,.
409000438620',2017-07-27,CR719610593939/RMCPL15227/1,,2017-07-27,1000.0,,-539918516.2000005,.
409000438620',2017-07-27,CR719611614782/RMCPL12049/1,,2017-07-27,5000.0,,-539923516.2000005,.
409000438620',2017-07-27,CR719610596182/RMCPL12459/1,,2017-07-27,1000.0,,-539924516.2000005,.
409000438620',2017-07-27,CR719610596211/RMCPL13078/1,,2017-07-27,100.0,,-539924616.2000005,.
409000438620',2017-07-27,CR719610599372/RMCPL16374/1,,2017-07-27,1000.0,,-539925616.2000005,.
409000438620',2017-07-27,CR719813570981/RMCPL15491/1,,2017-07-27,5000.0,,-539930616.2000005,.
409000438620',2017-07-27,CR719813571131/RMCPL15193/1,,2017-07-27,4500.0,,-539935116.2000005,.
409000438620',2017-07-27,CR719812557019/RMCPL15982/1,,2017-07-27,10000.0,,-539945116.2000005,.
409000438620',2017-07-27,CR719812557049/RMCPL14183/1,,2017-07-27,500.0,,-539945616.2000005,.
409000438620',2017-07-27,CR719811538408/RMCPL13304/1,,2017-07-27,100.0,,-539945716.2000005,.
409000438620',2017-07-27,CR719811538425/RMCPL15397/1,,2017-07-27,9000.0,,-539954716.2000005,.
409000438620',2017-07-27,CR719811538441/RMCPL15135/1,,2017-07-27,100.0,,-539954816.2000005,.
409000438620',2017-07-27,CR719811538500/RMCPL13285/1,,2017-07-27,200.0,,-539955016.2000005,.
409000438620',2017-07-27,CR719812538577/RMCPL12741/1,,2017-07-27,500.0,,-539955516.2000005,.
409000438620',2017-07-27,CR719812538631/RMCPL13323/1,,2017-07-27,1000.0,,-539956516.2000005,.
409000438620',2017-07-27,CR719812538693/RMCPL15850/1,,2017-07-27,7000.0,,-539963516.2000005,.
409000438620',2017-07-27,CR719812538663/RMCPL13418/1,,2017-07-27,2000.0,,-539965516.2000005,.
409000438620',2017-07-27,CR719812539482/RMCPL15315/1,,2017-07-27,2000.0,,-539967516.2000005,.
409000438620',2017-07-27,CR719813574256/RMCPL14079/1,,2017-07-27,1420.0,,-539968936.2000005,.
409000438620',2017-07-27,CR719813574410/RMCPL15002/1,,2017-07-27,3540.0,,-539972476.2000005,.
409000438620',2017-07-27,CR719811509988/RMCPL13973/1,,2017-07-27,100.0,,-539972576.2000005,.
409000438620',2017-07-27,CR719811510098/RMCPL15265/1,,2017-07-27,2400.0,,-539974976.2000005,.
409000438620',2017-07-27,CR719811510200/RMCPL00250/1,,2017-07-27,5000.0,,-539979976.2000005,.
409000438620',2017-07-27,CR719811512074/RMCPL13327/1,,2017-07-27,1000.0,,-539980976.2000005,.
409000438620',2017-07-27,CR719811512018/RMCPL16291/1,,2017-07-27,110.0,,-539981086.2000005,.
409000438620',2017-07-27,CR719811512107/RMCPL15901/1,,2017-07-27,3000.0,,-539984086.2000005,.
409000438620',2017-07-27,CR719811511247/RMCPL11755/1,,2017-07-27,1300.0,,-539985386.2000005,.
409000438620',2017-07-27,CR719811511268/RMCPL15850/1,,2017-07-27,2100.0,,-539987486.2000005,.
409000438620',2017-07-27,CR719811511742/RMCPL09879/1,,2017-07-27,600.0,,-539988086.2000005,.
409000438620',2017-07-27,CR719811511747/RMCPL09851/1,,2017-07-27,10000.0,,-539998086.2000005,.
409000438620',2017-07-27,CR719811511751/RMCPL00146/1,,2017-07-27,100.0,,-539998186.2000005,.
409000438620',2017-07-27,CR719812539636/RMCPL11466/1,,2017-07-27,600.0,,-539998786.2000005,.
409000438620',2017-07-27,CR719812539630/RMCPL16184/1,,2017-07-27,300.0,,-539999086.2000005,.
409000438620',2017-07-27,CR719812556436/RMCPL14066/1,,2017-07-27,3000.0,,-540002086.2000005,.
409000438620',2017-07-27,CR719812545852/RMCPL10733/1,,2017-07-27,10000.0,,-540012086.2000005,.
409000438620',2017-07-27,CR719816666350/RMCPL13575/1,,2017-07-27,1250.0,,-540013336.2000005,.
409000438620',2017-07-27,CR719816666412/RMCPL12177/1,,2017-07-27,150.0,,-540013486.2000005,.
409000438620',2017-07-27,CR719812544925/RMCPL14954/1,,2017-07-27,1200.0,,-540014686.2000005,.
409000438620',2017-07-27,CR719812544959/RMCPL14710/1,,2017-07-27,2300.0,,-540016986.2000005,.
409000438620',2017-07-27,CR719812544939/RMCPL15094/1,,2017-07-27,4000.0,,-540020986.2000005,.
409000438620',2017-07-27,CR719812545049/RMCPL10735/1,,2017-07-27,1000.0,,-540021986.2000005,.
409000438620',2017-07-27,CR719813572564/RMCPL11966/1,,2017-07-27,2060.0,,-540024046.2000005,.
409000438620',2017-07-27,CR719813572490/RMCPL16508/1,,2017-07-27,3000.0,,-540027046.2000005,.
409000438620',2017-07-27,CR719813572458/RMCPL09883/1,,2017-07-27,5000.0,,-540032046.2000005,.
409000438620',2017-07-27,CR719813570396/RMCPL15671/1,,2017-07-27,9000.0,,-540041046.2000005,.
409000438620',2017-07-27,CR719813570401/RMCPL15882/1,,2017-07-27,2880.0,,-540043926.2000005,.
409000438620',2017-07-27,CR719813570489/RMCPL16094/1,,2017-07-27,2000.0,,-540045926.2000005,.
409000438620',2017-07-27,CR719813570503/RMCPL13062/1,,2017-07-27,3000.0,,-540048926.2000005,.
409000438620',2017-07-27,CR719813570505/RMCPL14523/1,,2017-07-27,5000.0,,-540053926.2000005,.
409000438620',2017-07-27,CR719812556955/RMCPL10110/1,,2017-07-27,2000.0,,-540055926.2000005,.
409000438620',2017-07-27,CR719812556999/RMCPL15913/1,,2017-07-27,1000.0,,-540056926.2000005,.
409000438620',2017-07-27,CR719813573731/RMCPL09249/1,,2017-07-27,469.0,,-540057395.2000005,.
409000438620',2017-07-27,CR719812539646/RMCPL11828/1,,2017-07-27,1000.0,,-540058395.2000005,.
409000438620',2017-07-27,CR719813570439/RMCPL06957/1,,2017-07-27,5500.0,,-540063895.2000005,.
409000438620',2017-07-27,CR719813570502/RMCPL13447/1,,2017-07-27,600.0,,-540064495.2000005,.
409000438620',2017-07-27,CR719813570597/RMCPL15002/1,,2017-07-27,4040.0,,-540068535.2000005,.
409000438620',2017-07-27,CR719814606938/RMCPL14208/1,,2017-07-27,500.0,,-540069035.2000005,.
409000438620',2017-07-27,CR719816668114/RMCPL14217/1,,2017-07-27,1900.0,,-540070935.2000005,.
409000438620',2017-07-27,CR719816668229/RMCPL07044/1,,2017-07-27,730.0,,-540071665.2000005,.
409000438620',2017-07-27,CR719816668691/RMCPL14573/1,,2017-07-27,1800.0,,-540073465.2000005,.
409000438620',2017-07-27,CR719816668722/RMCPL10449/1,,2017-07-27,100.0,,-540073565.2000005,.
409000438620',2017-07-27,CR719812554863/RMCPL15317/1,,2017-07-27,3000.0,,-540076565.2000005,.
409000438620',2017-07-27,CR719812556014/RMCPL11354/1,,2017-07-27,5000.0,,-540081565.2000005,.
409000438620',2017-07-27,CR719812555974/RMCPL11733/1,,2017-07-27,5000.0,,-540086565.2000005,.
409000438620',2017-07-27,CR719813573726/RMCPL09033/1,,2017-07-27,10000.0,,-540096565.2000005,.
409000438620',2017-07-27,CR719813573760/RMCPL10315/1,,2017-07-27,2000.0,,-540098565.2000005,.
409000438620',2017-07-27,CR719813573744/RMCPL09386/1,,2017-07-27,2020.0,,-540100585.2000005,.
409000438620',2017-07-27,CR719811514806/RMCPL16473/1,,2017-07-27,3000.0,,-540103585.2000005,.
409000438620',2017-07-27,CR719812545771/RMCPL12348/1,,2017-07-27,5000.0,,-540108585.2000005,.
409000438620',2017-07-27,CR719812545728/RMCPL12855/1,,2017-07-27,1000.0,,-540109585.2000005,.
409000438620',2017-07-27,CR719812539497/RMCPL15218/1,,2017-07-27,1000.0,,-540110585.2000005,.
409000438620',2017-07-27,CR719812544287/RMCPL09050/1,,2017-07-27,500.0,,-540111085.2000005,.
409000438620',2017-07-27,CR719812544308/RMCPL10043/1,,2017-07-27,1860.0,,-540112945.2000005,.
409000438620',2017-07-27,CR719812544337/RMCPL11590/1,,2017-07-27,210.0,,-540113155.2000005,.
409000438620',2017-07-27,CR719812544344/RMCPL14815/1,,2017-07-27,2500.0,,-540115655.2000005,.
409000438620',2017-07-27,CR719812544394/RMCPL16208/1,,2017-07-27,1000.0,,-540116655.2000005,.
409000438620',2017-07-27,CR719812544460/RMCPL09505/1,,2017-07-27,10000.0,,-540126655.2000005,.
409000438620',2017-07-27,CR719813571361/RMCPL16184/1,,2017-07-27,300.0,,-540126955.2000005,.
409000438620',2017-07-27,CR719811511922/RMCPL14443/1,,2017-07-27,600.0,,-540127555.2000005,.
409000438620',2017-07-27,CR719811511974/RMCPL09927/1,,2017-07-27,2500.0,,-540130055.2000005,.
409000438620',2017-07-27,CR719811512006/RMCPL14569/1,,2017-07-27,3000.0,,-540133055.2000005,.
409000438620',2017-07-27,CR719811511998/RMCPL15388/1,,2017-07-27,500.0,,-540133555.2000005,.
409000438620',2017-07-27,CR719811511752/RMCPL11263/1,,2017-07-27,1920.0,,-540135475.2000005,.
409000438620',2017-07-27,CR719811511817/RMCPL14470/1,,2017-07-27,2000.0,,-540137475.2000005,.
409000438620',2017-07-27,CR719811511900/RMCPL16268/1,,2017-07-27,2000.0,,-540139475.2000005,.
409000438620',2017-07-27,CR719811511905/RMCPL12671/1,,2017-07-27,2000.0,,-540141475.2000005,.
409000438620',2017-07-27,CR719811514497/RMCPL14562/1,,2017-07-27,600.0,,-540142075.2000005,.
409000438620',2017-07-27,CR719811514541/RMCPL16184/1,,2017-07-27,300.0,,-540142375.2000005,.
409000438620',2017-07-27,CR719811514613/RMCPL15416/1,,2017-07-27,200.0,,-540142575.2000005,.
409000438620',2017-07-27,CR719811514623/RMCPL11050/1,,2017-07-27,10000.0,,-540152575.2000005,.
409000438620',2017-07-27,CR719811514727/RMCPL15403/1,,2017-07-27,1000.0,,-540153575.2000005,.
409000438620',2017-07-27,CR719811514773/RMCPL09343/1,,2017-07-27,100.0,,-540153675.2000005,.
409000438620',2017-07-27,CR719811514785/RMCPL00858/1,,2017-07-27,500.0,,-540154175.2000005,.
409000438620',2017-07-27,CR719811514750/RMCPL16268/1,,2017-07-27,2000.0,,-540156175.2000005,.
409000438620',2017-07-27,CR719811514742/RMCPL12426/1,,2017-07-27,1500.0,,-540157675.2000005,.
409000438620',2017-07-27,CR719812565511/RMCPL09050/1,,2017-07-27,8500.0,,-540166175.2000005,.
409000438620',2017-07-27,CR719812556540/RMCPL14732/1,,2017-07-27,515.0,,-540166690.2000005,.
409000438620',2017-07-27,CR719812564924/RMCPL11517/1,,2017-07-27,9900.0,,-540176590.2000005,.
409000438620',2017-07-27,CR719812564921/RMCPL14126/1,,2017-07-27,9000.0,,-540185590.2000005,.
409000438620',2017-07-27,CR719811508919/RMCPL15424/1,,2017-07-27,210.0,,-540185800.2000005,.
409000438620',2017-07-27,CR719811510228/RMCPL11401/1,,2017-07-27,1000.0,,-540186800.2000005,.
409000438620',2017-07-27,CR719811510213/RMCPL13327/1,,2017-07-27,3000.0,,-540189800.2000005,.
409000438620',2017-07-27,CR719811510218/RMCPL11925/1,,2017-07-27,4080.0,,-540193880.2000005,.
409000438620',2017-07-27,CR719811514025/RMCPL09136/1,,2017-07-27,905.0,,-540194785.2000005,.
409000438620',2017-07-27,CR719812547076/RMCPL16162/1,,2017-07-27,1000.0,,-540195785.2000005,.
409000438620',2017-07-27,CR719812547184/RMCPL12861/1,,2017-07-27,1600.0,,-540197385.2000005,.
409000438620',2017-07-27,CR719812547622/RMCPL14870/1,,2017-07-27,1300.0,,-540198685.2000005,.
409000438620',2017-07-27,CR719811516051/RMCPL04407/1,,2017-07-27,2000.0,,-540200685.2000005,.
409000438620',2017-07-27,CR719811509453/RMCPL11811/1,,2017-07-27,4000.0,,-540204685.2000005,.
409000438620',2017-07-27,CR719811509459/RMCPL15699/1,,2017-07-27,1530.0,,-540206215.2000005,.
409000438620',2017-07-27,CR719811509471/RMCPL11056/1,,2017-07-27,1000.0,,-540207215.2000005,.
409000438620',2017-07-27,CR719811509481/RMCPL14597/1,,2017-07-27,2100.0,,-540209315.2000005,.
409000438620',2017-07-27,CR719811509548/RMCPL00106/1,,2017-07-27,700.0,,-540210015.2000005,.
409000438620',2017-07-27,CR719811509575/RMCPL15490/1,,2017-07-27,3500.0,,-540213515.2000005,.
409000438620',2017-07-27,CR719811509578/RMCPL00097/1,,2017-07-27,1000.0,,-540214515.2000005,.
409000438620',2017-07-27,CR719812544483/RMCPL12036/1,,2017-07-27,1400.0,,-540215915.2000005,.
409000438620',2017-07-27,CR719812544509/RMCPL13157/1,,2017-07-27,3000.0,,-540218915.2000005,.
409000438620',2017-07-27,CR719812548157/RMCPL16292/1,,2017-07-27,2500.0,,-540221415.2000005,.
409000438620',2017-07-27,CR719812548214/RMCPL11680/1,,2017-07-27,2020.0,,-540223435.2000005,.
409000438620',2017-07-27,CR719812548229/RMCPL10733/1,,2017-07-27,10000.0,,-540233435.2000005,.
409000438620',2017-07-27,CR719811512738/RMCPL13972/1,,2017-07-27,2000.0,,-540235435.2000005,.
409000438620',2017-07-27,CR719811508937/RMCPL15609/1,,2017-07-27,1500.0,,-540236935.2000005,.
409000438620',2017-07-27,CR719811527420/RMCPL15921/1,,2017-07-27,4000.0,,-540240935.2000005,.
409000438620',2017-07-27,CR719812544518/RMCPL14138/1,,2017-07-27,3000.0,,-540243935.2000005,.
409000438620',2017-07-27,CR719812555420/RMCPL15094/1,,2017-07-27,1000.0,,-540244935.2000005,.
409000438620',2017-07-27,CR719811514790/RMCPL12671/1,,2017-07-27,3100.0,,-540248035.2000005,.
409000438620',2017-07-27,CR719816665795/RMCPL12343/1,,2017-07-27,500.0,,-540248535.2000005,.
409000438620',2017-07-27,CR719816665812/RMCPL13369/1,,2017-07-27,9000.0,,-540257535.2000005,.
409000438620',2017-07-27,CR719816665821/RMCPL12838/1,,2017-07-27,300.0,,-540257835.2000005,.
409000438620',2017-07-27,CR719816665857/RMCPL16636/1,,2017-07-27,1000.0,,-540258835.2000005,.
409000438620',2017-07-27,CR719813572352/RMCPL15198/1,,2017-07-27,3050.0,,-540261885.2000005,.
409000438620',2017-07-27,CR719813572413/RMCPL15263/1,,2017-07-27,100.0,,-540261985.2000005,.
409000438620',2017-07-27,CR719911978903/RMCPL09735/1,,2017-07-27,1000.0,,-540262985.2000005,.
409000438620',2017-07-27,CR719911979551/RMCPL16442/1,,2017-07-27,2000.0,,-540264985.2000005,.
409000438620',2017-07-27,CR719911979501/RMCPL00139/1,,2017-07-27,1300.0,,-540266285.2000005,.
409000438620',2017-07-27,CR719910971961/RMCPL00529/1,,2017-07-27,500.0,,-540266785.2000005,.
409000438620',2017-07-27,CR719910971854/RMCPL15490/1,,2017-07-27,3500.0,,-540270285.2000005,.
409000438620',2017-07-27,CR719911976499/RMCPL15553/1,,2017-07-27,3000.0,,-540273285.2000005,.
409000438620',2017-07-27,CR719911993796/RMCPL11375/1,,2017-07-27,1030.0,,-540274315.2000005,.
409000438620',2017-07-27,CR719911993821/RMCPL14735/1,,2017-07-27,10000.0,,-540284315.2000005,.
409000438620',2017-07-27,CR719911995685/RMCPL09832/1,,2017-07-27,700.0,,-540285015.2000005,.
409000438620',2017-07-27,CR719911995699/RMCPL10339/1,,2017-07-27,400.0,,-540285415.2000005,.
409000438620',2017-07-27,CR719910972461/RMCPL00027/1,,2017-07-27,2000.0,,-540287415.2000005,.
409000438620',2017-07-27,CR719911994974/RMCPL14111/1,,2017-07-27,2000.0,,-540289415.2000005,.
409000438620',2017-07-27,CR719911993785/RMCPL15207/1,,2017-07-27,2500.0,,-540291915.2000005,.
409000438620',2017-07-27,CR719910974971/RMCPL13679/1,,2017-07-27,600.0,,-540292515.2000005,.
409000438620',2017-07-27,CR719910974921/RMCPL14588/1,,2017-07-27,200.0,,-540292715.2000005,.
409000438620',2017-07-27,CR719910970647/RMCPL01183/1,,2017-07-27,1000.0,,-540293715.2000005,.
409000438620',2017-07-27,CR719910971034/RMCPL02773/1,,2017-07-27,210.0,,-540293925.2000005,.
409000438620',2017-07-27,CR719910971046/RMCPL13123/1,,2017-07-27,300.0,,-540294225.2000005,.
409000438620',2017-07-27,CR719910971060/RMCPL09738/1,,2017-07-27,905.0,,-540295130.2000005,.
409000438620',2017-07-27,CR719910971330/RMCPL13364/1,,2017-07-27,5000.0,,-540300130.2000005,.
409000438620',2017-07-27,CR719911977852/RMCPL11618/1,,2017-07-27,1020.0,,-540301150.2000005,.
409000438620',2017-07-27,CR719911977828/RMCPL16117/1,,2017-07-27,1500.0,,-540302650.2000005,.
409000438620',2017-07-27,CR719911993150/RMCPL14957/1,,2017-07-27,202.0,,-540302852.2000005,.
409000438620',2017-07-27,CR719911978416/RMCPL00117/1,,2017-07-27,4500.0,,-540307352.2000005,.
409000438620',2017-07-27,CR719911978364/RMCPL16300/1,,2017-07-27,1300.0,,-540308652.2000005,.
409000438620',2017-07-27,CR719911978421/RMCPL01929/1,,2017-07-27,2000.0,,-540310652.2000005,.
409000438620',2017-07-27,CR719911993087/RMCPL00167/1,,2017-07-27,1500.0,,-540312152.2000005,.
409000438620',2017-07-27,CR719911997407/RMCPL15035/1,,2017-07-27,1500.0,,-540313652.2000005,.
409000438620',2017-07-27,CR719910974424/RMCPL12947/1,,2017-07-27,5000.0,,-540318652.2000005,.
409000438620',2017-07-27,CR719911977775/RMCPL12858/1,,2017-07-27,572.0,,-540319224.2000005,.
409000438620',2017-07-27,CR719911977785/RMCPL15907/1,,2017-07-27,5050.0,,-540324274.2000005,.
409000438620',2017-07-27,CR719911978319/RMCPL12045/1,,2017-07-27,1010.0,,-540325284.2000005,.
409000438620',2017-07-27,CR719911977864/RMCPL11611/1,,2017-07-27,110.0,,-540325394.2000005,.
409000438620',2017-07-27,CR719911998057/RMCPL15376/1,,2017-07-27,3000.0,,-540328394.2000005,.
409000438620',2017-07-27,CR719912020957/RMCPL14569/1,,2017-07-27,2000.0,,-540330394.2000005,.
409000438620',2017-07-27,CR719911977248/RMCPL09883/1,,2017-07-27,500.0,,-540330894.2000005,.
409000438620',2017-07-27,CR719911977175/RMCPL10404/1,,2017-07-27,3000.0,,-540333894.2000005,.
409000438620',2017-07-27,CR719911978919/RMCPL10236/1,,2017-07-27,1100.0,,-540334994.2000005,.
409000438620',2017-07-27,CR719911978947/RMCPL12858/1,,2017-07-27,572.0,,-540335566.2000005,.
409000438620',2017-07-27,CR719911993841/RMCPL12750/1,,2017-07-27,1838.0,,-540337404.2000005,.
409000438620',2017-07-27,CR719911993880/RMCPL15374/1,,2017-07-27,3000.0,,-540340404.2000005,.
409000438620',2017-07-27,CR719911993799/RMCPL11242/1,,2017-07-27,10000.0,,-540350404.2000005,.
409000438620',2017-07-27,CR719911994339/RMCPL10339/1,,2017-07-27,400.0,,-540350804.2000005,.
409000438620',2017-07-27,CR719910975490/RMCPL15511/1,,2017-07-27,400.0,,-540351204.2000005,.
409000438620',2017-07-27,CR719910975528/RMCPL09735/1,,2017-07-27,1000.0,,-540352204.2000005,.
409000438620',2017-07-27,CR719910975527/RMCPL13433/1,,2017-07-27,2124.0,,-540354328.2000005,.
409000438620',2017-07-27,CR719910975560/RMCPL12384/1,,2017-07-27,1200.0,,-540355528.2000005,.
409000438620',2017-07-27,CR719910973832/RMCPL11784/1,,2017-07-27,500.0,,-540356028.2000005,.
409000438620',2017-07-27,CR719910973856/RMCPL09892/1,,2017-07-27,300.0,,-540356328.2000005,.
409000438620',2017-07-27,CR719910972930/RMCPL11264/1,,2017-07-27,110.0,,-540356438.2000005,.
409000438620',2017-07-27,CR719910972949/RMCPL15590/1,,2017-07-27,1000.0,,-540357438.2000005,.
409000438620',2017-07-27,CR719912021757/RMCPL16179/1,,2017-07-27,800.0,,-540358238.2000005,.
409000438620',2017-07-27,CR719912021853/RMCPL10823/1,,2017-07-27,2100.0,,-540360338.2000005,.
409000438620',2017-07-27,CR719912021847/RMCPL13525/1,,2017-07-27,1200.0,,-540361538.2000005,.
409000438620',2017-07-27,CR719911993233/RMCPL10689/1,,2017-07-27,1000.0,,-540362538.2000005,.
409000438620',2017-07-27,CR719911993276/RMCPL06758/1,,2017-07-27,8150.0,,-540370688.2000005,.
409000438620',2017-07-27,CR719912021545/RMCPL15030/1,,2017-07-27,2000.0,,-540372688.2000005,.
409000438620',2017-07-27,CR719911996282/RMCPL10759/1,,2017-07-27,10000.0,,-540382688.2000005,.
409000438620',2017-07-27,CR719911996329/RMCPL12636/1,,2017-07-27,500.0,,-540383188.2000005,.
409000438620',2017-07-27,CR719911976495/RMCPL09735/1,,2017-07-27,1000.0,,-540384188.2000005,.
409000438620',2017-07-27,CR719913054448/RMCPL13561/1,,2017-07-27,730.0,,-540384918.2000005,.
409000438620',2017-07-27,CR719910972966/RMCPL13490/1,,2017-07-27,10000.0,,-540394918.2000005,.
409000438620',2017-07-27,CR719910973134/RMCPL15019/1,,2017-07-27,100.0,,-540395018.2000005,.
409000438620',2017-07-27,CR720015585815/RMCPL16268/1,,2017-07-27,2000.0,,-540397018.2000005,.
409000438620',2017-07-27,CR720013529403/RMCPL13837/1,,2017-07-27,400.0,,-540397418.2000005,.
409000438620',2017-07-27,CR720015585821/RMCPL01724/1,,2017-07-27,2000.0,,-540399418.2000005,.
409000438620',2017-07-27,CR720015585878/RMCPL06719/1,,2017-07-27,10000.0,,-540409418.2000005,.
409000438620',2017-07-27,CR720018658604/RMCPL09701/1,,2017-07-27,220.0,,-540409638.2000005,.
409000438620',2017-07-27,CR720018658531/RMCPL13891/1,,2017-07-27,200.0,,-540409838.2000005,.
409000438620',2017-07-27,CR720018670201/RMCPL16403/1,,2017-07-27,600.0,,-540410438.2000005,.
409000438620',2017-07-27,CR720015586666/RMCPL11759/1,,2017-07-27,900.0,,-540411338.2000005,.
409000438620',2017-07-27,CR720013531744/RMCPL09821/1,,2017-07-27,1000.0,,-540412338.2000005,.
409000438620',2017-07-27,CR720017629541/RMCPL12201/1,,2017-07-27,500.0,,-540412838.2000005,.
409000438620',2017-07-27,AEPS Indiaforensic INCOME 260717,,2017-07-27,,98092.36,-540314745.8400005,.
409000438620',2017-07-27,AEPS Indiaforensic GST 260717,,2017-07-27,,17656.62,-540297089.2200005,.
409000438620',2017-07-28,AEPS ACQUIRING ADJ FEES 2,,2017-07-28,17.7,,-540297106.9200006,.
409000438620',2017-07-28,AEPS Indiaforensic INCOME 270717,,2017-07-28,,100148.55,-540196958.3700006,.
409000438620',2017-07-28,AEPS Indiaforensic GST 270717,,2017-07-28,,18026.74,-540178931.6300006,.
409000438620',2017-07-28,Indiaforensic AEPS NPCI WDL SET,,2017-07-28,,23935709.0,-516243222.6300006,.
409000438620',2017-07-28,Indfor-RIF AEPS NPCI WDL SET,,2017-07-28,,10200.0,-516233022.6300006,.
409000438620',2017-07-28,Indiaforensic AEPS NPCI DEP SET,,2017-07-28,16453044.0,,-532686066.6300006,.
409000438620',2017-07-28,TRF TO  Indiaforensic SERVICES I,,2017-07-28,6000000.0,,-538686066.6300006,.
409000438620',2017-07-28,TRF TO  Indiaforensic SERVICES I,,2017-07-28,4000000.0,,-542686066.6300006,.
409000438620',2017-07-28,TRF TO  Indiaforensic SERVICES I,,2017-07-28,3000000.0,,-545686066.6300006,.
409000438620',2017-07-29,AEPS ACQ REP ADJ FEES 280,,2017-07-29,,21.83,-545686044.8000005,.
409000438620',2017-07-29,AEPS Indiaforensic INCOME 280717,,2017-07-29,,99118.75,-545586926.0500005,.
409000438620',2017-07-29,AEPS Indiaforensic S TAX 280717,,2017-07-29,,17841.38,-545569084.6700006,.
409000438620',2017-07-29,Indiaforensic AEPS NPCI WDL SET,,2017-07-29,,24216368.0,-521352716.67000055,.
409000438620',2017-07-29,Indiaforensic AEPS NPCI DEP SET,,2017-07-29,15910000.0,,-537262716.6700006,.
409000438620',2017-07-29,TRANSFER TO  Indiaforensic SERVI,,2017-07-29,5000000.0,,-542262716.6700006,.
409000438620',2017-07-29,TRANSFER TO  Indiaforensic SERVI,,2017-07-29,4000000.0,,-546262716.6700006,.
409000438620',2017-07-31,AEPS Indiaforensic INCOME 290717,,2017-07-31,,96155.48,-546166561.1900005,.
409000438620',2017-07-31,AEPS Indiaforensic GST 290717,,2017-07-31,,17307.99,-546149253.2000005,.
409000438620',2017-07-31,AEPS Indiaforensic INCOME 300717,,2017-07-31,,78204.05,-546071049.1500006,.
409000438620',2017-07-31,AEPS Indiaforensic GST 300717,,2017-07-31,,14076.73,-546056972.4200006,.
409000438620',2017-07-31,Indiaforensic AEPS NPCI WDL SET,,2017-07-31,,22068374.0,-523988598.42000055,.
409000438620',2017-07-31,Indiaforensic AEPS NPCI WDL SET,,2017-07-31,,18764648.0,-505223950.42000055,.
409000438620',2017-07-31,Indiaforensic AEPS NPCI DEP SET,,2017-07-31,16653397.0,,-521877347.42000055,.
409000438620',2017-07-31,Indiaforensic AEPS NPCI DEP SET,,2017-07-31,11579285.0,,-533456632.42000055,.
409000438620',2017-08-01,TRF TO  Indiaforensic SERVICES I,,2017-08-01,12800000.0,,-546256632.4200006,.
409000438620',2017-08-01,AEPS ACQUIRING ADJ FEES 3,,2017-08-01,20.85,,-546256653.2700006,.
409000438620',2017-08-01,AEPS Indiaforensic INCOME 310717,,2017-08-01,,105013.48,-546151639.7900006,.
409000438620',2017-08-01,AEPS Indiaforensic S TAX 310717,,2017-08-01,,18902.43,-546132737.3600006,.
409000438620',2017-08-01,Indiaforensic AEPS NPCI WDL SET,,2017-08-01,,25007612.0,-521125125.3600006,.
409000438620',2017-08-01,Indiaforensic AEPS NPCI DEP SET,,2017-08-01,16471915.0,,-537597040.3600006,.
409000438620',2017-08-02,AEPS ACQUIRING ADJ FEES 0,,2017-08-02,17.7,,-537597058.0600007,.
409000438620',2017-08-02,CB720117127904/RMCPL10016/2,,2017-08-02,400.0,,-537597458.0600007,.
409000438620',2017-08-02,CB720211438787/RMCPL16684/2,,2017-08-02,6500.0,,-537603958.0600007,.
409000438620',2017-08-02,AEPS Indiaforensic INCOME 010817,,2017-08-02,,100215.4,-537503742.6600007,.
409000438620',2017-08-02,AEPS Indiaforensic S TAX 010817,,2017-08-02,,18038.77,-537485703.8900007,.
409000438620',2017-08-02,TRANSFER TO  Indiaforensic SERVI,,2017-08-02,8100000.0,,-545585703.8900007,.
409000438620',2017-08-02,Indiaforensic AEPS NPCI WDL SET,,2017-08-02,,24209449.0,-521376254.8900007,.
409000438620',2017-08-02,Indfor RIF AEPS NPCI WDL SET,,2017-08-02,,10000.0,-521366254.8900007,.
409000438620',2017-08-02,Indiaforensic AEPS NPCI DEP SET,,2017-08-02,15794190.0,,-537160444.8900007,.
409000438620',2017-08-03,TRF TO  Indiaforensic SERVICES I,,2017-08-03,9100000.0,,-546260444.8900007,.
409000438620',2017-08-03,AEPS Indiaforensic INCOME 020817,,2017-08-03,,96852.95,-546163591.9400007,.
409000438620',2017-08-03,AEPS Indiaforensic GST 020817,,2017-08-03,,17433.53,-546146158.4100007,.
409000438620',2017-08-03,Indiaforensic AEPS NPCI WDL SET,,2017-08-03,,22482724.0,-523663434.4100007,.
409000438620',2017-08-03,Indfor RIF AEPS NPCI WDL SET,,2017-08-03,,20000.0,-523643434.4100007,.
409000438620',2017-08-03,Indiaforensic AEPS NPCI DEP SET,,2017-08-03,15400189.0,,-539043623.4100007,.
409000438620',2017-08-04,TRF TO  Indiaforensic SERVICES I,,2017-08-04,7200000.0,,-546243623.4100007,.
409000438620',2017-08-04,Indiaforensic AEPS NPCI WDL SET,,2017-08-04,,28178778.0,-518064845.4100007,.
409000438620',2017-08-04,Indiaforensic AEPS NPCI DEP SET,,2017-08-04,19593478.0,,-537658323.4100007,.
409000438620',2017-08-04,AEPS ACQUIRING ADJ FEES 0,,2017-08-04,17.7,,-537658341.1100007,.
409000438620',2017-08-04,AEPS ACQ CR ADJ FEES 0308,,2017-08-04,1690.8,,-537660031.9100007,.
409000438620',2017-08-04,CR720117129736/RMCPL13918/2,,2017-08-04,1200.0,,-537661231.9100007,.
409000438620',2017-08-04,CR720117110312/RMCPL11402/2,,2017-08-04,2500.0,,-537663731.9100007,.
409000438620',2017-08-04,CR720118136593/RMCPL15905/2,,2017-08-04,1000.0,,-537664731.9100007,.
409000438620',2017-08-04,CR720118136589/RMCPL15584/2,,2017-08-04,1000.0,,-537665731.9100007,.
409000438620',2017-08-04,CR720118137110/RMCPL10371/2,,2017-08-04,5900.0,,-537671631.9100007,.
409000438620',2017-08-04,CR720118134931/RMCPL13913/2,,2017-08-04,10000.0,,-537681631.9100007,.
409000438620',2017-08-04,CR720118134948/RMCPL12441/2,,2017-08-04,300.0,,-537681931.9100007,.
409000438620',2017-08-04,CR720118135007/RMCPL09509/2,,2017-08-04,4000.0,,-537685931.9100007,.
409000438620',2017-08-04,CR720117130794/RMCPL09509/2,,2017-08-04,4000.0,,-537689931.9100007,.
409000438620',2017-08-04,CR720117130791/RMCPL10360/2,,2017-08-04,700.0,,-537690631.9100007,.
409000438620',2017-08-04,CR720117130807/RMCPL10987/2,,2017-08-04,500.0,,-537691131.9100007,.
409000438620',2017-08-04,CR720117130873/RMCPL13157/2,,2017-08-04,3000.0,,-537694131.9100007,.
409000438620',2017-08-04,CR720118137208/RMCPL03223/2,,2017-08-04,1000.0,,-537695131.9100007,.
409000438620',2017-08-04,CR720118137275/RMCPL10086/2,,2017-08-04,200.0,,-537695331.9100007,.
409000438620',2017-08-04,CR720118138507/RMCPL14817/2,,2017-08-04,5000.0,,-537700331.9100007,.
409000438620',2017-08-04,CR720117114130/RMCPL14875/2,,2017-08-04,1000.0,,-537701331.9100007,.
409000438620',2017-08-04,CR720117102176/RMCPL09101/2,,2017-08-04,3000.0,,-537704331.9100007,.
409000438620',2017-08-04,CR720117102212/RMCPL15997/2,,2017-08-04,6000.0,,-537710331.9100007,.
409000438620',2017-08-04,CR720117102263/RMCPL11624/2,,2017-08-04,10000.0,,-537720331.9100007,.
409000438620',2017-08-04,CR720117129596/RMCPL09999/2,,2017-08-04,2530.0,,-537722861.9100007,.
409000438620',2017-08-04,CR720117129679/RMCPL13432/2,,2017-08-04,1000.0,,-537723861.9100007,.
409000438620',2017-08-04,CR720117114032/RMCPL10107/2,,2017-08-04,10000.0,,-537733861.9100007,.
409000438620',2017-08-04,CR720117114081/RMCPL09112/2,,2017-08-04,3000.0,,-537736861.9100007,.
409000438620',2017-08-04,CR720115060957/RMCPL16364/2,,2017-08-04,8500.0,,-537745361.9100007,.
409000438620',2017-08-04,CR720115064914/RMCPL08345/2,,2017-08-04,405.0,,-537745766.9100007,.
409000438620',2017-08-04,CR720117125867/RMCPL12170/2,,2017-08-04,2250.0,,-537748016.9100007,.
409000438620',2017-08-04,CR720117125934/RMCPL10689/2,,2017-08-04,10000.0,,-537758016.9100007,.
409000438620',2017-08-04,CR720117125911/RMCPL15374/2,,2017-08-04,1000.0,,-537759016.9100007,.
409000438620',2017-08-04,CR720118142694/RMCPL13753/2,,2017-08-04,100.0,,-537759116.9100007,.
409000438620',2017-08-04,CR720118142852/RMCPL15361/2,,2017-08-04,4000.0,,-537763116.9100007,.
409000438620',2017-08-04,CR720117129458/RMCPL12512/2,,2017-08-04,100.0,,-537763216.9100007,.
409000438620',2017-08-04,CR720117129543/RMCPL10987/2,,2017-08-04,500.0,,-537763716.9100007,.
409000438620',2017-08-04,CR720117129562/RMCPL00198/2,,2017-08-04,100.0,,-537763816.9100007,.
409000438620',2017-08-04,CR720118142666/RMCPL14902/2,,2017-08-04,1000.0,,-537764816.9100007,.
409000438620',2017-08-04,CR720112993019/RMCPL16109/2,,2017-08-04,3000.0,,-537767816.9100007,.
409000438620',2017-08-04,CR720117130573/RMCPL00010/2,,2017-08-04,3000.0,,-537770816.9100007,.
409000438620',2017-08-04,CR720117110437/RMCPL15144/2,,2017-08-04,500.0,,-537771316.9100007,.
409000438620',2017-08-04,CR720115067109/RMCPL12838/2,,2017-08-04,600.0,,-537771916.9100007,.
409000438620',2017-08-04,CR720117106114/RMCPL13536/2,,2017-08-04,10000.0,,-537781916.9100007,.
409000438620',2017-08-04,CR720116076188/RMCPL13301/2,,2017-08-04,200.0,,-537782116.9100007,.
409000438620',2017-08-04,CR720117129702/RMCPL14366/2,,2017-08-04,5000.0,,-537787116.9100007,.
409000438620',2017-08-04,CR720115064801/RMCPL11943/2,,2017-08-04,5060.0,,-537792176.9100007,.
409000438620',2017-08-04,CR720115064852/RMCPL16407/2,,2017-08-04,500.0,,-537792676.9100007,.
409000438620',2017-08-04,CR720112989703/RMCPL15400/2,,2017-08-04,8000.0,,-537800676.9100007,.
409000438620',2017-08-04,CR720117127888/RMCPL12720/2,,2017-08-04,9900.0,,-537810576.9100007,.
409000438620',2017-08-04,CR720117127860/RMCPL13340/2,,2017-08-04,10000.0,,-537820576.9100007,.
409000438620',2017-08-04,CR720117109410/RMCPL16286/2,,2017-08-04,500.0,,-537821076.9100007,.
409000438620',2017-08-04,CR720117109426/RMCPL11158/2,,2017-08-04,1000.0,,-537822076.9100007,.
409000438620',2017-08-04,CR720112989660/RMCPL09033/2,,2017-08-04,4420.0,,-537826496.9100007,.
409000438620',2017-08-04,CR720112989767/RMCPL16011/2,,2017-08-04,8000.0,,-537834496.9100007,.
409000438620',2017-08-04,CR720112989808/RMCPL15905/2,,2017-08-04,1700.0,,-537836196.9100007,.
409000438620',2017-08-04,CR720112990620/RMCPL02216/2,,2017-08-04,1000.0,,-537837196.9100007,.
409000438620',2017-08-04,CR720117129408/RMCPL00527/2,,2017-08-04,1000.0,,-537838196.9100007,.
409000438620',2017-08-04,CR720112990623/RMCPL15356/2,,2017-08-04,2000.0,,-537840196.9100007,.
409000438620',2017-08-04,CR720118136426/RMCPL00271/2,,2017-08-04,2000.0,,-537842196.9100007,.
409000438620',2017-08-04,CR720118136456/RMCPL15915/2,,2017-08-04,500.0,,-537842696.9100007,.
409000438620',2017-08-04,CR720118136506/RMCPL15231/2,,2017-08-04,3000.0,,-537845696.9100007,.
409000438620',2017-08-04,CR720118135167/RMCPL15803/2,,2017-08-04,1300.0,,-537846996.9100007,.
409000438620',2017-08-04,CR720118136417/RMCPL09022/2,,2017-08-04,100.0,,-537847096.9100007,.
409000438620',2017-08-04,CR720117112636/RMCPL13340/2,,2017-08-04,500.0,,-537847596.9100007,.
409000438620',2017-08-04,CR720117112650/RMCPL12666/2,,2017-08-04,120.0,,-537847716.9100007,.
409000438620',2017-08-04,CR720117112687/RMCPL02162/2,,2017-08-04,1000.0,,-537848716.9100007,.
409000438620',2017-08-04,CR720115067046/RMCPL09050/2,,2017-08-04,1000.0,,-537849716.9100007,.
409000438620',2017-08-04,CR720117130574/RMCPL02803/2,,2017-08-04,1010.0,,-537850726.9100007,.
409000438620',2017-08-04,CR720117113957/RMCPL15891/2,,2017-08-04,2630.0,,-537853356.9100007,.
409000438620',2017-08-04,CR720112991130/RMCPL11213/2,,2017-08-04,4000.0,,-537857356.9100007,.
409000438620',2017-08-04,CR720112991157/RMCPL13343/2,,2017-08-04,1000.0,,-537858356.9100007,.
409000438620',2017-08-04,CR720511836413/RMCPL16144/2,,2017-08-04,1000.0,,-537859356.9100007,.
409000438620',2017-08-04,CR720511836427/RMCPL12844/2,,2017-08-04,1100.0,,-537860456.9100007,.
409000438620',2017-08-04,CR720512863677/RMCPL10638/2,,2017-08-04,10000.0,,-537870456.9100007,.
409000438620',2017-08-04,CR720512867320/RMCPL13637/2,,2017-08-04,3000.0,,-537873456.9100007,.
409000438620',2017-08-04,CR720512867419/RMCPL10638/2,,2017-08-04,5000.0,,-537878456.9100007,.
409000438620',2017-08-04,CR720512880833/RMCPL13363/2,,2017-08-04,410.0,,-537878866.9100007,.
409000438620',2017-08-04,CR720512880837/RMCPL09973/2,,2017-08-04,500.0,,-537879366.9100007,.
409000438620',2017-08-04,CR720512859304/RMCPL14954/2,,2017-08-04,1500.0,,-537880866.9100007,.
409000438620',2017-08-04,CR720513887555/RMCPL10797/2,,2017-08-04,2000.0,,-537882866.9100007,.
409000438620',2017-08-04,CR720511836496/RMCPL12440/2,,2017-08-04,1010.0,,-537883876.9100007,.
409000438620',2017-08-04,CR720511836507/RMCPL11253/2,,2017-08-04,300.0,,-537884176.9100007,.
409000438620',2017-08-04,CR720511836513/RMCPL13879/2,,2017-08-04,2000.0,,-537886176.9100007,.
409000438620',2017-08-04,CR720511836533/RMCPL00010/2,,2017-08-04,2000.0,,-537888176.9100007,.
409000438620',2017-08-04,CR720511836642/RMCPL12201/2,,2017-08-04,5000.0,,-537893176.9100007,.
409000438620',2017-08-04,CR720511836582/RMCPL13028/2,,2017-08-04,510.0,,-537893686.9100007,.
409000438620',2017-08-04,CR720511836648/RMCPL15827/2,,2017-08-04,600.0,,-537894286.9100007,.
409000438620',2017-08-04,CR720512859294/RMCPL16323/2,,2017-08-04,4000.0,,-537898286.9100007,.
409000438620',2017-08-04,CR720512877532/RMCPL09808/2,,2017-08-04,7000.0,,-537905286.9100007,.
409000438620',2017-08-04,CR720512877554/RMCPL12168/2,,2017-08-04,700.0,,-537905986.9100007,.
409000438620',2017-08-04,CR720513911462/RMCPL16873/2,,2017-08-04,10000.0,,-537915986.9100007,.
409000438620',2017-08-04,CR720513910295/RMCPL15030/2,,2017-08-04,1600.0,,-537917586.9100007,.
409000438620',2017-08-04,CR720512853691/RMCPL09207/2,,2017-08-04,1000.0,,-537918586.9100007,.
409000438620',2017-08-04,CR720511852525/RMCPL15534/2,,2017-08-04,5000.0,,-537923586.9100007,.
409000438620',2017-08-04,CR720517014014/RMCPL10086/2,,2017-08-04,100.0,,-537923686.9100007,.
409000438620',2017-08-04,CR720513897364/RMCPL16492/2,,2017-08-04,200.0,,-537923886.9100007,.
409000438620',2017-08-04,CR720513896554/RMCPL15520/2,,2017-08-04,5000.0,,-537928886.9100007,.
409000438620',2017-08-04,CR720511851970/RMCPL13637/2,,2017-08-04,4000.0,,-537932886.9100007,.
409000438620',2017-08-04,CR720512854259/RMCPL13830/2,,2017-08-04,10000.0,,-537942886.9100007,.
409000438620',2017-08-04,CR720512854281/RMCPL11800/2,,2017-08-04,1500.0,,-537944386.9100007,.
409000438620',2017-08-04,CR720512865560/RMCPL00322/2,,2017-08-04,300.0,,-537944686.9100007,.
409000438620',2017-08-04,CR720512865643/RMCPL00111/2,,2017-08-04,9600.0,,-537954286.9100007,.
409000438620',2017-08-04,CR720514915449/RMCPL16686/2,,2017-08-04,1500.0,,-537955786.9100007,.
409000438620',2017-08-04,CR720514915478/RMCPL10817/2,,2017-08-04,5000.0,,-537960786.9100007,.
409000438620',2017-08-04,CR720514916430/RMCPL15884/2,,2017-08-04,3000.0,,-537963786.9100007,.
409000438620',2017-08-04,CR720211438814/RMCPL11216/2,,2017-08-04,1000.0,,-537964786.9100007,.
409000438620',2017-08-04,CR720211438819/RMCPL15905/2,,2017-08-04,3000.0,,-537967786.9100007,.
409000438620',2017-08-04,CR720211439536/RMCPL10439/2,,2017-08-04,197.0,,-537967983.9100007,.
409000438620',2017-08-04,CR720216571714/RMCPL11787/2,,2017-08-04,500.0,,-537968483.9100007,.
409000438620',2017-08-04,CR720216571718/RMCPL13536/2,,2017-08-04,10000.0,,-537978483.9100007,.
409000438620',2017-08-04,CR720216592171/RMCPL15254/2,,2017-08-04,3000.0,,-537981483.9100007,.
409000438620',2017-08-04,CR720216572319/RMCPL16652/2,,2017-08-04,900.0,,-537982383.9100007,.
409000438620',2017-08-04,CR720216572345/RMCPL16411/2,,2017-08-04,5000.0,,-537987383.9100007,.
409000438620',2017-08-04,CR720216572805/RMCPL09125/2,,2017-08-04,5000.0,,-537992383.9100007,.
409000438620',2017-08-04,CR720216594891/RMCPL16721/2,,2017-08-04,100.0,,-537992483.9100007,.
409000438620',2017-08-04,CR720216594942/RMCPL10987/2,,2017-08-04,300.0,,-537992783.9100007,.
409000438620',2017-08-04,CR720217595932/RMCPL09999/2,,2017-08-04,510.0,,-537993293.9100007,.
409000438620',2017-08-04,CR720211442237/RMCPL00102/2,,2017-08-04,10000.0,,-538003293.9100007,.
409000438620',2017-08-04,CR720211442224/RMCPL12626/2,,2017-08-04,9000.0,,-538012293.9100007,.
409000438620',2017-08-04,CR720211442649/RMCPL13453/2,,2017-08-04,1000.0,,-538013293.9100007,.
409000438620',2017-08-04,CR720211442186/RMCPL13771/2,,2017-08-04,1500.0,,-538014793.9100007,.
409000438620',2017-08-04,CR720211442202/RMCPL14577/2,,2017-08-04,10000.0,,-538024793.9100007,.
409000438620',2017-08-04,CR720212452692/RMCPL14040/2,,2017-08-04,500.0,,-538025293.9100007,.
409000438620',2017-08-04,CR720211441619/RMCPL11442/2,,2017-08-04,5000.0,,-538030293.9100007,.
409000438620',2017-08-04,CR720211442656/RMCPL13808/2,,2017-08-04,3000.0,,-538033293.9100007,.
409000438620',2017-08-04,CR720211439271/RMCPL16113/2,,2017-08-04,500.0,,-538033793.9100007,.
409000438620',2017-08-04,CR720211445038/RMCPL16770/2,,2017-08-04,8000.0,,-538041793.9100007,.
409000438620',2017-08-04,CR720211445052/RMCPL14374/2,,2017-08-04,3000.0,,-538044793.9100007,.
409000438620',2017-08-04,CR720214515208/RMCPL16356/2,,2017-08-04,4000.0,,-538048793.9100007,.
409000438620',2017-08-04,CR720211444554/RMCPL13176/2,,2017-08-04,7500.0,,-538056293.9100007,.
409000438620',2017-08-04,CR720212480859/RMCPL03038/2,,2017-08-04,2550.0,,-538058843.9100007,.
409000438620',2017-08-04,CR720211443877/RMCPL00198/2,,2017-08-04,5000.0,,-538063843.9100007,.
409000438620',2017-08-04,CR720211439356/RMCPL13160/2,,2017-08-04,5000.0,,-538068843.9100007,.
409000438620',2017-08-04,CR720211436254/RMCPL10735/2,,2017-08-04,1000.0,,-538069843.9100007,.
409000438620',2017-08-04,CR720211436922/RMCPL00150/2,,2017-08-04,1100.0,,-538070943.9100007,.
409000438620',2017-08-04,CR720211437566/RMCPL12814/2,,2017-08-04,1000.0,,-538071943.9100007,.
409000438620',2017-08-04,CR720211436134/RMCPL13699/2,,2017-08-04,1000.0,,-538072943.9100007,.
409000438620',2017-08-04,CR720211436140/RMCPL13831/2,,2017-08-04,500.0,,-538073443.9100007,.
409000438620',2017-08-04,CR720211438107/RMCPL12870/2,,2017-08-04,5000.0,,-538078443.9100007,.
409000438620',2017-08-04,CR720211439350/RMCPL15213/2,,2017-08-04,200.0,,-538078643.9100007,.
409000438620',2017-08-04,CR720214515746/RMCPL14662/2,,2017-08-04,5000.0,,-538083643.9100007,.
409000438620',2017-08-04,CR720211436798/RMCPL14175/2,,2017-08-04,3000.0,,-538086643.9100007,.
409000438620',2017-08-04,CR720211438045/RMCPL11678/2,,2017-08-04,575.0,,-538087218.9100007,.
409000438620',2017-08-04,CR720211439396/RMCPL07629/2,,2017-08-04,5000.0,,-538092218.9100007,.
409000438620',2017-08-04,CR720211440404/RMCPL09883/2,,2017-08-04,5000.0,,-538097218.9100007,.
409000438620',2017-08-04,CR720211441043/RMCPL15907/2,,2017-08-04,6000.0,,-538103218.9100007,.
409000438620',2017-08-04,CR720211441033/RMCPL13128/2,,2017-08-04,8500.0,,-538111718.9100007,.
409000438620',2017-08-04,CR720211441055/RMCPL11793/2,,2017-08-04,510.0,,-538112228.9100007,.
409000438620',2017-08-04,CR720211443305/RMCPL12671/2,,2017-08-04,1000.0,,-538113228.9100007,.
409000438620',2017-08-04,CR720211443361/RMCPL13473/2,,2017-08-04,500.0,,-538113728.9100007,.
409000438620',2017-08-04,CR720211438044/RMCPL00093/2,,2017-08-04,10000.0,,-538123728.9100007,.
409000438620',2017-08-04,CR720211438079/RMCPL11788/2,,2017-08-04,600.0,,-538124328.9100007,.
409000438620',2017-08-04,CR720211440528/RMCPL10778/2,,2017-08-04,2000.0,,-538126328.9100007,.
409000438620',2017-08-04,CR720211440469/RMCPL10102/2,,2017-08-04,2730.0,,-538129058.9100007,.
409000438620',2017-08-04,AEPS ACQ REP ADJ FEES 030,,2017-08-04,,18.49,-538129040.4200007,.
409000438620',2017-08-04,CR720211441119/RMCPL16517/2,,2017-08-04,5000.0,,-538134040.4200007,.
409000438620',2017-08-04,CR720211441145/RMCPL11028/2,,2017-08-04,500.0,,-538134540.4200007,.
409000438620',2017-08-04,CR720211438103/RMCPL11800/2,,2017-08-04,300.0,,-538134840.4200007,.
409000438620',2017-08-04,CR720211438102/RMCPL03223/2,,2017-08-04,2000.0,,-538136840.4200007,.
409000438620',2017-08-04,CR720211438173/RMCPL13566/2,,2017-08-04,730.0,,-538137570.4200007,.
409000438620',2017-08-04,CR720211441550/RMCPL14772/2,,2017-08-04,2000.0,,-538139570.4200007,.
409000438620',2017-08-04,CR720211441624/RMCPL15905/2,,2017-08-04,100.0,,-538139670.4200007,.
409000438620',2017-08-04,CR720211438178/RMCPL11442/2,,2017-08-04,5000.0,,-538144670.4200007,.
409000438620',2017-08-04,CR720211438270/RMCPL14343/2,,2017-08-04,200.0,,-538144870.4200007,.
409000438620',2017-08-04,CR720211438781/RMCPL11966/2,,2017-08-04,2100.0,,-538146970.4200007,.
409000438620',2017-08-04,AEPS Indiaforensic INCOME 030817,,2017-08-04,,121117.09,-538025853.3300006,.
409000438620',2017-08-04,AEPS Indiaforensic GST 030817,,2017-08-04,,21801.08,-538004052.2500006,.
409000438620',2017-08-05,TRF TO  Indiaforensic SERVICES I,,2017-08-05,5000000.0,,-543004052.2500006,.
409000438620',2017-08-05,TRF TO  Indiaforensic SERVICES I,,2017-08-05,3000000.0,,-546004052.2500006,.
409000438620',2017-08-05,CB721211952406/RMCPL14457/3,,2017-08-05,10000.0,,-546014052.2500006,.
409000438620',2017-08-05,AEPS Indiaforensic INCOME 040817,,2017-08-05,,130792.84,-545883259.4100006,.
409000438620',2017-08-05,AEPS Indiaforensic GST 040817,,2017-08-05,,23542.71,-545859716.7000005,.
409000438620',2017-08-05,Indiaforensic AEPS NPCI WDL SET,,2017-08-05,,31410774.0,-514448942.7000005,.
409000438620',2017-08-05,Indiaforensic AEPS NPCI DEP SET,,2017-08-05,20669390.0,,-535118332.7000005,.
409000438620',2017-08-07,TRF TO  Indiaforensic SERVICES I,,2017-08-07,1000000.0,,-536118332.7000005,.
409000438620',2017-08-07,TRF TO  Indiaforensic SERVICES I,,2017-08-07,5000000.0,,-541118332.7000005,.
409000438620',2017-08-07,TRF TO  Indiaforensic SERVICES I,,2017-08-07,5000000.0,,-546118332.7000005,.
409000438620',2017-08-07,Indiaforensic AEPS NPCI WDL SET,,2017-08-07,,33359459.0,-512758873.7000005,.
409000438620',2017-08-07,Indfor RIF AEPS NPCI WDL SET,,2017-08-07,,2000.0,-512756873.7000005,.
409000438620',2017-08-07,Indiaforensic AEPS NPCI WDL SET,,2017-08-07,,23605495.0,-489151378.7000005,.
409000438620',2017-08-07,AEPS ACQUIRING ADJ FEES 0,,2017-08-07,17.7,,-489151396.4000005,.
409000438620',2017-08-07,AEPS Indiaforensic INCOME 050817,,2017-08-07,,137519.03,-489013877.37000054,.
409000438620',2017-08-07,AEPS Indiaforensic GST 050817,,2017-08-07,,24753.43,-488989123.94000053,.
409000438620',2017-08-07,AEPS Indiaforensic INCOME 060817,,2017-08-07,,96358.28,-488892765.66000056,.
409000438620',2017-08-07,AEPS Indiaforensic GST 060817,,2017-08-07,,17344.49,-488875421.17000055,.
409000438620',2017-08-07,Indiaforensic AEPS NPCI DEP SET,,2017-08-07,21311890.0,,-510187311.17000055,.
409000438620',2017-08-07,Indiaforensic AEPS NPCI DEP SET,,2017-08-07,14228208.0,,-524415519.17000055,.
409000438620',2017-08-07,TRANSFER TO  Indiaforensic SERVI,,2017-08-07,4000000.0,,-528415519.17000055,.
409000438620',2017-08-07,TRANSFER TO  Indiaforensic SERVI,,2017-08-07,4000000.0,,-532415519.17000055,.
409000438620',2017-08-08,TRF TO  Indiaforensic SERVICES I,,2017-08-08,13800000.0,,-546215519.1700006,.
409000438620',2017-08-08,CB721311502784/RMCPL16004/0,,2017-08-08,3000.0,,-546218519.1700006,.
409000438620',2017-08-08,AEPS Indiaforensic INCOME 070817,,2017-08-08,,90857.69,-546127661.4800005,.
409000438620',2017-08-08,AEPS Indiaforensic GST 070817,,2017-08-08,,16354.38,-546111307.1000005,.
409000438620',2017-08-08,Indiaforensic AEPS NPCI WDL SET,,2017-08-08,,21357861.0,-524753446.1000005,.
409000438620',2017-08-08,Indiaforensic AEPS NPCI DEP SET,,2017-08-08,14706800.0,,-539460246.1000005,.
409000438620',2017-08-08,TRF TO  Indiaforensic SERVICES I,,2017-08-08,2000000.0,,-541460246.1000005,.
409000438620',2017-08-08,TRANSFER FROM  Indiaforensic SER,,2017-08-08,3000000.0,,-544460246.1000005,.
409000438620',2017-08-09,AEPS Indiaforensic INCOME 080817,,2017-08-09,,122256.32,-544337989.7800004,.
409000438620',2017-08-09,AEPS Indiaforensic GST 080817,,2017-08-09,,22006.14,-544315983.6400005,.
409000438620',2017-08-09,Indiaforensic AEPS NPCI WDL SET,,2017-08-09,,30216246.0,-514099737.64000046,.
409000438620',2017-08-09,Indiaforensic AEPS NPCI DEP SET,,2017-08-09,18787967.0,,-532887704.64000046,.
409000438620',2017-08-09,TRF TO  Indiaforensic SERVICES I,,2017-08-09,13400000.0,,-546287704.6400005,.
409000438620',2017-08-10,AEPS Indiaforensic INCOME 090817,,2017-08-10,,128213.58,-546159491.0600004,.
409000438620',2017-08-10,AEPS Indiaforensic GST 090817,,2017-08-10,,23078.44,-546136412.6200004,.
409000438620',2017-08-10,Indiaforensic AEPS NPCI WDL SET,,2017-08-10,,31461719.0,-514674693.62000036,.
409000438620',2017-08-10,Indiaforensic AEPS NPCI DEP SET,,2017-08-10,20946645.0,,-535621338.62000036,.
409000438620',2017-08-10,TRF TO  Indiaforensic SERVICES I,,2017-08-10,10600000.0,,-546221338.6200004,.
409000438620',2017-08-11,AEPS ACQUIRING ADJ FEES 1,,2017-08-11,11.8,,-546221350.4200003,.
409000438620',2017-08-11,AEPS Indiaforensic INCOME 100817,,2017-08-11,,119245.33,-546102105.0900003,.
409000438620',2017-08-11,AEPS Indiaforensic GST 100817,,2017-08-11,,21464.16,-546080640.9300003,.
409000438620',2017-08-11,Indiaforensic AEPS NPCI WDL SET,,2017-08-11,,29386344.0,-516694296.9300003,.
409000438620',2017-08-11,Indiaforensic AEPS NPCI DEP SET,,2017-08-11,19159885.0,,-535854181.9300003,.
409000438620',2017-08-11,TRF TO  Indiaforensic SERVICES I,,2017-08-11,10400000.0,,-546254181.9300003,.
409000438620',2017-08-14,AEPS Indiaforensic INCOME 110817,,2017-08-14,,109654.14,-546144527.7900003,.
409000438620',2017-08-14,AEPS Indiaforensic GST 110817,,2017-08-14,,19737.75,-546124790.0400003,.
409000438620',2017-08-14,AEPS Indiaforensic INCOME 120817,,2017-08-14,,117154.69,-546007635.3500003,.
409000438620',2017-08-14,AEPS Indiaforensic GST 120817,,2017-08-14,,21087.84,-545986547.5100002,.
409000438620',2017-08-14,AEPS Indiaforensic INCOME 130817,,2017-08-14,,82843.0,-545903704.5100002,.
409000438620',2017-08-14,AEPS Indiaforensic GST 130817,,2017-08-14,,14911.74,-545888792.7700002,.
409000438620',2017-08-14,Indiaforensic AEPS NPCI WDL SET,,2017-08-14,,27440816.0,-518447976.7700002,.
409000438620',2017-08-14,Indiaforensic AEPS NPCI WDL SET,,2017-08-14,,28885494.0,-489562482.7700002,.
409000438620',2017-08-14,Indiaforensic AEPS NPCI WDL SET,,2017-08-14,,19151034.0,-470411448.7700002,.
409000438620',2017-08-14,Indiaforensic AEPS NPCI DEP SET,,2017-08-14,16855855.0,,-487267303.7700002,.
409000438620',2017-08-14,Indiaforensic AEPS NPCI DEP SET,,2017-08-14,17013549.0,,-504280852.7700002,.
409000438620',2017-08-14,Indiaforensic AEPS NPCI DEP SET,,2017-08-14,13483940.0,,-517764792.7700002,.
409000438620',2017-08-14,TRF TO 409000362497,,2017-08-14,15000000.0,,-532764792.7700002,.
409000438620',2017-08-14,TRF TO 409000362897,,2017-08-14,3000000.0,,-535764792.7700002,.
409000438620',2017-08-16,TRF TO  Indiaforensic SERVICES I,,2017-08-16,10000000.0,,-545764792.7700002,.
409000438620',2017-08-16,AEPS ACQUIRING ADJ FEES 1,,2017-08-16,17.7,,-545764810.4700003,.
409000438620',2017-08-16,AEPS Indiaforensic INCOME 140817,,2017-08-16,,113294.75,-545651515.7200003,.
409000438620',2017-08-16,AEPS Indiaforensic GST 140817,,2017-08-16,,20393.06,-545631122.6600003,.
409000438620',2017-08-16,AEPS Indiaforensic INCOME 150817,,2017-08-16,,82913.53,-545548209.1300004,.
409000438620',2017-08-16,AEPS Indiaforensic GST 150817,,2017-08-16,,14924.44,-545533284.6900003,.
409000438620',2017-08-16,Indiaforensic AEPS NPCI WDL SET,,2017-08-16,,28067460.0,-517465824.6900003,.
409000438620',2017-08-16,Indfor RIF AEPS NPCI WDL SET,,2017-08-16,,5000.0,-517460824.6900003,.
409000438620',2017-08-16,Indiaforensic AEPS NPCI WDL SET,,2017-08-16,,18649276.0,-498811548.6900003,.
409000438620',2017-08-16,Indiaforensic AEPS NPCI DEP SET,,2017-08-16,16805017.0,,-515616565.6900003,.
409000438620',2017-08-16,Indiaforensic AEPS NPCI DEP SET,,2017-08-16,13962429.0,,-529578994.6900003,.
409000438620',2017-08-17,TRF TO  Indiaforensic SERVICES I,,2017-08-17,15000000.0,,-544578994.6900003,.
409000438620',2017-08-17,TRF TO  Indiaforensic SERVICES I,,2017-08-17,1700000.0,,-546278994.6900003,.
409000438620',2017-08-18,Indiaforensic AEPS NPCI WDL SET,,2017-08-18,,32628193.0,-513650801.6900003,.
409000438620',2017-08-18,Indfor RIF AEPS NPCI WDL SET,,2017-08-18,,2000.0,-513648801.6900003,.
409000438620',2017-08-18,Indiaforensic AEPS NPCI WDL SET,,2017-08-18,,32123757.0,-481525044.6900003,.
409000438620',2017-08-18,Indfor RIF AEPS NPCI WDL SET,,2017-08-18,,3738.0,-481521306.6900003,.
409000438620',2017-08-18,AEPS ACQUIRING ADJ FEES 1,,2017-08-18,68.43,,-481521375.1200003,.
409000438620',2017-08-18,AEPS ACQ REP ADJ FEES 160,,2017-08-18,,17.7,-481521357.4200003,.
409000438620',2017-08-18,AEPS Indiaforensic INCOME 160817,,2017-08-18,,136176.43,-481385180.9900003,.
409000438620',2017-08-18,AEPS Indiaforensic GST 160817,,2017-08-18,,24511.76,-481360669.2300003,.
409000438620',2017-08-18,AEPS Indiaforensic INCOME 170817,,2017-08-18,,131546.38,-481229122.8500003,.
409000438620',2017-08-18,AEPS Indiaforensic GST 170817,,2017-08-18,,23678.35,-481205444.5000003,.
409000438620',2017-08-18,Indiaforensic AEPS NPCI DEP SET,,2017-08-18,22059857.0,,-503265301.5000003,.
409000438620',2017-08-18,Indiaforensic AEPS NPCI DEP SET,,2017-08-18,20431563.0,,-523696864.5000003,.
409000438620',2017-08-18,CB721912281459/RMCPL12164/0,,2017-08-18,2000.0,,-523698864.5000003,.
409000438620',2017-08-19,Indiaforensic AEPS NPCI WDL SET,,2017-08-19,,33461970.0,-490236894.5000003,.
409000438620',2017-08-19,Indiaforensic AEPS NPCI DEP SET,,2017-08-19,22166118.0,,-512403012.5000003,.
409000438620',2017-08-19,TRF TO  Indiaforensic SERVICES I,,2017-08-19,5000000.0,,-517403012.5000003,.
409000438620',2017-08-19,TRF TO  Indiaforensic SERVICES I,,2017-08-19,5000000.0,,-522403012.5000003,.
409000438620',2017-08-19,TRF TO  Indiaforensic SERVICES I,,2017-08-19,5000000.0,,-527403012.5000003,.
409000438620',2017-08-19,TRF TO  Indiaforensic SERVICES I,,2017-08-19,5000000.0,,-532403012.5000003,.
409000438620',2017-08-19,TRF TO  Indiaforensic SERVICES I,,2017-08-19,2000000.0,,-534403012.5000003,.
409000438620',2017-08-19,TRF TO  Indiaforensic SERVICES I,,2017-08-19,4000000.0,,-538403012.5000002,.
409000438620',2017-08-19,TRF TO  Indiaforensic SERVICES I,,2017-08-19,4000000.0,,-542403012.5000002,.
409000438620',2017-08-19,TRF TO  Indiaforensic SERVICES I,,2017-08-19,3000000.0,,-545403012.5000002,.
409000438620',2017-08-19,AEPS Indiaforensic INCOME 180817,,2017-08-19,,139293.89,-545263718.6100003,.
409000438620',2017-08-19,AEPS Indiaforensic GST 180817,,2017-08-19,,25072.9,-545238645.7100003,.
409000438620',2017-08-21,Indiaforensic AEPS NPCI WDL SET,,2017-08-21,,30230526.0,-515008119.7100003,.
409000438620',2017-08-21,Indiaforensic AEPS NPCI WDL SET,,2017-08-21,,21417242.0,-493590877.7100003,.
409000438620',2017-08-21,Indiaforensic AEPS NPCI DEP SET,,2017-08-21,23005291.0,,-516596168.7100003,.
409000438620',2017-08-21,Indiaforensic AEPS NPCI DEP SET,,2017-08-21,15440802.0,,-532036970.7100003,.
409000438620',2017-08-21,AEPS ACQ CR ADJ FEES 1908,,2017-08-21,20.65,,-532036991.36000025,.
409000438620',2017-08-21,CR721608830874/RMCPL16456/0,,2017-08-21,2500.0,,-532039491.36000025,.
409000438620',2017-08-21,CR722406587523/RMCPL14183/1,,2017-08-21,1000.0,,-532040491.36000025,.
409000438620',2017-08-21,AEPS Indiaforensic INCOME 190817,,2017-08-21,,131084.74,-531909406.62000024,.
409000438620',2017-08-21,AEPS Indiaforensic GST 190817,,2017-08-21,,23595.25,-531885811.37000024,.
409000438620',2017-08-21,AEPS Indiaforensic INCOME 200817,,2017-08-21,,94222.4,-531791588.97000027,.
409000438620',2017-08-21,AEPS Indiaforensic GST 200817,,2017-08-21,,16960.03,-531774628.9400003,.
409000438620',2017-08-22,TRF TO  Indiaforensic SERVICES I,,2017-08-22,14500000.0,,-546274628.9400003,.
409000438620',2017-08-22,Indiaforensic AEPS NPCI WDL SET,,2017-08-22,,31930115.0,-514344513.9400003,.
409000438620',2017-08-22,Indfor RIF AEPS NPCI WDL SET,,2017-08-22,,800.0,-514343713.9400003,.
409000438620',2017-08-22,Indiaforensic AEPS NPCI DEP SET,,2017-08-22,22002706.0,,-536346419.9400003,.
409000438620',2017-08-22,AEPS ACQUIRING ADJ FEES 2,,2017-08-22,14.1,,-536346434.0400003,.
409000438620',2017-08-22,AEPS ACQ CR ADJ FEES 2108,,2017-08-22,1881.2,,-536348315.2400003,.
409000438620',2017-08-22,CR721015196483/RMCPL13931/2,,2017-08-22,5000.0,,-536353315.2400003,.
409000438620',2017-08-22,CR721211955416/RMCPL06976/3,,2017-08-22,1000.0,,-536354315.2400003,.
409000438620',2017-08-22,CR721211955476/RMCPL09249/3,,2017-08-22,100.0,,-536354415.2400003,.
409000438620',2017-08-22,CR721212012720/RMCPL16933/3,,2017-08-22,10000.0,,-536364415.2400003,.
409000438620',2017-08-22,CR721212012783/RMCPL16427/3,,2017-08-22,1000.0,,-536365415.2400003,.
409000438620',2017-08-22,CR721211956074/RMCPL16684/3,,2017-08-22,200.0,,-536365615.2400003,.
409000438620',2017-08-22,CR721211956141/RMCPL14827/3,,2017-08-22,10000.0,,-536375615.2400003,.
409000438620',2017-08-22,CR721211953720/RMCPL00010/3,,2017-08-22,2000.0,,-536377615.2400003,.
409000438620',2017-08-22,CR721211953745/RMCPL11346/3,,2017-08-22,3200.0,,-536380815.2400003,.
409000438620',2017-08-22,CR721211953782/RMCPL00116/3,,2017-08-22,510.0,,-536381325.2400003,.
409000438620',2017-08-22,CR721211954262/RMCPL11943/3,,2017-08-22,510.0,,-536381835.2400003,.
409000438620',2017-08-22,CR721211954267/RMCPL11959/3,,2017-08-22,4040.0,,-536385875.2400003,.
409000438620',2017-08-22,CR721211959116/RMCPL14588/3,,2017-08-22,1300.0,,-536387175.2400003,.
409000438620',2017-08-22,CR721211955665/RMCPL00195/3,,2017-08-22,4000.0,,-536391175.2400003,.
409000438620',2017-08-22,CR721211952583/RMCPL16422/3,,2017-08-22,500.0,,-536391675.2400003,.
409000438620',2017-08-22,CR721211952569/RMCPL11943/3,,2017-08-22,510.0,,-536392185.2400003,.
409000438620',2017-08-22,CR721211957381/RMCPL09829/3,,2017-08-22,1500.0,,-536393685.2400003,.
409000438620',2017-08-22,CR721211957436/RMCPL14715/3,,2017-08-22,4000.0,,-536397685.2400003,.
409000438620',2017-08-22,CR721211957421/RMCPL09595/3,,2017-08-22,10000.0,,-536407685.2400003,.
409000438620',2017-08-22,CR721211957905/RMCPL17018/3,,2017-08-22,1000.0,,-536408685.2400003,.
409000438620',2017-08-22,CR721211957983/RMCPL12366/3,,2017-08-22,510.0,,-536409195.2400003,.
409000438620',2017-08-22,CR721211948488/RMCPL15895/3,,2017-08-22,2430.0,,-536411625.2400003,.
409000438620',2017-08-22,CR721211948466/RMCPL10048/3,,2017-08-22,1230.0,,-536412855.2400003,.
409000438620',2017-08-22,CR721211948526/RMCPL14481/3,,2017-08-22,4000.0,,-536416855.2400003,.
409000438620',2017-08-22,CR721211948949/RMCPL13710/3,,2017-08-22,3150.0,,-536420005.2400003,.
409000438620',2017-08-22,CR721211948980/RMCPL09880/3,,2017-08-22,2000.0,,-536422005.2400003,.
409000438620',2017-08-22,CR721211949002/RMCPL14672/3,,2017-08-22,2120.0,,-536424125.2400003,.
409000438620',2017-08-22,CR721211958489/RMCPL14827/3,,2017-08-22,10000.0,,-536434125.2400003,.
409000438620',2017-08-22,CR721211958544/RMCPL14600/3,,2017-08-22,10000.0,,-536444125.2400003,.
409000438620',2017-08-22,CR721211958535/RMCPL14667/3,,2017-08-22,2000.0,,-536446125.2400003,.
409000438620',2017-08-22,CR721211958551/RMCPL15227/3,,2017-08-22,3000.0,,-536449125.2400003,.
409000438620',2017-08-22,CR721211955478/RMCPL15386/3,,2017-08-22,500.0,,-536449625.2400003,.
409000438620',2017-08-22,CR721211955527/RMCPL14639/3,,2017-08-22,5000.0,,-536454625.2400003,.
409000438620',2017-08-22,CR721211949101/RMCPL10066/3,,2017-08-22,302.0,,-536454927.2400003,.
409000438620',2017-08-22,CR721211949042/RMCPL15558/3,,2017-08-22,500.0,,-536455427.2400003,.
409000438620',2017-08-22,CR721211949114/RMCPL14443/3,,2017-08-22,900.0,,-536456327.2400003,.
409000438620',2017-08-22,CR721211953070/RMCPL10067/3,,2017-08-22,150.0,,-536456477.2400003,.
409000438620',2017-08-22,CR721211963379/RMCPL11486/3,,2017-08-22,500.0,,-536456977.2400003,.
409000438620',2017-08-22,CR721211953601/RMCPL09176/3,,2017-08-22,2500.0,,-536459477.2400003,.
409000438620',2017-08-22,CR721211958588/RMCPL16026/3,,2017-08-22,2500.0,,-536461977.2400003,.
409000438620',2017-08-22,CR721211958615/RMCPL11943/3,,2017-08-22,510.0,,-536462487.2400003,.
409000438620',2017-08-22,CR721211954861/RMCPL14084/3,,2017-08-22,10000.0,,-536472487.2400003,.
409000438620',2017-08-22,CR721211954894/RMCPL09183/3,,2017-08-22,100.0,,-536472587.2400003,.
409000438620',2017-08-22,CR721211959049/RMCPL15788/3,,2017-08-22,2004.0,,-536474591.2400003,.
409000438620',2017-08-22,CR721211951422/RMCPL16126/3,,2017-08-22,2100.0,,-536476691.2400003,.
409000438620',2017-08-22,CR721212013128/RMCPL14667/3,,2017-08-22,500.0,,-536477191.2400003,.
409000438620',2017-08-22,CR721211959148/RMCPL11539/3,,2017-08-22,100.0,,-536477291.2400003,.
409000438620',2017-08-22,CR721210947867/RMCPL15313/3,,2017-08-22,500.0,,-536477791.2400003,.
409000438620',2017-08-22,CR721211953135/RMCPL02803/3,,2017-08-22,510.0,,-536478301.2400003,.
409000438620',2017-08-22,CR721211953119/RMCPL10877/3,,2017-08-22,500.0,,-536478801.2400003,.
409000438620',2017-08-22,CR721211953620/RMCPL01723/3,,2017-08-22,124.0,,-536478925.2400003,.
409000438620',2017-08-22,CR721211956201/RMCPL14340/3,,2017-08-22,4000.0,,-536482925.2400003,.
409000438620',2017-08-22,CR721211950728/RMCPL09408/3,,2017-08-22,100.0,,-536483025.2400003,.
409000438620',2017-08-22,CR721211957291/RMCPL15386/3,,2017-08-22,200.0,,-536483225.2400003,.
409000438620',2017-08-22,CR721211958058/RMCPL16422/3,,2017-08-22,500.0,,-536483725.2400003,.
409000438620',2017-08-22,CR721211959068/RMCPL15907/3,,2017-08-22,5000.0,,-536488725.2400003,.
409000438620',2017-08-22,CR721211959073/RMCPL15703/3,,2017-08-22,5000.0,,-536493725.2400003,.
409000438620',2017-08-22,CR721211952480/RMCPL16539/3,,2017-08-22,600.0,,-536494325.2400003,.
409000438620',2017-08-22,CR721211952528/RMCPL13413/3,,2017-08-22,300.0,,-536494625.2400003,.
409000438620',2017-08-22,CR721212010840/RMCPL15731/3,,2017-08-22,200.0,,-536494825.2400003,.
409000438620',2017-08-22,CR721211956649/RMCPL16408/3,,2017-08-22,1000.0,,-536495825.2400003,.
409000438620',2017-08-22,CR721211956678/RMCPL16912/3,,2017-08-22,2000.0,,-536497825.2400003,.
409000438620',2017-08-22,CR721211956819/RMCPL13699/3,,2017-08-22,100.0,,-536497925.2400003,.
409000438620',2017-08-22,CR721211948359/RMCPL14949/3,,2017-08-22,300.0,,-536498225.2400003,.
409000438620',2017-08-22,CR721211948363/RMCPL14040/3,,2017-08-22,3570.0,,-536501795.2400003,.
409000438620',2017-08-22,CR721311472220/RMCPL00175/0,,2017-08-22,500.0,,-536502295.2400003,.
409000438620',2017-08-22,CR721311472240/RMCPL13837/0,,2017-08-22,10000.0,,-536512295.2400003,.
409000438620',2017-08-22,CR721311472253/RMCPL13006/0,,2017-08-22,420.0,,-536512715.2400003,.
409000438620',2017-08-22,CR721311499397/RMCPL14596/0,,2017-08-22,1000.0,,-536513715.2400003,.
409000438620',2017-08-22,CR721311499375/RMCPL16693/0,,2017-08-22,5000.0,,-536518715.2400003,.
409000438620',2017-08-22,CR721311499461/RMCPL01159/0,,2017-08-22,2000.0,,-536520715.2400003,.
409000438620',2017-08-22,CR721311499479/RMCPL16210/0,,2017-08-22,2700.0,,-536523415.2400003,.
409000438620',2017-08-22,CR721311500044/RMCPL13922/0,,2017-08-22,3000.0,,-536526415.2400003,.
409000438620',2017-08-22,CR721311475608/RMCPL09924/0,,2017-08-22,1000.0,,-536527415.2400003,.
409000438620',2017-08-22,CR721311475698/RMCPL09571/0,,2017-08-22,8500.0,,-536535915.2400003,.
409000438620',2017-08-22,CR721311475753/RMCPL16075/0,,2017-08-22,4000.0,,-536539915.2400003,.
409000438620',2017-08-22,CR721311476246/RMCPL15691/0,,2017-08-22,100.0,,-536540015.2400003,.
409000438620',2017-08-22,CR721311476340/RMCPL15534/0,,2017-08-22,300.0,,-536540315.2400003,.
409000438620',2017-08-22,CR721305368067/RMCPL15197/0,,2017-08-22,9000.0,,-536549315.2400003,.
409000438620',2017-08-22,CR721311502750/RMCPL16361/0,,2017-08-22,2000.0,,-536551315.2400003,.
409000438620',2017-08-22,CR721311502767/RMCPL15777/0,,2017-08-22,5000.0,,-536556315.2400003,.
409000438620',2017-08-22,CR721311502766/RMCPL13006/0,,2017-08-22,3000.0,,-536559315.2400003,.
409000438620',2017-08-22,CR721311502805/RMCPL11146/0,,2017-08-22,1009.0,,-536560324.2400003,.
409000438620',2017-08-22,CR721311501114/RMCPL11318/0,,2017-08-22,500.0,,-536560824.2400003,.
409000438620',2017-08-22,CR721311476793/RMCPL15536/0,,2017-08-22,100.0,,-536560924.2400003,.
409000438620',2017-08-22,CR721311473815/RMCPL15068/0,,2017-08-22,6000.0,,-536566924.2400003,.
409000438620',2017-08-22,CR721311477680/RMCPL13558/0,,2017-08-22,4380.0,,-536571304.2400003,.
409000438620',2017-08-22,CR721311476794/RMCPL16403/0,,2017-08-22,200.0,,-536571504.2400003,.
409000438620',2017-08-22,CR721311476808/RMCPL00225/0,,2017-08-22,4500.0,,-536576004.2400003,.
409000438620',2017-08-22,CR721311476823/RMCPL00248/0,,2017-08-22,10000.0,,-536586004.2400003,.
409000438620',2017-08-22,CR721311476895/RMCPL09925/0,,2017-08-22,5000.0,,-536591004.2400003,.
409000438620',2017-08-22,CR721311499511/RMCPL14743/0,,2017-08-22,5110.0,,-536596114.2400003,.
409000438620',2017-08-22,CR721311499516/RMCPL11131/0,,2017-08-22,1200.0,,-536597314.2400003,.
409000438620',2017-08-22,CR721311476931/RMCPL14990/0,,2017-08-22,1020.0,,-536598334.2400003,.
409000438620',2017-08-22,CR721311477372/RMCPL17019/0,,2017-08-22,4200.0,,-536602534.2400003,.
409000438620',2017-08-22,CR721311477432/RMCPL16086/0,,2017-08-22,500.0,,-536603034.2400003,.
409000438620',2017-08-22,CR721311477649/RMCPL12574/0,,2017-08-22,900.0,,-536603934.2400003,.
409000438620',2017-08-22,CR721311472779/RMCPL17161/0,,2017-08-22,6000.0,,-536609934.2400003,.
409000438620',2017-08-22,CR721311474540/RMCPL15480/0,,2017-08-22,5000.0,,-536614934.2400003,.
409000438620',2017-08-22,CR721311473286/RMCPL14356/0,,2017-08-22,9500.0,,-536624434.2400003,.
409000438620',2017-08-22,CR721311473320/RMCPL13831/0,,2017-08-22,3000.0,,-536627434.2400003,.
409000438620',2017-08-22,CR721311473307/RMCPL11596/0,,2017-08-22,200.0,,-536627634.2400003,.
409000438620',2017-08-22,CR721311500475/RMCPL16655/0,,2017-08-22,5000.0,,-536632634.2400003,.
409000438620',2017-08-22,CR721311500568/RMCPL11609/0,,2017-08-22,10000.0,,-536642634.2400003,.
409000438620',2017-08-22,CR721311500618/RMCPL15077/0,,2017-08-22,2000.0,,-536644634.2400003,.
409000438620',2017-08-22,CR721311472288/RMCPL11616/0,,2017-08-22,200.0,,-536644834.2400003,.
409000438620',2017-08-22,CR721311473905/RMCPL13837/0,,2017-08-22,10000.0,,-536654834.2400003,.
409000438620',2017-08-22,CR721411969615/RMCPL09936/0,,2017-08-22,1600.0,,-536656434.2400003,.
409000438620',2017-08-22,CR721411970095/RMCPL16968/0,,2017-08-22,100.0,,-536656534.2400003,.
409000438620',2017-08-22,CR721411970168/RMCPL16395/0,,2017-08-22,1000.0,,-536657534.2400003,.
409000438620',2017-08-22,CR721411970594/RMCPL15573/0,,2017-08-22,1000.0,,-536658534.2400003,.
409000438620',2017-08-22,CR721411970687/RMCPL14558/0,,2017-08-22,500.0,,-536659034.2400003,.
409000438620',2017-08-22,CR721411970720/RMCPL16992/0,,2017-08-22,100.0,,-536659134.2400003,.
409000438620',2017-08-22,CR721411968891/RMCPL13270/0,,2017-08-22,820.0,,-536659954.2400003,.
409000438620',2017-08-22,CR721411969010/RMCPL15908/0,,2017-08-22,500.0,,-536660454.2400003,.
409000438620',2017-08-22,CR721411969005/RMCPL15079/0,,2017-08-22,300.0,,-536660754.2400003,.
409000438620',2017-08-22,CR721410954773/RMCPL11817/0,,2017-08-22,9000.0,,-536669754.2400003,.
409000438620',2017-08-22,CR721412011240/RMCPL00010/0,,2017-08-22,500.0,,-536670254.2400003,.
409000438620',2017-08-22,CR721412011243/RMCPL12872/0,,2017-08-22,1000.0,,-536671254.2400003,.
409000438620',2017-08-22,CR721412991343/RMCPL12922/0,,2017-08-22,3020.0,,-536674274.2400003,.
409000438620',2017-08-22,CR721412991460/RMCPL11779/0,,2017-08-22,1450.0,,-536675724.2400003,.
409000438620',2017-08-22,CR721411968136/RMCPL12916/0,,2017-08-22,4000.0,,-536679724.2400003,.
409000438620',2017-08-22,CR721411968147/RMCPL14447/0,,2017-08-22,1000.0,,-536680724.2400003,.
409000438620',2017-08-22,CR721411968175/RMCPL15684/0,,2017-08-22,1200.0,,-536681924.2400003,.
409000438620',2017-08-22,CR721411968181/RMCPL13945/0,,2017-08-22,5000.0,,-536686924.2400003,.
409000438620',2017-08-22,CR721411968402/RMCPL13499/0,,2017-08-22,3050.0,,-536689974.2400003,.
409000438620',2017-08-22,CR721412010720/RMCPL16428/0,,2017-08-22,500.0,,-536690474.2400003,.
409000438620',2017-08-22,CR721412010739/RMCPL12666/0,,2017-08-22,1020.0,,-536691494.2400003,.
409000438620',2017-08-22,CR721412991287/RMCPL11402/0,,2017-08-22,520.0,,-536692014.2400003,.
409000438620',2017-08-22,CR721412009696/RMCPL13353/0,,2017-08-22,3000.0,,-536695014.2400003,.
409000438620',2017-08-22,CR721412009684/RMCPL11247/0,,2017-08-22,1200.0,,-536696214.2400003,.
409000438620',2017-08-22,CR721410955641/RMCPL15781/0,,2017-08-22,200.0,,-536696414.2400003,.
409000438620',2017-08-22,CR721410956180/RMCPL09895/0,,2017-08-22,1000.0,,-536697414.2400003,.
409000438620',2017-08-22,CR721411967901/RMCPL12815/0,,2017-08-22,4010.0,,-536701424.2400003,.
409000438620',2017-08-22,CR721411967900/RMCPL15446/0,,2017-08-22,1000.0,,-536702424.2400003,.
409000438620',2017-08-22,CR721410946439/RMCPL04296/0,,2017-08-22,2040.0,,-536704464.2400003,.
409000438620',2017-08-22,CR721412991511/RMCPL14064/0,,2017-08-22,3000.0,,-536707464.2400003,.
409000438620',2017-08-22,CR721412010103/RMCPL14133/0,,2017-08-22,520.0,,-536707984.2400003,.
409000438620',2017-08-22,CR721412010115/RMCPL11672/0,,2017-08-22,1934.0,,-536709918.2400003,.
409000438620',2017-08-22,CR721410950153/RMCPL11120/0,,2017-08-22,1500.0,,-536711418.2400003,.
409000438620',2017-08-22,CR721411988571/RMCPL16409/0,,2017-08-22,2000.0,,-536713418.2400003,.
409000438620',2017-08-22,CR721412011372/RMCPL15742/0,,2017-08-22,5000.0,,-536718418.2400003,.
409000438620',2017-08-22,CR721412011390/RMCPL15014/0,,2017-08-22,1500.0,,-536719918.2400003,.
409000438620',2017-08-22,CR721412011408/RMCPL08345/0,,2017-08-22,2515.0,,-536722433.2400003,.
409000438620',2017-08-22,CR721412011780/RMCPL15996/0,,2017-08-22,1500.0,,-536723933.2400003,.
409000438620',2017-08-22,CR721412011817/RMCPL12557/0,,2017-08-22,4800.0,,-536728733.2400003,.
409000438620',2017-08-22,CR721410954623/RMCPL16705/0,,2017-08-22,300.0,,-536729033.2400003,.
409000438620',2017-08-22,CR721410954615/RMCPL09931/0,,2017-08-22,1000.0,,-536730033.2400003,.
409000438620',2017-08-22,CR721411969556/RMCPL13807/0,,2017-08-22,100.0,,-536730133.2400003,.
409000438620',2017-08-22,CR721411969535/RMCPL16531/0,,2017-08-22,3500.0,,-536733633.2400003,.
409000438620',2017-08-22,CR721412011835/RMCPL09607/0,,2017-08-22,5000.0,,-536738633.2400003,.
409000438620',2017-08-22,CR721412011920/RMCPL16698/0,,2017-08-22,100.0,,-536738733.2400003,.
409000438620',2017-08-22,CR721412011939/RMCPL14100/0,,2017-08-22,100.0,,-536738833.2400003,.
409000438620',2017-08-22,CR721410927025/RMCPL11721/0,,2017-08-22,500.0,,-536739333.2400003,.
409000438620',2017-08-22,CR721411967948/RMCPL16343/0,,2017-08-22,3000.0,,-536742333.2400003,.
409000438620',2017-08-22,CR721409925039/RMCPL14040/0,,2017-08-22,6150.0,,-536748483.2400003,.
409000438620',2017-08-22,CR721411971338/RMCPL12277/0,,2017-08-22,1000.0,,-536749483.2400003,.
409000438620',2017-08-22,CR721412010175/RMCPL09607/0,,2017-08-22,5000.0,,-536754483.2400003,.
409000438620',2017-08-22,CR721412010209/RMCPL09602/0,,2017-08-22,9000.0,,-536763483.2400003,.
409000438620',2017-08-22,CR721412010607/RMCPL16927/0,,2017-08-22,100.0,,-536763583.2400003,.
409000438620',2017-08-22,CR721412010611/RMCPL15884/0,,2017-08-22,5000.0,,-536768583.2400003,.
409000438620',2017-08-22,CR721412010613/RMCPL12060/0,,2017-08-22,500.0,,-536769083.2400003,.
409000438620',2017-08-22,CR721412010801/RMCPL12494/0,,2017-08-22,7500.0,,-536776583.2400003,.
409000438620',2017-08-22,CR721412010791/RMCPL16941/0,,2017-08-22,2010.0,,-536778593.2400003,.
409000438620',2017-08-22,CR721412010840/RMCPL07629/0,,2017-08-22,1000.0,,-536779593.2400003,.
409000438620',2017-08-22,CR721412010808/RMCPL13270/0,,2017-08-22,1640.0,,-536781233.2400003,.
409000438620',2017-08-22,CR721412010866/RMCPL09044/0,,2017-08-22,1000.0,,-536782233.2400003,.
409000438620',2017-08-22,CR721412011229/RMCPL15794/0,,2017-08-22,100.0,,-536782333.2400003,.
409000438620',2017-08-22,CR721412011239/RMCPL11529/0,,2017-08-22,2510.0,,-536784843.2400003,.
409000438620',2017-08-22,CR721412010151/RMCPL13504/0,,2017-08-22,520.0,,-536785363.2400003,.
409000438620',2017-08-22,CR721410934077/RMCPL16636/0,,2017-08-22,520.0,,-536785883.2400003,.
409000438620',2017-08-22,CR721410927672/RMCPL09749/0,,2017-08-22,200.0,,-536786083.2400003,.
409000438620',2017-08-22,CR721410927684/RMCPL14670/0,,2017-08-22,3000.0,,-536789083.2400003,.
409000438620',2017-08-22,CR721410927698/RMCPL12201/0,,2017-08-22,750.0,,-536789833.2400003,.
409000438620',2017-08-22,CR721411971209/RMCPL15019/0,,2017-08-22,1000.0,,-536790833.2400003,.
409000438620',2017-08-22,CR721411971213/RMCPL14605/0,,2017-08-22,500.0,,-536791333.2400003,.
409000438620',2017-08-22,CR721411971233/RMCPL16080/0,,2017-08-22,730.0,,-536792063.2400003,.
409000438620',2017-08-22,CR721410938169/RMCPL11824/0,,2017-08-22,5000.0,,-536797063.2400003,.
409000438620',2017-08-22,CR721412010160/RMCPL12382/0,,2017-08-22,2000.0,,-536799063.2400003,.
409000438620',2017-08-22,CR721411971290/RMCPL10268/0,,2017-08-22,3020.0,,-536802083.2400003,.
409000438620',2017-08-22,CR721411971341/RMCPL11471/0,,2017-08-22,3000.0,,-536805083.2400003,.
409000438620',2017-08-22,CR721411971343/RMCPL12429/0,,2017-08-22,110.0,,-536805193.2400003,.
409000438620',2017-08-22,CR721411968393/RMCPL14569/0,,2017-08-22,4000.0,,-536809193.2400003,.
409000438620',2017-08-22,CR721411968378/RMCPL14558/0,,2017-08-22,5000.0,,-536814193.2400003,.
409000438620',2017-08-22,CR721411968401/RMCPL16595/0,,2017-08-22,4120.0,,-536818313.2400003,.
409000438620',2017-08-22,CR721912296108/RMCPL15667/0,,2017-08-22,10000.0,,-536828313.2400003,.
409000438620',2017-08-22,CR721912296163/RMCPL09009/0,,2017-08-22,6000.0,,-536834313.2400003,.
409000438620',2017-08-22,CR721912296240/RMCPL15459/0,,2017-08-22,2500.0,,-536836813.2400003,.
409000438620',2017-08-22,CR721912296398/RMCPL15429/0,,2017-08-22,1010.0,,-536837823.2400003,.
409000438620',2017-08-22,CR721912296410/RMCPL13837/0,,2017-08-22,1650.0,,-536839473.2400003,.
409000438620',2017-08-22,CR722312213728/RMCPL00006/1,,2017-08-22,5000.0,,-536844473.2400003,.
409000438620',2017-08-22,AEPS ACQ REP ADJ FEES 210,,2017-08-22,,42.35,-536844430.8900003,.
409000438620',2017-08-22,AEPS Indiaforensic INCOME 210817,,2017-08-22,,136156.07,-536708274.8200003,.
409000438620',2017-08-22,AEPS Indiaforensic GST 210817,,2017-08-22,,24508.09,-536683766.7300003,.
409000438620',2017-08-22,TRF TO Indiaforensic SERVICES IN,,2017-08-22,4000000.0,,-540683766.7300003,.
409000438620',2017-08-22,TRF TO Indiaforensic SERVICES IN,,2017-08-22,4000000.0,,-544683766.7300003,.
409000438620',2017-08-22,TRF TO Indiaforensic SERVICES IN,,2017-08-22,1000000.0,,-545683766.7300003,.
409000438620',2017-08-22,CB721211954242/RMCPL16004/3,,2017-08-22,2500.0,,-545686266.7300003,.
409000438620',2017-08-22,CB721211949463/RMCPL01525/3,,2017-08-22,1920.0,,-545688186.7300003,.
409000438620',2017-08-23,Indiaforensic AEPS NPCI WDL SET,,2017-08-23,,31240557.0,-514447629.73000026,.
409000438620',2017-08-23,Indiaforensic AEPS NPCI DEP SET,,2017-08-23,20463905.0,,-534911534.73000026,.
409000438620',2017-08-23,AEPS Indiaforensic INCOME 220817,,2017-08-23,,131200.3,-534780334.43000025,.
409000438620',2017-08-23,AEPS Indiaforensic GST 220817,,2017-08-23,,23616.05,-534756718.38000023,.
409000438620',2017-08-23,TRF TO  Indiaforensic SERVICES I,,2017-08-23,11400000.0,,-546156718.3800002,.
409000438620',2017-08-24,Indiaforensic AEPS NPCI WDL SET,,2017-08-24,,30908804.0,-515247914.38000023,.
409000438620',2017-08-24,Indfor RIF AEPS NPCI WDL SET,,2017-08-24,,10000.0,-515237914.38000023,.
409000438620',2017-08-24,CB719511141864/RMCPL15566/1,,2017-08-24,1600.0,,-515239514.38000023,.
409000438620',2017-08-24,CB719816661896/RMCPL09883/1,,2017-08-24,700.0,,-515240214.38000023,.
409000438620',2017-08-24,Indiaforensic AEPS NPCI DEP SET,,2017-08-24,22348729.0,,-537588943.3800002,.
409000438620',2017-08-24,AEPS Indiaforensic INCOME 230817,,2017-08-24,,132923.78,-537456019.6000003,.
409000438620',2017-08-24,AEPS Indiaforensic GST 230817,,2017-08-24,,23926.28,-537432093.3200003,.
409000438620',2017-08-24,TRF TO  Indiaforensic VIRTUAL VI,,2017-08-24,3500000.0,,-540932093.3200003,.
409000438620',2017-08-24,TRF TO  Indiaforensic SERVICES I,,2017-08-24,4300000.0,,-545232093.3200003,.
409000438620',2017-08-24,TRF TO  Indiaforensic SERVICES I,,2017-08-24,1000000.0,,-546232093.3200003,.
409000438620',2017-08-28,Indiaforensic AEPS NPCI WDL SET,,2017-08-28,,29435834.0,-516796259.3200003,.
409000438620',2017-08-28,Indiaforensic AEPS NPCI WDL SET,,2017-08-28,,32428432.0,-484367827.3200003,.
409000438620',2017-08-28,Indiaforensic AEPS NPCI WDL SET,,2017-08-28,,31761198.0,-452606629.3200003,.
409000438620',2017-08-28,Indfor RIF AEPS NPCI WDL SET,,2017-08-28,,1000.0,-452605629.3200003,.
409000438620',2017-08-28,Indiaforensic AEPS NPCI WDL SET,,2017-08-28,,16761275.0,-435844354.3200003,.
409000438620',2017-08-28,Indiaforensic AEPS NPCI DEP SET,,2017-08-28,20379587.0,,-456223941.3200003,.
409000438620',2017-08-28,Indiaforensic AEPS NPCI DEP SET,,2017-08-28,19731151.0,,-475955092.3200003,.
409000438620',2017-08-28,Indiaforensic AEPS NPCI DEP SET,,2017-08-28,20118382.0,,-496073474.3200003,.
409000438620',2017-08-28,Indiaforensic AEPS NPCI DEP SET,,2017-08-28,14028979.0,,-510102453.3200003,.
409000438620',2017-08-28,TRANSFER TO  Indiaforensic SERVI,,2017-08-28,15000000.0,,-525102453.3200003,.
409000438620',2017-08-28,TYRANSFER TO  Indiaforensic SERV,,2017-08-28,15000000.0,,-540102453.3200003,.
409000438620',2017-08-28,TRANSFER TO  Indiaforensic SERVI,,2017-08-28,6200000.0,,-546302453.3200003,.
409000438620',2017-08-28,AEPS Indiaforensic INCOME 240817,,2017-08-28,,123716.99,-546178736.3300003,.
409000438620',2017-08-28,AEPS Indiaforensic GST 240817,,2017-08-28,,22269.06,-546156467.2700003,.
409000438620',2017-08-28,AEPS Indiaforensic INCOME 250817,,2017-08-28,,131278.48,-546025188.7900003,.
409000438620',2017-08-28,AEPS Indiaforensic GST 250817,,2017-08-28,,23630.13,-546001558.6600003,.
409000438620',2017-08-28,AEPS Indiaforensic INCOME 260817,,2017-08-28,,128497.25,-545873061.4100003,.
409000438620',2017-08-28,AEPS Indiaforensic GST 260817,,2017-08-28,,23129.51,-545849931.9000003,.
409000438620',2017-08-28,AEPS Indiaforensic INCOME 270817,,2017-08-28,,76763.19,-545773168.7100003,.
409000438620',2017-08-28,AEPS Indiaforensic GST 270817,,2017-08-28,,13817.37,-545759351.3400003,.
409000438620',2017-08-29,AEPS Indiaforensic INCOME 280817,,2017-08-29,,138225.98,-545621125.3600003,.
409000438620',2017-08-29,AEPS Indiaforensic GST 280817,,2017-08-29,,24880.68,-545596244.6800003,.
409000438620',2017-08-29,Indiaforensic AEPS NPCI WDL SET,,2017-08-29,,33446366.0,-512149878.6800003,.
409000438620',2017-08-29,Indfor-RIF AEPS NPCI WDL SET,,2017-08-29,,1500.0,-512148378.6800003,.
409000438620',2017-08-29,Indiaforensic AEPS NPCI DEP SET,,2017-08-29,23170118.0,,-535318496.6800003,.
409000438620',2017-08-29,TRF TO  Indiaforensic SERVICES I,,2017-08-29,10900000.0,,-546218496.6800003,.
409000438620',2017-08-30,AEPS Indiaforensic INCOME 290817,,2017-08-30,,145495.26,-546073001.4200003,.
409000438620',2017-08-30,AEPS Indiaforensic GST 290817,,2017-08-30,,26189.15,-546046812.2700003,.
409000438620',2017-08-30,Indiaforensic AEPS NPCI WDL SET,,2017-08-30,,35390690.0,-510656122.27000034,.
409000438620',2017-08-30,Indfor-RIF AEPS NPCI WDL SET,,2017-08-30,,3000.0,-510653122.27000034,.
409000438620',2017-08-30,Indiaforensic AEPS NPCI DEP SET,,2017-08-30,24079575.0,,-534732697.27000034,.
409000438620',2017-08-30,TRF TO  Indiaforensic SERVICES I,,2017-08-30,11500000.0,,-546232697.2700003,.
409000438620',2017-08-31,Indiaforensic AEPS NPCI WDL SET,,2017-08-31,,35370831.0,-510861866.27000034,.
409000438620',2017-08-31,Indfor-RIF AEPS NPCI WDL SET,,2017-08-31,,1000.0,-510860866.27000034,.
409000438620',2017-08-31,Indiaforensic AEPS NPCI DEP SET,,2017-08-31,23880230.0,,-534741096.27000034,.
409000438620',2017-08-31,TRF TO  Indiaforensic SERVICES I,,2017-08-31,11200000.0,,-545941096.2700003,.
409000438620',2017-08-31,TRF TO  Indiaforensic SERVICES I,,2017-08-31,300000.0,,-546241096.2700003,.
409000438620',2017-08-31,AEPS Indiaforensic INCOME 300817,,2017-08-31,,144749.81,-546096346.4600004,.
409000438620',2017-08-31,AEPS Indiaforensic GST 300817,,2017-08-31,,26054.97,-546070291.4900004,.
409000438620',2017-09-01,AEPS ACQUIRING ADJ FEES 3,,2017-09-01,17.7,,-546070309.1900004,.
409000438620',2017-09-01,AEPS Indiaforensic INCOME 310817,,2017-09-01,,125182.33,-545945126.8600004,.
409000438620',2017-09-01,AEPS Indiaforensic GST 310817,,2017-09-01,,22532.82,-545922594.0400003,.
409000438620',2017-09-01,Indiaforensic AEPS NPCI WDL SET,,2017-09-01,,29788445.0,-516134149.0400003,.
409000438620',2017-09-01,Indiaforensic AEPS NPCI DEP SET,,2017-09-01,21376524.0,,-537510673.0400003,.
409000438620',2017-09-01,TRF TO  Indiaforensic SERVICES I,,2017-09-01,3000000.0,,-540510673.0400003,.
409000438620',2017-09-01,TRF TO  Indiaforensic SERVICES I,,2017-09-01,3000000.0,,-543510673.0400003,.
409000438620',2017-09-01,TRF TO  Indiaforensic SERVICES I,,2017-09-01,2000000.0,,-545510673.0400003,.
409000438620',2017-09-04,Indiaforensic AEPS NPCI WDL SET,,2017-09-04,,36073200.0,-509437473.0400003,.
409000438620',2017-09-04,Indiaforensic AEPS NPCI WDL SET,,2017-09-04,,23537554.0,-485899919.0400003,.
409000438620',2017-09-04,Indfor-RIF AEPS NPCI WDL SET,,2017-09-04,,2000.0,-485897919.0400003,.
409000438620',2017-09-04,Indiaforensic AEPS NPCI WDL SET,,2017-09-04,,20145281.0,-465752638.0400003,.
409000438620',2017-09-04,Indiaforensic AEPS NPCI DEP SET,,2017-09-04,23624975.0,,-489377613.0400003,.
409000438620',2017-09-04,Indiaforensic AEPS NPCI DEP SET,,2017-09-04,17409489.0,,-506787102.0400003,.
409000438620',2017-09-04,Indiaforensic AEPS NPCI DEP SET,,2017-09-04,15461854.0,,-522248956.0400003,.
409000438620',2017-09-04,TRF TO  Indiaforensic SERVICES I,,2017-09-04,3000000.0,,-525248956.0400003,.
409000438620',2017-09-04,TRF TO  Indiaforensic SERVICES I,,2017-09-04,3000000.0,,-528248956.0400003,.
409000438620',2017-09-04,TRF TO  Indiaforensic SERVICES I,,2017-09-04,2000000.0,,-530248956.0400003,.
409000438620',2017-09-04,TRF TO  Indiaforensic SERVICES I,,2017-09-04,2000000.0,,-532248956.0400003,.
409000438620',2017-09-04,TRF TO  Indiaforensic SERVICES I,,2017-09-04,2000000.0,,-534248956.0400003,.
409000438620',2017-09-04,TRF TO  Indiaforensic SERVICES I,,2017-09-04,2000000.0,,-536248956.0400003,.
409000438620',2017-09-04,TRF TO  Indiaforensic SERVICES I,,2017-09-04,2000000.0,,-538248956.0400003,.
409000438620',2017-09-04,TRF TO  Indiaforensic SERVICES I,,2017-09-04,1000000.0,,-539248956.0400003,.
409000438620',2017-09-04,TRF TO  Indiaforensic SERVICES I,,2017-09-04,1000000.0,,-540248956.0400003,.
409000438620',2017-09-04,AEPS ACQUIRING ADJ FEES 0,,2017-09-04,,17.7,-540248938.3400003,.
409000438620',2017-09-04,AEPS Indiaforensic INCOME 010917,,2017-09-04,,145824.18,-540103114.1600003,.
409000438620',2017-09-04,AEPS Indiaforensic GST 010917,,2017-09-04,,26248.35,-540076865.8100003,.
409000438620',2017-09-04,AEPS Indiaforensic INCOME 020917,,2017-09-04,,103289.64,-539973576.1700003,.
409000438620',2017-09-04,AEPS Indiaforensic GST 020917,,2017-09-04,,18592.14,-539954984.0300003,.
409000438620',2017-09-04,AEPS Indiaforensic INCOME 030917,,2017-09-04,,89032.25,-539865951.7800003,.
409000438620',2017-09-04,AEPS Indiaforensic GST 030917,,2017-09-04,,16025.81,-539849925.9700004,.
409000438620',2017-09-05,Indiaforensic AEPS NPCI WDL SET,,2017-09-05,,36264272.0,-503585653.9700004,.
409000438620',2017-09-05,Indiaforensic AEPS NPCI DEP SET,,2017-09-05,24478157.0,,-528063810.9700004,.
409000438620',2017-09-05,Indfor RIF AEPS NPCI DEP SET,,2017-09-05,8500.0,,-528072310.9700004,.
409000438620',2017-09-05,TRF TO  Indiaforensic SERVICES I,,2017-09-05,6400000.0,,-534472310.9700004,.
409000438620',2017-09-05,AEPS ACQUIRING ADJ FEES 0,,2017-09-05,33.91,,-534472344.8800004,.
409000438620',2017-09-05,AEPS Indiaforensic INCOME 040917,,2017-09-05,,152569.42,-534319775.4600004,.
409000438620',2017-09-05,AEPS Indiaforensic GST 040917,,2017-09-05,,27462.5,-534292312.9600004,.
409000438620',2017-09-05,TRF TO  Indiaforensic SERVICES I,,2017-09-05,11600000.0,,-545892312.9600004,.
409000438620',2017-09-05,TRF TO  Indiaforensic SERVICES I,,2017-09-05,200000.0,,-546092312.9600004,.
409000438620',2017-09-06,Indiaforensic AEPS NPCI WDL SET,,2017-09-06,,34001155.0,-512091157.9600004,.
409000438620',2017-09-06,Indiaforensic AEPS NPCI DEP SET,,2017-09-06,23861177.0,,-535952334.9600004,.
409000438620',2017-09-06,Indfor RIF AEPS NPCI DEP SET,,2017-09-06,1500.0,,-535953834.9600004,.
409000438620',2017-09-06,TRF TO  Indiaforensic SERVICES I,,2017-09-06,10300000.0,,-546253834.9600004,.
409000438620',2017-09-06,CB721411967923/RMCPL16808/0,,2017-09-06,2400.0,,-546256234.9600004,.
409000438620',2017-09-06,AEPS ACQ REP ADJ FEES 050,,2017-09-06,,33.91,-546256201.0500004,.
409000438620',2017-09-06,AEPS Indiaforensic INCOME 050917,,2017-09-06,,144558.9,-546111642.1500005,.
409000438620',2017-09-06,AEPS Indiaforensic GST 050917,,2017-09-06,,26020.6,-546085621.5500004,.
409000438620',2017-09-07,Indiaforensic AEPS NPCI WDL SET,,2017-09-07,,32806169.0,-513279452.5500004,.
409000438620',2017-09-07,Indfor RIF AEPS NPCI WDL SET,,2017-09-07,,5000.0,-513274452.5500004,.
409000438620',2017-09-07,Indiaforensic AEPS NPCI DEP SET,,2017-09-07,23724183.0,,-536998635.5500004,.
409000438620',2017-09-07,AEPS Indiaforensic INCOME 060917,,2017-09-07,,140360.69,-536858274.86000043,.
409000438620',2017-09-07,AEPS Indiaforensic GST 060917,,2017-09-07,,25264.92,-536833009.9400004,.
409000438620',2017-09-07,TRF TO  Indiaforensic SERVICES I,,2017-09-07,9300000.0,,-546133009.9400004,.
409000438620',2017-09-08,Indiaforensic AEPS NPCI WDL SET,,2017-09-08,,41573471.0,-504559538.9400004,.
409000438620',2017-09-08,Indfor RIF AEPS NPCI WDL SET,,2017-09-08,,100.0,-504559438.9400004,.
409000438620',2017-09-08,Indiaforensic AEPS NPCI DEP SET,,2017-09-08,25984401.0,,-530543839.9400004,.
409000438620',2017-09-08,Indfor RIF AEPS NPCI DEP SET,,2017-09-08,100.0,,-530543939.9400004,.
409000438620',2017-09-08,AEPS ACQUIRING ADJ FEES 0,,2017-09-08,6.08,,-530543946.0200004,.
409000438620',2017-09-08,AEPS Indiaforensic INCOME 070917,,2017-09-08,,168619.03,-530375326.9900004,.
409000438620',2017-09-08,AEPS Indiaforensic GST 070917,,2017-09-08,,30351.43,-530344975.5600004,.
409000438620',2017-09-08,TRF TO  Indiaforensic SERVICES I,,2017-09-08,15000000.0,,-545344975.5600004,.
409000438620',2017-09-08,TRF TO  Indiaforensic SERVICES I,,2017-09-08,700000.0,,-546044975.5600004,.
409000438620',2017-09-11,Indiaforensic AEPS NPCI WDL SET,,2017-09-11,,49173912.0,-496871063.5600004,.
409000438620',2017-09-11,Indiaforensic AEPS NPCI WDL SET,,2017-09-11,,39321651.0,-457549412.5600004,.
409000438620',2017-09-11,Indfor RIF AEPS NPCI WDL SET,,2017-09-11,,1000.0,-457548412.5600004,.
409000438620',2017-09-11,Indiaforensic AEPS NPCI WDL SET,,2017-09-11,,31304036.0,-426244376.5600004,.
409000438620',2017-09-11,Indfor RIF AEPS NPCI WDL SET,,2017-09-11,,3000.0,-426241376.5600004,.
409000438620',2017-09-11,Indiaforensic AEPS NPCI DEP SET,,2017-09-11,28073517.0,,-454314893.5600004,.
409000438620',2017-09-11,Indiaforensic AEPS NPCI DEP SET,,2017-09-11,21283841.0,,-475598734.5600004,.
409000438620',2017-09-11,Indiaforensic AEPS NPCI DEP SET,,2017-09-11,18770031.0,,-494368765.5600004,.
409000438620',2017-09-11,TRF TO  Indiaforensic SERVICES I,,2017-09-11,15000000.0,,-509368765.5600004,.
409000438620',2017-09-11,TRF TO  Indiaforensic SERVICES I,,2017-09-11,15000000.0,,-524368765.5600004,.
409000438620',2017-09-11,TRF TO  Indiaforensic SERVICES I,,2017-09-11,15000000.0,,-539368765.5600004,.
409000438620',2017-09-11,TRF TO  Indiaforensic SERVICES I,,2017-09-11,6900000.0,,-546268765.5600004,.
409000438620',2017-09-11,AEPS ACQ GF REP ADJ FEES0,,2017-09-11,,17.7,-546268747.8600004,.
409000438620',2017-09-11,AEPS Indiaforensic INCOME 080917,,2017-09-11,,188767.15,-546079980.7100004,.
409000438620',2017-09-11,AEPS Indiaforensic GST 080917,,2017-09-11,,33978.09,-546046002.6200004,.
409000438620',2017-09-11,AEPS Indiaforensic INCOME 090917,,2017-09-11,,147151.11,-545898851.5100003,.
409000438620',2017-09-11,AEPS Indiaforensic GST 090917,,2017-09-11,,26487.2,-545872364.3100003,.
409000438620',2017-09-11,AEPS Indiaforensic INCOME 100917,,2017-09-11,,124635.37,-545747728.9400003,.
409000438620',2017-09-11,AEPS Indiaforensic GST 100917,,2017-09-11,,22434.37,-545725294.5700003,.
409000438620',2017-09-12,Indiaforensic AEPS NPCI WDL SET,,2017-09-12,,50450593.0,-495274701.5700003,.
409000438620',2017-09-12,Indiaforensic AEPS NPCI DEP SET,,2017-09-12,29079242.0,,-524353943.5700003,.
409000438620',2017-09-12,Indfor RIF AEPS NPCI DEP SET,,2017-09-12,1000.0,,-524354943.5700003,.
409000438620',2017-09-12,AEPS ACQUIRING ADJ FEES 1,,2017-09-12,5.9,,-524354949.47000027,.
409000438620',2017-09-12,AEPS ACQUIRING REP ADJ FE,,2017-09-12,,6.08,-524354943.3900003,.
409000438620',2017-09-12,AEPS Indiaforensic INCOME 110917,,2017-09-12,,196616.39,-524158327.0000003,.
409000438620',2017-09-12,AEPS Indiaforensic GST 110917,,2017-09-12,,35390.95,-524122936.0500003,.
409000438620',2017-09-12,TRF TO  Indiaforensic SERVICES I,,2017-09-12,15000000.0,,-539122936.0500003,.
409000438620',2017-09-12,TRF TO  Indiaforensic SERVICES I,,2017-09-12,7100000.0,,-546222936.0500003,.
409000438620',2017-09-13,Indiaforensic AEPS NPCI WDL SET,,2017-09-13,,38570138.0,-507652798.0500003,.
409000438620',2017-09-13,Indiaforensic AEPS NPCI DEP SET,,2017-09-13,24124561.0,,-531777359.0500003,.
409000438620',2017-09-13,AEPS ACQ REP ADJ FEES 120,,2017-09-13,,5.9,-531777353.15000033,.
409000438620',2017-09-13,AEPS Indiaforensic INCOME 120917,,2017-09-13,,152164.67,-531625188.4800003,.
409000438620',2017-09-13,AEPS Indiaforensic GST 120917,,2017-09-13,,27389.64,-531597798.84000033,.
409000438620',2017-09-13,TRF TO  Indiaforensic SERVICES I,,2017-09-13,14700000.0,,-546297798.8400004,.
409000438620',2017-09-14,Indiaforensic AEPS NPCI WDL SET,,2017-09-14,,46474689.0,-499823109.8400004,.
409000438620',2017-09-14,Indiaforensic AEPS NPCI DEP SET,,2017-09-14,27235059.0,,-527058168.8400004,.
409000438620',2017-09-14,TRF TO  Indiaforensic SERVICES I,,2017-09-14,15000000.0,,-542058168.8400004,.
409000438620',2017-09-14,TRF TO  Indiaforensic SERVICES I,,2017-09-14,4200000.0,,-546258168.8400004,.
409000438620',2017-09-14,AEPS ACQUIRING ADJ FEES 1,,2017-09-14,27.44,,-546258196.2800004,.
409000438620',2017-09-14,AEPS Indiaforensic INCOME 130917,,2017-09-14,,180338.81,-546077857.4700005,.
409000438620',2017-09-14,AEPS Indiaforensic GST 130917,,2017-09-14,,32460.99,-546045396.4800005,.
409000438620',2017-09-14,CB725019078243/RMCPL00519/0,,2017-09-14,,9180.0,-546036216.4800005,.
409000438620',2017-09-15,Indiaforensic AEPS NPCI WDL SET,,2017-09-15,,47181604.0,-498854612.4800005,.
409000438620',2017-09-15,Indiaforensic AEPS NPCI DEP SET,,2017-09-15,29731317.0,,-528585929.4800005,.
409000438620',2017-09-15,AEPS ACQ REP ADJ FEES 130,,2017-09-15,,9.74,-528585919.7400005,.
409000438620',2017-09-15,AEPS Indiaforensic INCOME 140917,,2017-09-15,,187264.34,-528398655.4000005,.
409000438620',2017-09-15,AEPS Indiaforensic GST 140917,,2017-09-15,,33707.58,-528364947.8200005,.
409000438620',2017-09-15,TRF TO  Indiaforensic SERVICES I,,2017-09-15,15000000.0,,-543364947.8200005,.
409000438620',2017-09-15,TRF TO  Indiaforensic SERVICES I,,2017-09-15,2900000.0,,-546264947.8200005,.
409000438620',2017-09-15,REV CB725019078243/RMCPL005,,2017-09-15,9180.0,,-546274127.8200005,.
409000438620',2017-09-15,CB725019078243/RMCPL00519/0,,2017-09-15,9180.0,,-546283307.8200005,.
409000438620',2017-09-16,Indiaforensic AEPS NPCI WDL SET,,2017-09-16,,47067366.0,-499215941.8200005,.
409000438620',2017-09-16,Indiaforensic AEPS NPCI DEP SET,,2017-09-16,31170513.0,,-530386454.8200005,.
409000438620',2017-09-16,AEPS ACQUIRING ADJ FEES 1,,2017-09-16,12.69,,-530386467.5100005,.
409000438620',2017-09-16,AEPS Indiaforensic INCOME 140917,,2017-09-16,,188429.5,-530198038.0100005,.
409000438620',2017-09-16,AEPS Indiaforensic GST 140917,,2017-09-16,,33917.31,-530164120.7000005,.
409000438620',2017-09-16,TRF TO  Indiaforensic SERVICES I,,2017-09-16,5000000.0,,-535164120.7000005,.
409000438620',2017-09-16,TRF TO  Indiaforensic SERVICES I,,2017-09-16,5000000.0,,-540164120.7000005,.
409000438620',2017-09-16,TRF TO  Indiaforensic SERVICES I,,2017-09-16,5000000.0,,-545164120.7000005,.
409000438620',2017-09-18,Indiaforensic AEPS NPCI WDL SET,,2017-09-18,,43222050.0,-501942070.7000005,.
409000438620',2017-09-18,Indiaforensic AEPS NPCI WDL SET,,2017-09-18,,27870435.0,-474071635.7000005,.
409000438620',2017-09-18,Indfor RIF AEPS NPCI WDL SET,,2017-09-18,,20800.0,-474050835.7000005,.
409000438620',2017-09-18,Indiaforensic AEPS NPCI DEP SET,,2017-09-18,27324958.0,,-501375793.7000005,.
409000438620',2017-09-18,Indiaforensic AEPS NPCI DEP SET,,2017-09-18,18161757.0,,-519537550.7000005,.
409000438620',2017-09-18,TRF TO  Indiaforensic SERVICES I,,2017-09-18,11700000.0,,-531237550.7000005,.
409000438620',2017-09-18,TRF TO  Indiaforensic SERVICES I,,2017-09-18,15000000.0,,-546237550.7000005,.
409000438620',2017-09-18,CB725611973495/RMCPL03342/1,,2017-09-18,2150.0,,-546239700.7000005,.
409000438620',2017-09-18,AEPS Indiaforensic INCOME 160917,,2017-09-18,,171332.28,-546068368.4200006,.
409000438620',2017-09-18,AEPS Indiaforensic GST 160917,,2017-09-18,,30839.81,-546037528.6100006,.
409000438620',2017-09-18,AEPS Indiaforensic INCOME 170917,,2017-09-18,,114538.43,-545922990.1800007,.
409000438620',2017-09-18,AEPS Indiaforensic GST 170917,,2017-09-18,,20616.92,-545902373.2600007,.
409000438620',2017-09-19,Indiaforensic AEPS NPCI WDL SET,,2017-09-19,,45895021.0,-500007352.2600007,.
409000438620',2017-09-19,Indfor RIF AEPS NPCI WDL SET,,2017-09-19,,3400.0,-500003952.2600007,.
409000438620',2017-09-19,AEPS ACQUIRING ADJ FEES 1,,2017-09-19,23.6,,-500003975.8600007,.
409000438620',2017-09-19,AEPS ACQ CR ADJ FEES 1809,,2017-09-19,2861.22,,-500006837.08000076,.
409000438620',2017-09-19,CR722816791831/RMCPL14603/1,,2017-09-19,10000.0,,-500016837.08000076,.
409000438620',2017-09-19,CR724016754893/RMCPL16659/2,,2017-09-19,1000.0,,-500017837.08000076,.
409000438620',2017-09-19,CR724016754482/RMCPL00021/2,,2017-09-19,1000.0,,-500018837.08000076,.
409000438620',2017-09-19,CR724016755443/RMCPL00116/2,,2017-09-19,510.0,,-500019347.08000076,.
409000438620',2017-09-19,CR724218913063/RMCPL09986/3,,2017-09-19,1020.0,,-500020367.08000076,.
409000438620',2017-09-19,CR724616859110/RMCPL03862/0,,2017-09-19,310.0,,-500020677.08000076,.
409000438620',2017-09-19,CR724410688093/RMCPL14809/0,,2017-09-19,1471.0,,-500022148.08000076,.
409000438620',2017-09-19,CR724410687987/RMCPL17320/0,,2017-09-19,3000.0,,-500025148.08000076,.
409000438620',2017-09-19,CR725309352325/RMCPL18099/1,,2017-09-19,3000.0,,-500028148.08000076,.
409000438620',2017-09-19,CR725116515719/RMCPL12121/0,,2017-09-19,510.0,,-500028658.08000076,.
409000438620',2017-09-19,CR725019081703/RMCPL15907/0,,2017-09-19,210.0,,-500028868.08000076,.
409000438620',2017-09-19,CR725019081772/RMCPL00322/0,,2017-09-19,600.0,,-500029468.08000076,.
409000438620',2017-09-19,CR725019081362/RMCPL11260/0,,2017-09-19,5000.0,,-500034468.08000076,.
409000438620',2017-09-19,CR725019081570/RMCPL03136/0,,2017-09-19,3000.0,,-500037468.08000076,.
409000438620',2017-09-19,CR725019102074/RMCPL17115/0,,2017-09-19,1500.0,,-500038968.08000076,.
409000438620',2017-09-19,CR725019081832/RMCPL17943/0,,2017-09-19,5400.0,,-500044368.08000076,.
409000438620',2017-09-19,CR725019077809/RMCPL02276/0,,2017-09-19,1000.0,,-500045368.08000076,.
409000438620',2017-09-19,CR725019077824/RMCPL09727/0,,2017-09-19,5000.0,,-500050368.08000076,.
409000438620',2017-09-19,CR725019077916/RMCPL16636/0,,2017-09-19,110.0,,-500050478.08000076,.
409000438620',2017-09-19,CR725019078043/RMCPL10913/0,,2017-09-19,1000.0,,-500051478.08000076,.
409000438620',2017-09-19,CR725019078114/RMCPL11728/0,,2017-09-19,200.0,,-500051678.08000076,.
409000438620',2017-09-19,CR725019078136/RMCPL11328/0,,2017-09-19,2550.0,,-500054228.08000076,.
409000438620',2017-09-19,CR725019078139/RMCPL13006/0,,2017-09-19,220.0,,-500054448.08000076,.
409000438620',2017-09-19,CR725019078309/RMCPL16289/0,,2017-09-19,10000.0,,-500064448.08000076,.
409000438620',2017-09-19,CR725019102004/RMCPL10932/0,,2017-09-19,5100.0,,-500069548.08000076,.
409000438620',2017-09-19,CR725019081683/RMCPL18067/0,,2017-09-19,100.0,,-500069648.08000076,.
409000438620',2017-09-19,CR725610935074/RMCPL09759/1,,2017-09-19,520.0,,-500070168.08000076,.
409000438620',2017-09-19,CR725610935134/RMCPL15703/1,,2017-09-19,10000.0,,-500080168.08000076,.
409000438620',2017-09-19,CR725610935144/RMCPL13846/1,,2017-09-19,500.0,,-500080668.08000076,.
409000438620',2017-09-19,CR725611986739/RMCPL17375/1,,2017-09-19,1600.0,,-500082268.08000076,.
409000438620',2017-09-19,CR725611985811/RMCPL10677/1,,2017-09-19,500.0,,-500082768.08000076,.
409000438620',2017-09-19,CR725610963359/RMCPL12418/1,,2017-09-19,10000.0,,-500092768.08000076,.
409000438620',2017-09-19,CR725610951924/RMCPL14078/1,,2017-09-19,1000.0,,-500093768.08000076,.
409000438620',2017-09-19,CR725610951873/RMCPL12483/1,,2017-09-19,520.0,,-500094288.08000076,.
409000438620',2017-09-19,CR725610951696/RMCPL07811/1,,2017-09-19,510.0,,-500094798.08000076,.
409000438620',2017-09-19,CR725610951930/RMCPL15646/1,,2017-09-19,6000.0,,-500100798.08000076,.
409000438620',2017-09-19,CR725610934932/RMCPL11327/1,,2017-09-19,3500.0,,-500104298.08000076,.
409000438620',2017-09-19,CR725610934939/RMCPL16768/1,,2017-09-19,2600.0,,-500106898.08000076,.
409000438620',2017-09-19,CR725610934956/RMCPL14710/1,,2017-09-19,3000.0,,-500109898.08000076,.
409000438620',2017-09-19,CR725611972725/RMCPL14781/1,,2017-09-19,4000.0,,-500113898.08000076,.
409000438620',2017-09-19,CR725610963592/RMCPL16925/1,,2017-09-19,6000.0,,-500119898.08000076,.
409000438620',2017-09-19,CR725610963666/RMCPL00519/1,,2017-09-19,3060.0,,-500122958.08000076,.
409000438620',2017-09-19,CR725610963675/RMCPL13298/1,,2017-09-19,1020.0,,-500123978.08000076,.
409000438620',2017-09-19,CR725610963723/RMCPL17809/1,,2017-09-19,1000.0,,-500124978.08000076,.
409000438620',2017-09-19,CR725611972825/RMCPL17040/1,,2017-09-19,8080.0,,-500133058.08000076,.
409000438620',2017-09-19,CR725610963792/RMCPL11959/1,,2017-09-19,500.0,,-500133558.08000076,.
409000438620',2017-09-19,CR725611973076/RMCPL16629/1,,2017-09-19,2040.0,,-500135598.08000076,.
409000438620',2017-09-19,CR725611972599/RMCPL18567/1,,2017-09-19,1000.0,,-500136598.08000076,.
409000438620',2017-09-19,CR725611973311/RMCPL18323/1,,2017-09-19,100.0,,-500136698.08000076,.
409000438620',2017-09-19,CR725610934133/RMCPL10794/1,,2017-09-19,2000.0,,-500138698.08000076,.
409000438620',2017-09-19,CR725610934240/RMCPL03736/1,,2017-09-19,2000.0,,-500140698.08000076,.
409000438620',2017-09-19,CR725610957526/RMCPL17107/1,,2017-09-19,2020.0,,-500142718.08000076,.
409000438620',2017-09-19,CR725611972564/RMCPL09611/1,,2017-09-19,1000.0,,-500143718.08000076,.
409000438620',2017-09-19,CR725611972681/RMCPL00012/1,,2017-09-19,10000.0,,-500153718.08000076,.
409000438620',2017-09-19,CR725610963978/RMCPL17074/1,,2017-09-19,2000.0,,-500155718.08000076,.
409000438620',2017-09-19,CR725610964042/RMCPL02162/1,,2017-09-19,1000.0,,-500156718.08000076,.
409000438620',2017-09-19,CR725610934229/RMCPL17049/1,,2017-09-19,510.0,,-500157228.08000076,.
409000438620',2017-09-19,CR725611998441/RMCPL15981/1,,2017-09-19,2000.0,,-500159228.08000076,.
409000438620',2017-09-19,CR725610964442/RMCPL11931/1,,2017-09-19,7000.0,,-500166228.08000076,.
409000438620',2017-09-19,CR725610964539/RMCPL15557/1,,2017-09-19,1500.0,,-500167728.08000076,.
409000438620',2017-09-19,CR725610964674/RMCPL17397/1,,2017-09-19,1300.0,,-500169028.08000076,.
409000438620',2017-09-19,CR725610934248/RMCPL18148/1,,2017-09-19,3000.0,,-500172028.08000076,.
409000438620',2017-09-19,CR725610934198/RMCPL13568/1,,2017-09-19,3000.0,,-500175028.08000076,.
409000438620',2017-09-19,CR725610935211/RMCPL12448/1,,2017-09-19,10000.0,,-500185028.08000076,.
409000438620',2017-09-19,CR725610935257/RMCPL10752/1,,2017-09-19,6000.0,,-500191028.08000076,.
409000438620',2017-09-19,CR725611002143/RMCPL10987/1,,2017-09-19,3000.0,,-500194028.08000076,.
409000438620',2017-09-19,CR725611998590/RMCPL06484/1,,2017-09-19,1420.0,,-500195448.08000076,.
409000438620',2017-09-19,CR725611002356/RMCPL00052/1,,2017-09-19,1015.0,,-500196463.08000076,.
409000438620',2017-09-19,CR725611981183/RMCPL16824/1,,2017-09-19,5000.0,,-500201463.08000076,.
409000438620',2017-09-19,CR725611985136/RMCPL09082/1,,2017-09-19,2000.0,,-500203463.08000076,.
409000438620',2017-09-19,CR725611975496/RMCPL17095/1,,2017-09-19,10000.0,,-500213463.08000076,.
409000438620',2017-09-19,CR725611981292/RMCPL11996/1,,2017-09-19,520.0,,-500213983.08000076,.
409000438620',2017-09-19,CR725611981342/RMCPL11139/1,,2017-09-19,100.0,,-500214083.08000076,.
409000438620',2017-09-19,CR725611981467/RMCPL09186/1,,2017-09-19,100.0,,-500214183.08000076,.
409000438620',2017-09-19,CR725611985284/RMCPL14483/1,,2017-09-19,200.0,,-500214383.08000076,.
409000438620',2017-09-19,CR725611985466/RMCPL00414/1,,2017-09-19,500.0,,-500214883.08000076,.
409000438620',2017-09-19,CR725611975082/RMCPL15360/1,,2017-09-19,650.0,,-500215533.08000076,.
409000438620',2017-09-19,CR725611985864/RMCPL09999/1,,2017-09-19,1010.0,,-500216543.08000076,.
409000438620',2017-09-19,CR725611985881/RMCPL17775/1,,2017-09-19,300.0,,-500216843.08000076,.
409000438620',2017-09-19,CR725611981765/RMCPL09294/1,,2017-09-19,5200.0,,-500222043.08000076,.
409000438620',2017-09-19,CR725611981707/RMCPL15034/1,,2017-09-19,500.0,,-500222543.08000076,.
409000438620',2017-09-19,CR725611985686/RMCPL13084/1,,2017-09-19,1500.0,,-500224043.08000076,.
409000438620',2017-09-19,CR725611985738/RMCPL11749/1,,2017-09-19,2000.0,,-500226043.08000076,.
409000438620',2017-09-19,CR725611985749/RMCPL05156/1,,2017-09-19,1000.0,,-500227043.08000076,.
409000438620',2017-09-19,CR725611985777/RMCPL03631/1,,2017-09-19,6000.0,,-500233043.08000076,.
409000438620',2017-09-19,CR725611985807/RMCPL07093/1,,2017-09-19,5000.0,,-500238043.08000076,.
409000438620',2017-09-19,CR725611985816/RMCPL09328/1,,2017-09-19,3000.0,,-500241043.08000076,.
409000438620',2017-09-19,CR725611985939/RMCPL15534/1,,2017-09-19,1000.0,,-500242043.08000076,.
409000438620',2017-09-19,CR725611985112/RMCPL16425/1,,2017-09-19,2020.0,,-500244063.08000076,.
409000438620',2017-09-19,CR725611985210/RMCPL14751/1,,2017-09-19,100.0,,-500244163.08000076,.
409000438620',2017-09-19,CR725611986059/RMCPL10675/1,,2017-09-19,500.0,,-500244663.08000076,.
409000438620',2017-09-19,CR725611973978/RMCPL17149/1,,2017-09-19,100.0,,-500244763.08000076,.
409000438620',2017-09-19,CR725611973181/RMCPL14040/1,,2017-09-19,500.0,,-500245263.08000076,.
409000438620',2017-09-19,CR725611973307/RMCPL17461/1,,2017-09-19,1000.0,,-500246263.08000076,.
409000438620',2017-09-19,CR725611973310/RMCPL15499/1,,2017-09-19,400.0,,-500246663.08000076,.
409000438620',2017-09-19,CR725611973833/RMCPL14112/1,,2017-09-19,9000.0,,-500255663.08000076,.
409000438620',2017-09-19,CR725611973892/RMCPL09397/1,,2017-09-19,2000.0,,-500257663.08000076,.
409000438620',2017-09-19,CR725611973896/RMCPL10041/1,,2017-09-19,100.0,,-500257763.08000076,.
409000438620',2017-09-19,CR725611973425/RMCPL18487/1,,2017-09-19,400.0,,-500258163.08000076,.
409000438620',2017-09-19,CR725611972779/RMCPL13003/1,,2017-09-19,520.0,,-500258683.08000076,.
409000438620',2017-09-19,CR725611973575/RMCPL13833/1,,2017-09-19,1030.0,,-500259713.08000076,.
409000438620',2017-09-19,CR725611973586/RMCPL15577/1,,2017-09-19,800.0,,-500260513.08000076,.
409000438620',2017-09-19,CR725611973795/RMCPL15427/1,,2017-09-19,1000.0,,-500261513.08000076,.
409000438620',2017-09-19,CR725610934386/RMCPL10781/1,,2017-09-19,200.0,,-500261713.08000076,.
409000438620',2017-09-19,CR725611987271/RMCPL14481/1,,2017-09-19,2000.0,,-500263713.08000076,.
409000438620',2017-09-19,CR725611987273/RMCPL14813/1,,2017-09-19,5000.0,,-500268713.08000076,.
409000438620',2017-09-19,CR725611987294/RMCPL17974/1,,2017-09-19,2000.0,,-500270713.08000076,.
409000438620',2017-09-19,CR725611987322/RMCPL14995/1,,2017-09-19,110.0,,-500270823.08000076,.
409000438620',2017-09-19,CR725610934549/RMCPL10075/1,,2017-09-19,4500.0,,-500275323.08000076,.
409000438620',2017-09-19,CR725610934657/RMCPL10080/1,,2017-09-19,410.0,,-500275733.08000076,.
409000438620',2017-09-19,CR725610934667/RMCPL10371/1,,2017-09-19,6000.0,,-500281733.08000076,.
409000438620',2017-09-19,CR725610934734/RMCPL15556/1,,2017-09-19,2000.0,,-500283733.08000076,.
409000438620',2017-09-19,CR725610934746/RMCPL16859/1,,2017-09-19,2000.0,,-500285733.08000076,.
409000438620',2017-09-19,CR725611987567/RMCPL14084/1,,2017-09-19,4000.0,,-500289733.08000076,.
409000438620',2017-09-19,CR725611987699/RMCPL12897/1,,2017-09-19,1500.0,,-500291233.08000076,.
409000438620',2017-09-19,CR725610934803/RMCPL14104/1,,2017-09-19,6000.0,,-500297233.08000076,.
409000438620',2017-09-19,CR725610934811/RMCPL13099/1,,2017-09-19,9000.0,,-500306233.08000076,.
409000438620',2017-09-19,CR725610933729/RMCPL17747/1,,2017-09-19,1200.0,,-500307433.08000076,.
409000438620',2017-09-19,CR725610933948/RMCPL07354/1,,2017-09-19,5000.0,,-500312433.08000076,.
409000438620',2017-09-19,CR725610941941/RMCPL06541/1,,2017-09-19,2000.0,,-500314433.08000076,.
409000438620',2017-09-19,CR725610933735/RMCPL16637/1,,2017-09-19,2000.0,,-500316433.08000076,.
409000438620',2017-09-19,CR725610933749/RMCPL09286/1,,2017-09-19,300.0,,-500316733.08000076,.
409000438620',2017-09-19,CR725610933766/RMCPL14239/1,,2017-09-19,6500.0,,-500323233.08000076,.
409000438620',2017-09-19,CR725610933734/RMCPL15657/1,,2017-09-19,2040.0,,-500325273.08000076,.
409000438620',2017-09-19,CR725610933787/RMCPL12579/1,,2017-09-19,820.0,,-500326093.08000076,.
409000438620',2017-09-19,CR725610933815/RMCPL14740/1,,2017-09-19,3030.0,,-500329123.08000076,.
409000438620',2017-09-19,CR725610933789/RMCPL17277/1,,2017-09-19,3030.0,,-500332153.08000076,.
409000438620',2017-09-19,CR725610940245/RMCPL18162/1,,2017-09-19,2000.0,,-500334153.08000076,.
409000438620',2017-09-19,CR725610933870/RMCPL17648/1,,2017-09-19,500.0,,-500334653.08000076,.
409000438620',2017-09-19,CR725610933902/RMCPL17668/1,,2017-09-19,4000.0,,-500338653.08000076,.
409000438620',2017-09-19,CR725610933916/RMCPL00278/1,,2017-09-19,3000.0,,-500341653.08000076,.
409000438620',2017-09-19,CR725610933929/RMCPL00197/1,,2017-09-19,500.0,,-500342153.08000076,.
409000438620',2017-09-19,CR725610933939/RMCPL13561/1,,2017-09-19,730.0,,-500342883.08000076,.
409000438620',2017-09-19,CR725610934134/RMCPL07558/1,,2017-09-19,10000.0,,-500352883.08000076,.
409000438620',2017-09-19,CR725610934142/RMCPL11618/1,,2017-09-19,10000.0,,-500362883.08000076,.
409000438620',2017-09-19,CR725610941018/RMCPL15184/1,,2017-09-19,1000.0,,-500363883.08000076,.
409000438620',2017-09-19,CR725610941038/RMCPL00024/1,,2017-09-19,1030.0,,-500364913.08000076,.
409000438620',2017-09-19,CR725610940735/RMCPL16243/1,,2017-09-19,10000.0,,-500374913.08000076,.
409000438620',2017-09-19,CR725611974572/RMCPL16592/1,,2017-09-19,100.0,,-500375013.08000076,.
409000438620',2017-09-19,CR725611974605/RMCPL13867/1,,2017-09-19,800.0,,-500375813.08000076,.
409000438620',2017-09-19,CR725611974822/RMCPL18476/1,,2017-09-19,1200.0,,-500377013.08000076,.
409000438620',2017-09-19,CR725611974885/RMCPL16452/1,,2017-09-19,1000.0,,-500378013.08000076,.
409000438620',2017-09-19,CR725611974887/RMCPL14017/1,,2017-09-19,3800.0,,-500381813.08000076,.
409000438620',2017-09-19,CR725611974982/RMCPL15334/1,,2017-09-19,500.0,,-500382313.08000076,.
409000438620',2017-09-19,CR725610935294/RMCPL13024/1,,2017-09-19,5000.0,,-500387313.08000076,.
409000438620',2017-09-19,CR725610935331/RMCPL18075/1,,2017-09-19,105.0,,-500387418.08000076,.
409000438620',2017-09-19,CR725610939041/RMCPL13270/1,,2017-09-19,1000.0,,-500388418.08000076,.
409000438620',2017-09-19,CR725610939320/RMCPL10820/1,,2017-09-19,2500.0,,-500390918.08000076,.
409000438620',2017-09-19,CR725610957091/RMCPL17443/1,,2017-09-19,2000.0,,-500392918.08000076,.
409000438620',2017-09-19,CR725610933956/RMCPL18173/1,,2017-09-19,5000.0,,-500397918.08000076,.
409000438620',2017-09-19,CR725610933980/RMCPL15207/1,,2017-09-19,500.0,,-500398418.08000076,.
409000438620',2017-09-19,CR725610934000/RMCPL15704/1,,2017-09-19,3500.0,,-500401918.08000076,.
409000438620',2017-09-19,CR725610934027/RMCPL00020/1,,2017-09-19,1320.0,,-500403238.08000076,.
409000438620',2017-09-19,CR725610934029/RMCPL11413/1,,2017-09-19,5050.0,,-500408288.08000076,.
409000438620',2017-09-19,CR725610934034/RMCPL12164/1,,2017-09-19,400.0,,-500408688.08000076,.
409000438620',2017-09-19,CR725610940421/RMCPL18559/1,,2017-09-19,100.0,,-500408788.08000076,.
409000438620',2017-09-19,CR725610940783/RMCPL17560/1,,2017-09-19,3000.0,,-500411788.08000076,.
409000438620',2017-09-19,CR725610934088/RMCPL13809/1,,2017-09-19,3000.0,,-500414788.08000076,.
409000438620',2017-09-19,CR725610934113/RMCPL14238/1,,2017-09-19,10000.0,,-500424788.08000076,.
409000438620',2017-09-19,CR725610934117/RMCPL13592/1,,2017-09-19,1000.0,,-500425788.08000076,.
409000438620',2017-09-19,CR725610941736/RMCPL10748/1,,2017-09-19,1515.0,,-500427303.08000076,.
409000438620',2017-09-19,CR725610941892/RMCPL00190/1,,2017-09-19,1400.0,,-500428703.08000076,.
409000438620',2017-09-19,CR725610942389/RMCPL18302/1,,2017-09-19,2000.0,,-500430703.08000076,.
409000438620',2017-09-19,CR725610942542/RMCPL18482/1,,2017-09-19,5000.0,,-500435703.08000076,.
409000438620',2017-09-19,CR725610942797/RMCPL10735/1,,2017-09-19,1000.0,,-500436703.08000076,.
409000438620',2017-09-19,CR725610942807/RMCPL07740/1,,2017-09-19,10000.0,,-500446703.08000076,.
409000438620',2017-09-19,CR725610934871/RMCPL17640/1,,2017-09-19,3000.0,,-500449703.08000076,.
409000438620',2017-09-19,CR725610945390/RMCPL15158/1,,2017-09-19,200.0,,-500449903.08000076,.
409000438620',2017-09-19,CR725610945242/RMCPL08315/1,,2017-09-19,1000.0,,-500450903.08000076,.
409000438620',2017-09-19,CR725610945468/RMCPL14461/1,,2017-09-19,2500.0,,-500453403.08000076,.
409000438620',2017-09-19,CR725610935453/RMCPL12377/1,,2017-09-19,7100.0,,-500460503.08000076,.
409000438620',2017-09-19,CR725610952600/RMCPL11350/1,,2017-09-19,5050.0,,-500465553.08000076,.
409000438620',2017-09-19,CR725610952594/RMCPL16397/1,,2017-09-19,5000.0,,-500470553.08000076,.
409000438620',2017-09-19,CR725610957101/RMCPL15380/1,,2017-09-19,10000.0,,-500480553.08000076,.
409000438620',2017-09-19,CR725610957206/RMCPL10724/1,,2017-09-19,4900.0,,-500485453.08000076,.
409000438620',2017-09-19,CR725611975049/RMCPL01289/1,,2017-09-19,720.0,,-500486173.08000076,.
409000438620',2017-09-19,CR725611981532/RMCPL01553/1,,2017-09-19,5050.0,,-500491223.08000076,.
409000438620',2017-09-19,CR725611981427/RMCPL15654/1,,2017-09-19,410.0,,-500491633.08000076,.
409000438620',2017-09-19,CR725611980421/RMCPL18410/1,,2017-09-19,300.0,,-500491933.08000076,.
409000438620',2017-09-19,CR725611980423/RMCPL14104/1,,2017-09-19,10000.0,,-500501933.08000076,.
409000438620',2017-09-19,CR725611980561/RMCPL09932/1,,2017-09-19,1000.0,,-500502933.08000076,.
409000438620',2017-09-19,CR725611997212/RMCPL15376/1,,2017-09-19,4040.0,,-500506973.08000076,.
409000438620',2017-09-19,CR725611975997/RMCPL13504/1,,2017-09-19,10000.0,,-500516973.08000076,.
409000438620',2017-09-19,CR725611975998/RMCPL09789/1,,2017-09-19,5000.0,,-500521973.08000076,.
409000438620',2017-09-19,CR725611980522/RMCPL09883/1,,2017-09-19,410.0,,-500522383.08000076,.
409000438620',2017-09-19,CR725611980773/RMCPL11685/1,,2017-09-19,2010.0,,-500524393.08000076,.
409000438620',2017-09-19,CR725611997012/RMCPL00012/1,,2017-09-19,3000.0,,-500527393.08000076,.
409000438620',2017-09-19,CR725611997046/RMCPL13564/1,,2017-09-19,730.0,,-500528123.08000076,.
409000438620',2017-09-19,CR725611997268/RMCPL14534/1,,2017-09-19,111.0,,-500528234.08000076,.
409000438620',2017-09-19,CR725611997975/RMCPL16134/1,,2017-09-19,300.0,,-500528534.08000076,.
409000438620',2017-09-19,CR725611997399/RMCPL16766/1,,2017-09-19,2000.0,,-500530534.08000076,.
409000438620',2017-09-19,CR725611997402/RMCPL15907/1,,2017-09-19,3030.0,,-500533564.08000076,.
409000438620',2017-09-19,CR725611997409/RMCPL17274/1,,2017-09-19,200.0,,-500533764.08000076,.
409000438620',2017-09-19,CR725610935480/RMCPL09984/1,,2017-09-19,10000.0,,-500543764.08000076,.
409000438620',2017-09-19,CR725610935500/RMCPL17698/1,,2017-09-19,600.0,,-500544364.08000076,.
409000438620',2017-09-19,CR725610935755/RMCPL13679/1,,2017-09-19,1220.0,,-500545584.08000076,.
409000438620',2017-09-19,CR725610935840/RMCPL17542/1,,2017-09-19,605.0,,-500546189.08000076,.
409000438620',2017-09-19,CR725610935878/RMCPL13699/1,,2017-09-19,100.0,,-500546289.08000076,.
409000438620',2017-09-19,CR725610935913/RMCPL08472/1,,2017-09-19,100.0,,-500546389.08000076,.
409000438620',2017-09-19,CR725610936021/RMCPL17908/1,,2017-09-19,9000.0,,-500555389.08000076,.
409000438620',2017-09-19,CR725610936095/RMCPL16343/1,,2017-09-19,410.0,,-500555799.08000076,.
409000438620',2017-09-19,CR725610936110/RMCPL17831/1,,2017-09-19,1900.0,,-500557699.08000076,.
409000438620',2017-09-19,CR725610935705/RMCPL16999/1,,2017-09-19,3800.0,,-500561499.08000076,.
409000438620',2017-09-19,CR725610935706/RMCPL17531/1,,2017-09-19,200.0,,-500561699.08000076,.
409000438620',2017-09-19,CR725610936275/RMCPL10937/1,,2017-09-19,5000.0,,-500566699.08000076,.
409000438620',2017-09-19,CR725610937334/RMCPL14181/1,,2017-09-19,10000.0,,-500576699.08000076,.
409000438620',2017-09-19,CR725610936952/RMCPL16258/1,,2017-09-19,3000.0,,-500579699.08000076,.
409000438620',2017-09-19,CR725610946171/RMCPL06723/1,,2017-09-19,1000.0,,-500580699.08000076,.
409000438620',2017-09-19,CR725610946962/RMCPL06945/1,,2017-09-19,10000.0,,-500590699.08000076,.
409000438620',2017-09-19,CR725610947132/RMCPL14020/1,,2017-09-19,2000.0,,-500592699.08000076,.
409000438620',2017-09-19,CR725610943986/RMCPL10930/1,,2017-09-19,5000.0,,-500597699.08000076,.
409000438620',2017-09-19,CR725610944041/RMCPL14755/1,,2017-09-19,3000.0,,-500600699.08000076,.
409000438620',2017-09-19,CR725610944544/RMCPL03048/1,,2017-09-19,2050.0,,-500602749.08000076,.
409000438620',2017-09-19,CR725610934960/RMCPL09824/1,,2017-09-19,2040.0,,-500604789.08000076,.
409000438620',2017-09-19,CR725610935032/RMCPL10932/1,,2017-09-19,530.0,,-500605319.08000076,.
409000438620',2017-09-19,CR725610939190/RMCPL11375/1,,2017-09-19,10000.0,,-500615319.08000076,.
409000438620',2017-09-19,CR725611985333/RMCPL17056/1,,2017-09-19,3000.0,,-500618319.08000076,.
409000438620',2017-09-19,CR725611985631/RMCPL14088/1,,2017-09-19,500.0,,-500618819.08000076,.
409000438620',2017-09-19,CR725611985786/RMCPL09448/1,,2017-09-19,1020.0,,-500619839.08000076,.
409000438620',2017-09-19,CR725610963522/RMCPL05244/1,,2017-09-19,1020.0,,-500620859.08000076,.
409000438620',2017-09-19,CR725610943222/RMCPL02837/1,,2017-09-19,500.0,,-500621359.08000076,.
409000438620',2017-09-19,CR725610943497/RMCPL13564/1,,2017-09-19,730.0,,-500622089.08000076,.
409000438620',2017-09-19,CR725610948464/RMCPL14249/1,,2017-09-19,300.0,,-500622389.08000076,.
409000438620',2017-09-19,CR725610944665/RMCPL11360/1,,2017-09-19,5050.0,,-500627439.08000076,.
409000438620',2017-09-19,CR725610945199/RMCPL09998/1,,2017-09-19,10000.0,,-500637439.08000076,.
409000438620',2017-09-19,CR725610944698/RMCPL12979/1,,2017-09-19,7000.0,,-500644439.08000076,.
409000438620',2017-09-19,CR725610948178/RMCPL16481/1,,2017-09-19,1000.0,,-500645439.08000076,.
409000438620',2017-09-19,CR725610945189/RMCPL12748/1,,2017-09-19,510.0,,-500645949.08000076,.
409000438620',2017-09-19,CR725610950915/RMCPL17187/1,,2017-09-19,400.0,,-500646349.08000076,.
409000438620',2017-09-19,CR725610951512/RMCPL13120/1,,2017-09-19,2000.0,,-500648349.08000076,.
409000438620',2017-09-19,CR725611986944/RMCPL14469/1,,2017-09-19,10000.0,,-500658349.08000076,.
409000438620',2017-09-19,CR725611986980/RMCPL11195/1,,2017-09-19,1515.0,,-500659864.08000076,.
409000438620',2017-09-19,CR725610935093/RMCPL13947/1,,2017-09-19,1550.0,,-500661414.08000076,.
409000438620',2017-09-19,CR725611973807/RMCPL13162/1,,2017-09-19,100.0,,-500661514.08000076,.
409000438620',2017-09-19,CR725610950341/RMCPL09945/1,,2017-09-19,5031.0,,-500666545.08000076,.
409000438620',2017-09-19,CR725610950850/RMCPL10036/1,,2017-09-19,5000.0,,-500671545.08000076,.
409000438620',2017-09-19,CR725611972889/RMCPL17307/1,,2017-09-19,3000.0,,-500674545.08000076,.
409000438620',2017-09-19,CR725611972894/RMCPL00404/1,,2017-09-19,1000.0,,-500675545.08000076,.
409000438620',2017-09-19,CR725611972452/RMCPL16230/1,,2017-09-19,2000.0,,-500677545.08000076,.
409000438620',2017-09-19,CR725611973035/RMCPL13028/1,,2017-09-19,5000.0,,-500682545.08000076,.
409000438620',2017-09-19,CR725611972577/RMCPL18375/1,,2017-09-19,3000.0,,-500685545.08000076,.
409000438620',2017-09-19,CR725611001710/RMCPL17954/1,,2017-09-19,1300.0,,-500686845.08000076,.
409000438620',2017-09-19,CR725610949133/RMCPL15995/1,,2017-09-19,110.0,,-500686955.08000076,.
409000438620',2017-09-19,CR725610949218/RMCPL12984/1,,2017-09-19,1010.0,,-500687965.08000076,.
409000438620',2017-09-19,CR725610949463/RMCPL14454/1,,2017-09-19,10000.0,,-500697965.08000076,.
409000438620',2017-09-19,CR725611000555/RMCPL07483/1,,2017-09-19,500.0,,-500698465.08000076,.
409000438620',2017-09-19,CR725611000831/RMCPL14445/1,,2017-09-19,5500.0,,-500703965.08000076,.
409000438620',2017-09-19,CR725611000835/RMCPL16592/1,,2017-09-19,100.0,,-500704065.08000076,.
409000438620',2017-09-19,CR725610933713/RMCPL11759/1,,2017-09-19,3000.0,,-500707065.08000076,.
409000438620',2017-09-19,CR725610933716/RMCPL15211/1,,2017-09-19,2000.0,,-500709065.08000076,.
409000438620',2017-09-19,CR725611000905/RMCPL00093/1,,2017-09-19,1000.0,,-500710065.08000076,.
409000438620',2017-09-19,CR725611000966/RMCPL14164/1,,2017-09-19,5000.0,,-500715065.08000076,.
409000438620',2017-09-19,CR725610933717/RMCPL12613/1,,2017-09-19,2400.0,,-500717465.08000076,.
409000438620',2017-09-19,CR725610934351/RMCPL17674/1,,2017-09-19,350.0,,-500717815.08000076,.
409000438620',2017-09-19,CR725610934438/RMCPL01530/1,,2017-09-19,300.0,,-500718115.08000076,.
409000438620',2017-09-19,CR725610934501/RMCPL11140/1,,2017-09-19,750.0,,-500718865.08000076,.
409000438620',2017-09-19,CR725610934621/RMCPL17673/1,,2017-09-19,2520.0,,-500721385.08000076,.
409000438620',2017-09-19,CR725611998894/RMCPL00139/1,,2017-09-19,1200.0,,-500722585.08000076,.
409000438620',2017-09-19,CR725611998906/RMCPL17173/1,,2017-09-19,4600.0,,-500727185.08000076,.
409000438620',2017-09-19,CR725611987152/RMCPL12411/1,,2017-09-19,10000.0,,-500737185.08000076,.
409000438620',2017-09-19,CR725610934310/RMCPL15095/1,,2017-09-19,3000.0,,-500740185.08000076,.
409000438620',2017-09-19,CR725610934377/RMCPL14997/1,,2017-09-19,2100.0,,-500742285.08000076,.
409000438620',2017-09-19,CR725610937459/RMCPL17206/1,,2017-09-19,505.0,,-500742790.08000076,.
409000438620',2017-09-19,CR725610937559/RMCPL16733/1,,2017-09-19,1000.0,,-500743790.08000076,.
409000438620',2017-09-19,CR725610937150/RMCPL07673/1,,2017-09-19,1300.0,,-500745090.08000076,.
409000438620',2017-09-19,CR725610937280/RMCPL10677/1,,2017-09-19,1050.0,,-500746140.08000076,.
409000438620',2017-09-19,CR725610937842/RMCPL18037/1,,2017-09-19,2000.0,,-500748140.08000076,.
409000438620',2017-09-19,CR725610938021/RMCPL09448/1,,2017-09-19,1020.0,,-500749160.08000076,.
409000438620',2017-09-19,CR725610937867/RMCPL17438/1,,2017-09-19,500.0,,-500749660.08000076,.
409000438620',2017-09-19,CR725610938360/RMCPL13377/1,,2017-09-19,1600.0,,-500751260.08000076,.
409000438620',2017-09-19,CR725610937957/RMCPL13918/1,,2017-09-19,10000.0,,-500761260.08000076,.
409000438620',2017-09-19,CR725610938532/RMCPL14780/1,,2017-09-19,10000.0,,-500771260.08000076,.
409000438620',2017-09-19,CR725610936294/RMCPL02773/1,,2017-09-19,510.0,,-500771770.08000076,.
409000438620',2017-09-19,CR725610936314/RMCPL13536/1,,2017-09-19,5000.0,,-500776770.08000076,.
409000438620',2017-09-19,CR725610936307/RMCPL08471/1,,2017-09-19,1020.0,,-500777790.08000076,.
409000438620',2017-09-19,CR725610936348/RMCPL14869/1,,2017-09-19,3000.0,,-500780790.08000076,.
409000438620',2017-09-19,CR725610936647/RMCPL12366/1,,2017-09-19,2000.0,,-500782790.08000076,.
409000438620',2017-09-19,CR725610936612/RMCPL18074/1,,2017-09-19,2900.0,,-500785690.08000076,.
409000438620',2017-09-19,CR725610937191/RMCPL13509/1,,2017-09-19,5800.0,,-500791490.08000076,.
409000438620',2017-09-19,AEPS Indiaforensic INCOME 180917,,2017-09-19,,186017.84,-500605472.2400008,.
409000438620',2017-09-19,AEPS Indiaforensic GST 180917,,2017-09-19,,33483.21,-500571989.0300008,.
409000438620',2017-09-19,Indiaforensic AEPS NPCI DEP SET,,2017-09-19,29116530.0,,-529688519.0300008,.
409000438620',2017-09-19,TRF TO  Indiaforensic SERVICES I,,2017-09-19,15000000.0,,-544688519.0300008,.
409000438620',2017-09-19,TRF TO  Indiaforensic SERVICES I,,2017-09-19,1600000.0,,-546288519.0300008,.
409000438620',2017-09-20,AEPS Indiaforensic INCOME 190917,,2017-09-20,,179340.17,-546109178.8600008,.
409000438620',2017-09-20,AEPS Indiaforensic GST 190917,,2017-09-20,,32281.23,-546076897.6300008,.
409000438620',2017-09-20,Indiaforensic AEPS NPCI WDL SET,,2017-09-20,,43512718.0,-502564179.6300008,.
409000438620',2017-09-20,Indfor RIF AEPS NPCI WDL SET,,2017-09-20,,2800.0,-502561379.6300008,.
409000438620',2017-09-20,Indiaforensic AEPS NPCI DEP SET,,2017-09-20,29800391.0,,-532361770.6300008,.
409000438620',2017-09-20,TRF TO  Indiaforensic SERVICES I,,2017-09-20,13900000.0,,-546261770.6300008,.
409000438620',2017-09-21,AEPS ACQ REP ADJ FEES 200,,2017-09-21,,23.6,-546261747.0300008,.
409000438620',2017-09-21,AEPS Indiaforensic INCOME 200917,,2017-09-21,,176027.23,-546085719.8000008,.
409000438620',2017-09-21,AEPS Indiaforensic GST 200917,,2017-09-21,,31684.9,-546054034.9000008,.
409000438620',2017-09-21,Indiaforensic AEPS NPCI WDL SET,,2017-09-21,,43111824.0,-502942210.9000008,.
409000438620',2017-09-21,Indiaforensic AEPS NPCI DEP SET,,2017-09-21,28883823.0,,-531826033.9000008,.
409000438620',2017-09-21,TRF TO  Indiaforensic SERVICES I,,2017-09-21,14400000.0,,-546226033.9000008,.
409000438620',2017-09-22,AEPS ACQUIRING ADJ FEES 2,,2017-09-22,5.9,,-546226039.8000008,.
409000438620',2017-09-22,AEPS Indiaforensic INCOME 210917,,2017-09-22,,172447.99,-546053591.8100008,.
409000438620',2017-09-22,AEPS Indiaforensic GST 210917,,2017-09-22,,31040.64,-546022551.1700008,.
409000438620',2017-09-22,Indiaforensic AEPS NPCI WDL SET,,2017-09-22,,42050758.0,-503971793.1700008,.
409000438620',2017-09-22,Indiaforensic AEPS NPCI DEP SET,,2017-09-22,30057328.0,,-534029121.1700008,.
409000438620',2017-09-22,TRF TO  Indiaforensic SERVICES I,,2017-09-22,12285000.0,,-546314121.1700008,.
409000438620',2017-09-25,AEPS ACQUIRING ADJ FEES 2,,2017-09-25,17.7,,-546314138.8700008,.
409000438620',2017-09-25,AEPS Indiaforensic INCOME 220917,,2017-09-25,,181418.05,-546132720.8200009,.
409000438620',2017-09-25,AEPS Indiaforensic GST 220917,,2017-09-25,,32655.25,-546100065.5700009,.
409000438620',2017-09-25,AEPS Indiaforensic INCOME 230917,,2017-09-25,,146702.58,-545953362.9900008,.
409000438620',2017-09-25,AEPS Indiaforensic GST 230917,,2017-09-25,,26406.46,-545926956.5300008,.
409000438620',2017-09-25,AEPS Indiaforensic INCOME 240917,,2017-09-25,,115587.44,-545811369.0900007,.
409000438620',2017-09-25,AEPS Indiaforensic GST 240917,,2017-09-25,,20805.74,-545790563.3500007,.
409000438620',2017-09-25,Indiaforensic AEPS NPCI WDL SET,,2017-09-25,,44731666.0,-501058897.35000074,.
409000438620',2017-09-25,Indiaforensic AEPS NPCI WDL SET,,2017-09-25,,37079209.0,-463979688.35000074,.
409000438620',2017-09-25,Indiaforensic AEPS NPCI WDL SET,,2017-09-25,,27441379.0,-436538309.35000074,.
409000438620',2017-09-25,Indfor RIF AEPS NPCI WDL SET,,2017-09-25,,800.0,-436537509.35000074,.
409000438620',2017-09-25,Indiaforensic AEPS NPCI DEP SET,,2017-09-25,30880905.0,,-467418414.35000074,.
409000438620',2017-09-25,Indiaforensic AEPS NPCI DEP SET,,2017-09-25,23470738.0,,-490889152.35000074,.
409000438620',2017-09-25,Indiaforensic AEPS NPCI DEP SET,,2017-09-25,20320734.0,,-511209886.35000074,.
409000438620',2017-09-25,TRF TO  Indiaforensic SERVICES I,,2017-09-25,15000000.0,,-526209886.35000074,.
409000438620',2017-09-25,TRF TO  Indiaforensic SERVICES I,,2017-09-25,15000000.0,,-541209886.3500007,.
409000438620',2017-09-25,TRF TO  Indiaforensic SERVICES I,,2017-09-25,5100000.0,,-546309886.3500007,.
409000438620',2017-09-26,AEPS ACQUIRING ADJ FEES 2,,2017-09-26,14.16,,-546309900.5100007,.
409000438620',2017-09-26,AEPS ACQ REP ADJ FEES 250,,2017-09-26,,23.6,-546309876.9100007,.
409000438620',2017-09-26,AEPS Indiaforensic INCOME 250917,,2017-09-26,,200448.6,-546109428.3100007,.
409000438620',2017-09-26,AEPS Indiaforensic GST 250917,,2017-09-26,,36080.75,-546073347.5600007,.
409000438620',2017-09-26,Indiaforensic AEPS NPCI WDL SET,,2017-09-26,,49715527.0,-496357820.56000066,.
409000438620',2017-09-26,Indfor RIF AEPS NPCI WDL SET,,2017-09-26,,20000.0,-496337820.56000066,.
409000438620',2017-09-26,Indiaforensic AEPS NPCI DEP SET,,2017-09-26,31304852.0,,-527642672.56000066,.
409000438620',2017-09-26,TRF TO  Indiaforensic SERVICES I,,2017-09-26,10000000.0,,-537642672.5600007,.
409000438620',2017-09-26,TRF TO  Indiaforensic SERVICES I,,2017-09-26,8600000.0,,-546242672.5600007,.
409000438620',2017-09-27,AEPS ACQ REP ADJ FEES 260,,2017-09-27,,14.16,-546242658.4000007,.
409000438620',2017-09-27,AEPS Indiaforensic INCOME 260917,,2017-09-27,,189232.87,-546053425.5300007,.
409000438620',2017-09-27,AEPS Indiaforensic GST 260917,,2017-09-27,,34061.92,-546019363.6100007,.
409000438620',2017-09-27,Indiaforensic AEPS NPCI WDL SET,,2017-09-27,,46460212.0,-499559151.6100007,.
409000438620',2017-09-27,Indiaforensic AEPS NPCI DEP SET,,2017-09-27,31143999.0,,-530703150.6100007,.
409000438620',2017-09-27,TRF TO  Indiaforensic SERVICES I,,2017-09-27,10000000.0,,-540703150.6100007,.
409000438620',2017-09-27,TRF TO  Indiaforensic SERVICES I,,2017-09-27,5600000.0,,-546303150.6100007,.
409000438620',2017-09-28,AEPS ACQUIRING ADJ FEES 2,,2017-09-28,53.68,,-546303204.2900007,.
409000438620',2017-09-28,AEPS Indiaforensic INCOME 270917,,2017-09-28,,196554.18,-546106650.1100007,.
409000438620',2017-09-28,AEPS Indiaforensic GST 270917,,2017-09-28,,35379.75,-546071270.3600007,.
409000438620',2017-09-28,Indiaforensic AEPS NPCI WDL SET,,2017-09-28,,48944001.0,-497127269.3600007,.
409000438620',2017-09-28,Indfor RIF AEPS NPCI WDL SET,,2017-09-28,,100.0,-497127169.3600007,.
409000438620',2017-09-28,Indiaforensic AEPS NPCI DEP SET,,2017-09-28,31582368.0,,-528709537.3600007,.
409000438620',2017-09-28,TRANSFER TO  Indiaforensic SERVI,,2017-09-28,10000000.0,,-538709537.3600007,.
409000438620',2017-09-28,TRANSFER TO  Indiaforensic SERVI,,2017-09-28,7600000.0,,-546309537.3600007,.
409000438620',2017-09-29,AEPS ACQUIRING ADJ FEES 2,,2017-09-29,5.9,,-546309543.2600007,.
409000438620',2017-09-29,AEPS ACQ REP ADJ FEES 280,,2017-09-29,,53.69,-546309489.5700006,.
409000438620',2017-09-29,AEPS Indiaforensic INCOME 280917,,2017-09-29,,180208.42,-546129281.1500007,.
409000438620',2017-09-29,AEPS Indiaforensic GST 280917,,2017-09-29,,32437.52,-546096843.6300007,.
409000438620',2017-09-29,Indiaforensic AEPS NPCI WDL SET,,2017-09-29,,44653527.0,-501443316.6300007,.
409000438620',2017-09-29,Indiaforensic AEPS NPCI DEP SET,,2017-09-29,29262911.0,,-530706227.6300007,.
409000438620',2017-09-29,TRF TO  Indiaforensic SERVICES I,,2017-09-29,5600000.0,,-536306227.6300007,.
409000438620',2017-09-29,TRF TO  Indiaforensic SERVICES I,,2017-09-29,10000000.0,,-546306227.6300007,.
409000438620',2017-10-03,Indiaforensic AEPS NPCI WDL SET,,2017-10-03,,35254860.0,-511051367.6300007,.
409000438620',2017-10-03,Indiaforensic AEPS NPCI WDL SET,,2017-10-03,,26854921.0,-484196446.6300007,.
409000438620',2017-10-03,Indfor-RIF AEPS NPCI WDL SET,,2017-10-03,,1300.0,-484195146.6300007,.
409000438620',2017-10-03,Indiaforensic AEPS NPCI DEP SET,,2017-10-03,26118133.0,,-510313279.6300007,.
409000438620',2017-10-03,Indiaforensic AEPS NPCI DEP SET,,2017-10-03,19017683.0,,-529330962.6300007,.
409000438620',2017-10-03,TRF TO  Indiaforensic SERVICES I,,2017-10-03,6900000.0,,-536230962.6300007,.
409000438620',2017-10-03,TRF TO  Indiaforensic SERVICES I,,2017-10-03,10000000.0,,-546230962.6300007,.
409000438620',2017-10-03,Indiaforensic AEPS NPCI WDL SET,,2017-10-03,,20825862.0,-525405100.6300007,.
409000438620',2017-10-03,Indiaforensic AEPS NPCI WDL SET,,2017-10-03,,29010760.0,-496394340.6300007,.
409000438620',2017-10-03,Indiaforensic AEPS NPCI DEP SET,,2017-10-03,14821144.0,,-511215484.6300007,.
409000438620',2017-10-03,Indiaforensic AEPS NPCI DEP SET,,2017-10-03,20714800.0,,-531930284.6300007,.
409000438620',2017-10-03,AEPS ACQUIRING ADJ FEES 2,,2017-10-03,60.83,,-531930345.4600007,.
409000438620',2017-10-03,AEPS ACQ REP ADJ FEES 290,,2017-10-03,,5.9,-531930339.5600007,.
409000438620',2017-10-03,AEPS Indiaforensic INCOME 290917,,2017-10-03,,149895.68,-531780443.8800007,.
409000438620',2017-10-03,AEPS Indiaforensic GST 290917,,2017-10-03,,26981.22,-531753462.6600007,.
409000438620',2017-10-03,AEPS Indiaforensic INCOME 300917,,2017-10-03,,114889.79,-531638572.87000066,.
409000438620',2017-10-03,AEPS Indiaforensic GST 300917,,2017-10-03,,20680.16,-531617892.71000063,.
409000438620',2017-10-03,AEPS Indiaforensic INCOME 011017,,2017-10-03,,89847.86,-531528044.8500006,.
409000438620',2017-10-03,AEPS Indiaforensic GST 011017,,2017-10-03,,16172.61,-531511872.2400006,.
409000438620',2017-10-03,AEPS Indiaforensic INCOME 021017,,2017-10-03,,128311.16,-531383561.0800006,.
409000438620',2017-10-03,AEPS Indiaforensic GST 021017,,2017-10-03,,23096.01,-531360465.0700006,.
409000438620',2017-10-04,AEPS ACQ REP ADJ FEES 031,,2017-10-04,,60.83,-531360404.2400006,.
409000438620',2017-10-04,AEPS Indiaforensic INCOME 031017,,2017-10-04,,182968.92,-531177435.3200006,.
409000438620',2017-10-04,AEPS Indiaforensic GST 031017,,2017-10-04,,32934.41,-531144500.91000056,.
409000438620',2017-10-04,TRF TO  Indiaforensic SERVICES I,,2017-10-04,10000000.0,,-541144500.9100006,.
409000438620',2017-10-04,TRF TO  Indiaforensic SERVICES I,,2017-10-04,4900000.0,,-546044500.9100006,.
409000438620',2017-10-04,Indiaforensic AEPS NPCI WDL SET,,2017-10-04,,43789463.0,-502255037.91000056,.
409000438620',2017-10-04,Indiaforensic AEPS NPCI DEP SET,,2017-10-04,30574465.0,,-532829502.91000056,.
409000438620',2017-10-04,TRF TO  Indiaforensic SERVICES I,,2017-10-04,13400000.0,,-546229502.9100006,.
409000438620',2017-10-05,Indiaforensic AEPS NPCI WDL SET,,2017-10-05,,47827714.0,-498401788.91000056,.
409000438620',2017-10-05,Indfor RIF AEPS NPCI WDL SET,,2017-10-05,,5000.0,-498396788.91000056,.
409000438620',2017-10-05,AEPS Indiaforensic INCOME 041017,,2017-10-05,,199477.46,-498197311.4500006,.
409000438620',2017-10-05,AEPS Indiaforensic GST 041017,,2017-10-05,,35905.94,-498161405.5100006,.
409000438620',2017-10-05,Indiaforensic AEPS NPCI DEP SET,,2017-10-05,33089550.0,,-531250955.5100006,.
409000438620',2017-10-05,TRF TO  Indiaforensic SERVICES I,,2017-10-05,15000000.0,,-546250955.5100006,.
409000438620',2017-10-06,AEPS Indiaforensic INCOME 051017,,2017-10-06,,198382.21,-546052573.3000005,.
409000438620',2017-10-06,AEPS Indiaforensic GST 051017,,2017-10-06,,35708.8,-546016864.5000006,.
409000438620',2017-10-06,Indiaforensic AEPS NPCI WDL SET,,2017-10-06,,47835230.0,-498181634.5000006,.
409000438620',2017-10-06,Indiaforensic AEPS NPCI DEP SET,,2017-10-06,33607769.0,,-531789403.5000006,.
409000438620',2017-10-06,TRF TO  Indiaforensic SERVICES I,,2017-10-06,14500000.0,,-546289403.5000006,.
409000438620',2017-10-07,AEPS ACQUIRING ADJ FEES 0,,2017-10-07,45.48,,-546289448.9800006,.
409000438620',2017-10-07,AEPS Indiaforensic INCOME 061017,,2017-10-07,,206460.38,-546082988.6000006,.
409000438620',2017-10-07,AEPS Indiaforensic GST 061017,,2017-10-07,,37162.87,-546045825.7300006,.
409000438620',2017-10-07,Indiaforensic AEPS NPCI WDL SET,,2017-10-07,,49869477.0,-496176348.7300006,.
409000438620',2017-10-07,Indiaforensic AEPS NPCI DEP SET,,2017-10-07,34663377.0,,-530839725.7300006,.
409000438620',2017-10-09,AEPS ACQUIRING ADJ FEES 0,,2017-10-09,17.7,,-530839743.4300006,.
409000438620',2017-10-09,AEPS Indiaforensic INCOME 071017,,2017-10-09,,187874.1,-530651869.3300006,.
409000438620',2017-10-09,AEPS Indiaforensic GST 071017,,2017-10-09,,33817.34,-530618051.9900006,.
409000438620',2017-10-09,AEPS Indiaforensic INCOME 081017,,2017-10-09,,141151.34,-530476900.65000063,.
409000438620',2017-10-09,AEPS Indiaforensic GST 081017,,2017-10-09,,25407.24,-530451493.4100006,.
409000438620',2017-10-09,Indiaforensic AEPS NPCI WDL SET,,2017-10-09,,47009929.0,-483441564.4100006,.
409000438620',2017-10-09,Indiaforensic AEPS NPCI WDL SET,,2017-10-09,,36387289.0,-447054275.4100006,.
409000438620',2017-10-09,Indiaforensic AEPS NPCI DEP SET,,2017-10-09,30821738.0,,-477876013.4100006,.
409000438620',2017-10-09,Indiaforensic AEPS NPCI DEP SET,,2017-10-09,21802993.0,,-499679006.4100006,.
409000438620',2017-10-09,Indfor RIF AEPS NPCI DEP SET,,2017-10-09,5000.0,,-499684006.4100006,.
409000438620',2017-10-09,FUND TRF TO  Indiaforensic SERVI,,2017-10-09,15000000.0,,-514684006.4100006,.
409000438620',2017-10-09,FND TRF TO  Indiaforensic SERVIC,,2017-10-09,5000000.0,,-519684006.4100006,.
409000438620',2017-10-09,FND TRF TO  Indiaforensic SERVIC,,2017-10-09,5000000.0,,-524684006.4100006,.
409000438620',2017-10-09,FND TRF TO  Indiaforensic SERVIC,,2017-10-09,5000000.0,,-529684006.4100006,.
409000438620',2017-10-09,FND TRF TO  Indiaforensic SERVIC,,2017-10-09,4000000.0,,-533684006.4100006,.
409000438620',2017-10-09,FND TRF TO  Indiaforensic SERVIC,,2017-10-09,5000000.0,,-538684006.4100006,.
409000438620',2017-10-09,FND TRF TO  Indiaforensic SERVIC,,2017-10-09,4000000.0,,-542684006.4100006,.
409000438620',2017-10-09,FND TRF TO  Indiaforensic SERVIC,,2017-10-09,3000000.0,,-545684006.4100006,.
409000438620',2017-10-10,AEPS ACQUIRING ADJ FEES 0,,2017-10-10,10.62,,-545684017.0300006,.
409000438620',2017-10-10,CB726812875859/RMCPL17616/2,,2017-10-10,6060.0,,-545690077.0300006,.
409000438620',2017-10-10,AEPS ACQ REP ADJ FEES 091,,2017-10-10,,45.49,-545690031.5400006,.
409000438620',2017-10-10,AEPS Indiaforensic INCOME 091017,,2017-10-10,,209985.62,-545480045.9200006,.
409000438620',2017-10-10,AEPS Indiaforensic GST 091017,,2017-10-10,,37797.41,-545442248.5100006,.
409000438620',2017-10-10,Indiaforensic AEPS NPCI WDL SET,,2017-10-10,,54685480.0,-490756768.5100006,.
409000438620',2017-10-10,Indfor RIF AEPS NPCI WDL SET,,2017-10-10,,5000.0,-490751768.5100006,.
409000438620',2017-10-10,Indiaforensic AEPS NPCI DEP SET,,2017-10-10,32047706.0,,-522799474.5100006,.
409000438620',2017-10-10,TRF TO  Indiaforensic SERVICES I,,2017-10-10,15000000.0,,-537799474.5100006,.
409000438620',2017-10-10,TRF TO  Indiaforensic SERVICES I,,2017-10-10,8500000.0,,-546299474.5100006,.
409000438620',2017-10-11,Indiaforensic AEPS NPCI WDL SET,,2017-10-11,,47544059.0,-498755415.5100006,.
409000438620',2017-10-11,Indfor RIF AEPS NPCI WDL SET,,2017-10-11,,5550.0,-498749865.5100006,.
409000438620',2017-10-11,Indiaforensic AEPS NPCI DEP SET,,2017-10-11,31660904.0,,-530410769.5100006,.
409000438620',2017-10-11,TRF TO  Indiaforensic SERVICES I,,2017-10-11,10000000.0,,-540410769.5100006,.
409000438620',2017-10-11,TRF TO  Indiaforensic SERVICES I,,2017-10-11,5900000.0,,-546310769.5100006,.
409000438620',2017-10-11,AEPS ACQUIRING ADJ FEES 1,,2017-10-11,100.89,,-546310870.4000006,.
409000438620',2017-10-11,AEPS ACQ REP ADJ FEES 101,,2017-10-11,,10.62,-546310859.7800006,.
409000438620',2017-10-11,AEPS Indiaforensic INCOME 101017,,2017-10-11,,189358.21,-546121501.5700005,.
409000438620',2017-10-11,AEPS Indiaforensic GST 101017,,2017-10-11,,34084.48,-546087417.0900005,.
409000438620',2017-10-12,Indiaforensic AEPS NPCI WDL SET,,2017-10-12,,58007186.0,-488080231.0900005,.
409000438620',2017-10-12,Indfor RIF AEPS NPCI WDL SET,,2017-10-12,,5000.0,-488075231.0900005,.
409000438620',2017-10-12,Indiaforensic AEPS NPCI DEP SET,,2017-10-12,35311454.0,,-523386685.0900005,.
409000438620',2017-10-12,AEPS ACQUIRING ADJ FEES 1,,2017-10-12,70.8,,-523386755.8900005,.
409000438620',2017-10-12,AEPS ACQ REP ADJ FEES 111,,2017-10-12,,100.89,-523386655.00000054,.
409000438620',2017-10-12,AEPS Indiaforensic INCOME 111017,,2017-10-12,,225517.81,-523161137.19000053,.
409000438620',2017-10-12,AEPS Indiaforensic GST 111017,,2017-10-12,,40593.21,-523120543.98000056,.
409000438620',2017-10-12,TRANSFER TO  Indiaforensic SERVI,,2017-10-12,7900000.0,,-531020543.98000056,.
409000438620',2017-10-12,TRANSFER TO  Indiaforensic SERVI,,2017-10-12,15000000.0,,-546020543.9800005,.
409000438620',2017-10-13,AEPS ACQUIRING ADJ FEES 1,,2017-10-13,133.64,,-546020677.6200005,.
409000438620',2017-10-13,AEPS ACQ CR ADJ FEES 1210,,2017-10-13,280.18,,-546020957.8000004,.
409000438620',2017-10-13,CR726617131980/RMCPL10994/2,,2017-10-13,100.0,,-546021057.8000004,.
409000438620',2017-10-13,CR726607860411/RMCPL16625/2,,2017-10-13,800.0,,-546021857.8000004,.
409000438620',2017-10-13,CR726607860294/RMCPL11535/2,,2017-10-13,1200.0,,-546023057.8000004,.
409000438620',2017-10-13,CR726607860364/RMCPL10817/2,,2017-10-13,10000.0,,-546033057.8000004,.
409000438620',2017-10-13,CR726607860278/RMCPL17673/2,,2017-10-13,8800.0,,-546041857.8000004,.
409000438620',2017-10-13,CR726607860331/RMCPL15197/2,,2017-10-13,100.0,,-546041957.8000004,.
409000438620',2017-10-13,CR726607860391/RMCPL18020/2,,2017-10-13,2000.0,,-546043957.8000004,.
409000438620',2017-10-13,CR726812871149/RMCPL15657/2,,2017-10-13,400.0,,-546044357.8000004,.
409000438620',2017-10-13,CR726814941667/RMCPL17064/2,,2017-10-13,4000.0,,-546048357.8000004,.
409000438620',2017-10-13,CR726814941718/RMCPL11836/2,,2017-10-13,500.0,,-546048857.8000004,.
409000438620',2017-10-13,CR726917529492/RMCPL16185/2,,2017-10-13,2530.0,,-546051387.8000004,.
409000438620',2017-10-13,CR727212863817/RMCPL14749/2,,2017-10-13,5000.0,,-546056387.8000004,.
409000438620',2017-10-13,CR727617691503/RMCPL11446/0,,2017-10-13,10000.0,,-546066387.8000004,.
409000438620',2017-10-13,CR727918308075/RMCPL17307/0,,2017-10-13,500.0,,-546066887.8000004,.
409000438620',2017-10-13,CR727918308078/RMCPL13751/0,,2017-10-13,101.0,,-546066988.8000004,.
409000438620',2017-10-13,CR727918308088/RMCPL17936/0,,2017-10-13,2500.0,,-546069488.8000004,.
409000438620',2017-10-13,CR727918308089/RMCPL13918/0,,2017-10-13,10000.0,,-546079488.8000004,.
409000438620',2017-10-13,CR727918308099/RMCPL15847/0,,2017-10-13,1000.0,,-546080488.8000004,.
409000438620',2017-10-13,CR727918308131/RMCPL14181/0,,2017-10-13,520.0,,-546081008.8000004,.
409000438620',2017-10-13,CR727918307835/RMCPL18123/0,,2017-10-13,2000.0,,-546083008.8000004,.
409000438620',2017-10-13,CR727918307862/RMCPL18312/0,,2017-10-13,1600.0,,-546084608.8000004,.
409000438620',2017-10-13,CR727918307876/RMCPL11253/0,,2017-10-13,1000.0,,-546085608.8000004,.
409000438620',2017-10-13,CR727918307755/RMCPL15613/0,,2017-10-13,1000.0,,-546086608.8000004,.
409000438620',2017-10-13,CR727918307759/RMCPL15189/0,,2017-10-13,400.0,,-546087008.8000004,.
409000438620',2017-10-13,CR727918307769/RMCPL16824/0,,2017-10-13,5000.0,,-546092008.8000004,.
409000438620',2017-10-13,CR727918308025/RMCPL19517/0,,2017-10-13,2000.0,,-546094008.8000004,.
409000438620',2017-10-13,CR725711540055/RMCPL09033/1,,2017-10-13,1500.0,,-546095508.8000004,.
409000438620',2017-10-13,CR725512497382/RMCPL17936/1,,2017-10-13,200.0,,-546095708.8000004,.
409000438620',2017-10-13,CR725514560981/RMCPL11363/1,,2017-10-13,1500.0,,-546097208.8000004,.
409000438620',2017-10-13,CR726413065279/RMCPL16100/2,,2017-10-13,2040.0,,-546099248.8000004,.
409000438620',2017-10-13,CR727111368773/RMCPL15530/2,,2017-10-13,1000.0,,-546100248.8000004,.
409000438620',2017-10-13,AEPS Indiaforensic INCOME 121017,,2017-10-13,,222813.44,-545877435.3600004,.
409000438620',2017-10-13,AEPS Indiaforensic GST 121017,,2017-10-13,,40106.42,-545837328.9400004,.
409000438620',2017-10-13,Indiaforensic AEPS NPCI WDL SET,,2017-10-13,,57472034.0,-488365294.9400004,.
409000438620',2017-10-13,Indiaforensic AEPS NPCI DEP SET,,2017-10-13,35424167.0,,-523789461.9400004,.
409000438620',2017-10-13,TRF TO  Indiaforensic SERVICES I,,2017-10-13,15000000.0,,-538789461.9400004,.
409000438620',2017-10-13,TRF TO  Indiaforensic SERVICES I,,2017-10-13,7500000.0,,-546289461.9400004,.
409000438620',2017-10-16,Indiaforensic AEPS NPCI WDL SET,,2017-10-16,,44276831.0,-502012630.9400004,.
409000438620',2017-10-16,Indiaforensic AEPS NPCI WDL SET,,2017-10-16,,54879921.0,-447132709.9400004,.
409000438620',2017-10-16,Indiaforensic AEPS NPCI WDL SET,,2017-10-16,,37945382.0,-409187327.9400004,.
409000438620',2017-10-16,Indiaforensic AEPS NPCI DEP SET,,2017-10-16,26364205.0,,-435551532.9400004,.
409000438620',2017-10-16,Indiaforensic AEPS NPCI DEP SET,,2017-10-16,29490172.0,,-465041704.9400004,.
409000438620',2017-10-16,Indiaforensic AEPS NPCI DEP SET,,2017-10-16,24477266.0,,-489518970.9400004,.
409000438620',2017-10-16,TRF TO  Indiaforensic SERVICES I,,2017-10-16,2000000.0,,-491518970.9400004,.
409000438620',2017-10-16,TRF TO  Indiaforensic SERVICES I,,2017-10-16,2000000.0,,-493518970.9400004,.
409000438620',2017-10-16,TRF TO  Indiaforensic SERVICES I,,2017-10-16,5000000.0,,-498518970.9400004,.
409000438620',2017-10-16,TRF TO  Indiaforensic SERVICES I,,2017-10-16,10000000.0,,-508518970.9400004,.
409000438620',2017-10-16,TRF TO  Indiaforensic SERVICES I,,2017-10-16,10000000.0,,-518518970.9400004,.
409000438620',2017-10-16,TRF TO  Indiaforensic SERVICES I,,2017-10-16,15000000.0,,-533518970.9400004,.
409000438620',2017-10-16,TRF TO  Indiaforensic SERVICES I,,2017-10-16,4000000.0,,-537518970.9400004,.
409000438620',2017-10-16,AEPS ACQUIRING ADJ FEES 1,,2017-10-16,2.95,,-537518973.8900005,.
409000438620',2017-10-16,AEPS ACQUIRING ADJ FEES 1,,2017-10-16,,3.54,-537518970.3500005,.
409000438620',2017-10-16,TRF TO Indiaforensic SERVICES IN,,2017-10-16,4000000.0,,-541518970.3500005,.
409000438620',2017-10-16,TRF TO  Indiaforensic SERVICES I,,2017-10-16,4000000.0,,-545518970.3500005,.
409000438620',2017-10-16,AEPS Indiaforensic INCOME 131017,,2017-10-16,,166847.05,-545352123.3000005,.
409000438620',2017-10-16,AEPS Indiaforensic GST 131017,,2017-10-16,,30032.47,-545322090.8300005,.
409000438620',2017-10-16,AEPS Indiaforensic INCOME 141017,,2017-10-16,,205196.45,-545116894.3800005,.
409000438620',2017-10-16,AEPS Indiaforensic GST 141017,,2017-10-16,,36935.36,-545079959.0200005,.
409000438620',2017-10-16,AEPS Indiaforensic INCOME 151017,,2017-10-16,,152200.35,-544927758.6700004,.
409000438620',2017-10-16,AEPS Indiaforensic GST 151017,,2017-10-16,,27396.06,-544900362.6100005,.
409000438620',2017-10-17,AEPS ACQUIRING ADJ FEES 1,,2017-10-17,71.98,,-544900434.5900005,.
409000438620',2017-10-17,AEPS ACQ REP ADJ FEES 161,,2017-10-17,,37.17,-544900397.4200006,.
409000438620',2017-10-17,AEPS Indiaforensic INCOME 161017,,2017-10-17,,256685.68,-544643711.7400006,.
409000438620',2017-10-17,AEPS Indiaforensic GST 161017,,2017-10-17,,46203.42,-544597508.3200006,.
409000438620',2017-10-17,Indiaforensic AEPS NPCI WDL SET,,2017-10-17,,66391337.0,-478206171.32000065,.
409000438620',2017-10-17,Indiaforensic AEPS NPCI DEP SET,,2017-10-17,39988875.0,,-518195046.32000065,.
409000438620',2017-10-17,CB728315320897/RMCPL19102/1,,2017-10-17,100.0,,-518195146.32000065,.
409000438620',2017-10-17,TRF TO  Indiaforensic SERVICES I,,2017-10-17,15000000.0,,-533195146.32000065,.
409000438620',2017-10-17,TRF TO  Indiaforensic SERVICES I,,2017-10-17,13000000.0,,-546195146.3200006,.
409000438620',2017-10-18,AEPS ACQUIRING ADJ FEES 1,,2017-10-18,17.7,,-546195164.0200007,.
409000438620',2017-10-18,AEPS ACQ REP ADJ FEES 161,,2017-10-18,,108.26,-546195055.7600007,.
409000438620',2017-10-18,AEPS Indiaforensic INCOME 171017,,2017-10-18,,300718.03,-545894337.7300007,.
409000438620',2017-10-18,AEPS Indiaforensic GST 171017,,2017-10-18,,54129.25,-545840208.4800007,.
409000438620',2017-10-18,Indiaforensic AEPS NPCI WDL SET,,2017-10-18,,78375799.0,-467464409.48000073,.
409000438620',2017-10-18,Indiaforensic AEPS NPCI DEP SET,,2017-10-18,46674805.0,,-514139214.48000073,.
409000438620',2017-10-18,CB728315320897/RMCPL19102/1,,2017-10-18,500.0,,-514139714.48000073,.
409000438620',2017-10-18,REV CB728315320897/RMCPL191,,2017-10-18,,100.0,-514139614.48000073,.
409000438620',2017-10-18,TRF TO  Indiaforensic SERVICES I,,2017-10-18,15000000.0,,-529139614.48000073,.
409000438620',2017-10-18,TRF TO  Indiaforensic SERVICES I,,2017-10-18,2100000.0,,-531239614.48000073,.
409000438620',2017-10-18,TRF TO  Indiaforensic SERVICES I,,2017-10-18,15000000.0,,-546239614.4800007,.
409000438620',2017-10-21,Indiaforensic AEPS NPCI WDL SET,,2017-10-21,,73566983.0,-472672631.48000073,.
409000438620',2017-10-21,Indiaforensic AEPS NPCI WDL SET,,2017-10-21,,42298793.0,-430373838.48000073,.
409000438620',2017-10-21,Indiaforensic AEPS NPCI WDL SET,,2017-10-21,,33038069.0,-397335769.48000073,.
409000438620',2017-10-21,Indiaforensic AEPS NPCI DEP SET,,2017-10-21,45863129.0,,-443198898.48000073,.
409000438620',2017-10-21,Indiaforensic AEPS NPCI DEP SET,,2017-10-21,29785790.0,,-472984688.48000073,.
409000438620',2017-10-21,Indiaforensic AEPS NPCI DEP SET,,2017-10-21,29254647.0,,-502239335.48000073,.
409000438620',2017-10-21,AEPS ACQUIRING ADJ FEES 1,,2017-10-21,23.84,,-502239359.3200007,.
409000438620',2017-10-21,REP ADJ FEES 181017,,2017-10-21,,17.7,-502239341.6200007,.
409000438620',2017-10-21,AEPS Indiaforensic INCOME 181017,,2017-10-21,,284305.11,-501955036.5100007,.
409000438620',2017-10-21,AEPS Indiaforensic GST 181017,,2017-10-21,,51174.92,-501903861.5900007,.
409000438620',2017-10-21,AEPS Indiaforensic INCOME 191017,,2017-10-21,,173308.25,-501730553.3400007,.
409000438620',2017-10-21,AEPS Indiaforensic GST 191017,,2017-10-21,,31195.49,-501699357.8500007,.
409000438620',2017-10-21,AEPS Indiaforensic INCOME 201017,,2017-10-21,,147835.23,-501551522.62000066,.
409000438620',2017-10-21,AEPS Indiaforensic GST 201017,,2017-10-21,,26610.34,-501524912.2800007,.
409000438620',2017-10-21,TRF TO  Indiaforensic SERVICES I,,2017-10-21,15000000.0,,-516524912.2800007,.
409000438620',2017-10-21,TRF TO  Indiaforensic SERVICES I,,2017-10-21,15000000.0,,-531524912.2800007,.
409000438620',2017-10-21,TRF TO  Indiaforensic SERVICES I,,2017-10-21,10000000.0,,-541524912.2800007,.
409000438620',2017-10-21,TRF TO  Indiaforensic SERVICES I,,2017-10-21,2000000.0,,-543524912.2800007,.
409000438620',2017-10-21,TRF TO  Indiaforensic SERVICES I,,2017-10-21,2000000.0,,-545524912.2800007,.
409000438620',2017-10-23,AEPS ACQUIRING ADJ FEES 2,,2017-10-23,35.4,,-545524947.6800007,.
409000438620',2017-10-23,AEPS Indiaforensic INCOME 211017,,2017-10-23,,173586.91,-545351360.7700007,.
409000438620',2017-10-23,AEPS Indiaforensic GST 211017,,2017-10-23,,31245.64,-545320115.1300007,.
409000438620',2017-10-23,AEPS Indiaforensic INCOME 221017,,2017-10-23,,142384.26,-545177730.8700007,.
409000438620',2017-10-23,AEPS Indiaforensic GST 221017,,2017-10-23,,25629.17,-545152101.7000008,.
409000438620',2017-10-23,Indiaforensic AEPS NPCI WDL SET,,2017-10-23,,40673897.0,-504478204.70000076,.
409000438620',2017-10-23,Indiaforensic AEPS NPCI WDL SET,,2017-10-23,,33744990.0,-470733214.70000076,.
409000438620',2017-10-23,Indiaforensic AEPS NPCI DEP SET,,2017-10-23,31221579.0,,-501954793.70000076,.
409000438620',2017-10-23,Indiaforensic AEPS NPCI DEP SET,,2017-10-23,25597420.0,,-527552213.70000076,.
409000438620',2017-10-23,CB728916623236/RMCPL16353/1,,2017-10-23,10000.0,,-527562213.70000076,.
409000438620',2017-10-23,TRF TO  Indiaforensic SERVICES I,,2017-10-23,4000000.0,,-531562213.70000076,.
409000438620',2017-10-23,TRF TO  Indiaforensic SERVICES I,,2017-10-23,4000000.0,,-535562213.70000076,.
409000438620',2017-10-23,TRF TO  Indiaforensic SERVICES I,,2017-10-23,4000000.0,,-539562213.7000008,.
409000438620',2017-10-23,TRF TO  Indiaforensic SERVICES I,,2017-10-23,3000000.0,,-542562213.7000008,.
409000438620',2017-10-23,TRF TO  Indiaforensic SERVICES I,,2017-10-23,3000000.0,,-545562213.7000008,.
409000438620',2017-10-24,Indiaforensic AEPS NPCI WDL SET,,2017-10-24,,60058374.0,-485503839.70000076,.
409000438620',2017-10-24,AEPS ACQ REP ADJ FEES 231,,2017-10-24,,35.4,-485503804.3000008,.
409000438620',2017-10-24,AEPS Indiaforensic INCOME 231017,,2017-10-24,,243701.29,-485260103.01000077,.
409000438620',2017-10-24,AEPS Indiaforensic GST 231017,,2017-10-24,,43866.23,-485216236.78000075,.
409000438620',2017-10-24,Indiaforensic AEPS NPCI DEP SET,,2017-10-24,40783377.0,,-525999613.78000075,.
409000438620',2017-10-24,TRANSFER TO  Indiaforensic SERVI,,2017-10-24,15000000.0,,-540999613.7800007,.
409000438620',2017-10-24,TRANSFER TO  Indiaforensic SERVI,,2017-10-24,5300000.0,,-546299613.7800007,.
409000438620',2017-10-25,Indiaforensic AEPS NPCI WDL SET,,2017-10-25,,55712944.0,-490586669.7800007,.
409000438620',2017-10-25,AEPS ACQUIRING ADJ FEES 2,,2017-10-25,92.75,,-490586762.5300007,.
409000438620',2017-10-25,AEPS Indiaforensic INCOME 241017,,2017-10-25,,232789.41,-490353973.12000066,.
409000438620',2017-10-25,AEPS Indiaforensic GST 241017,,2017-10-25,,41902.09,-490312071.0300007,.
409000438620',2017-10-25,Indiaforensic AEPS NPCI DEP SET,,2017-10-25,41616321.0,,-531928392.0300007,.
409000438620',2017-10-25,TRF TO  Indiaforensic SERVICES I,,2017-10-25,14300000.0,,-546228392.0300007,.
409000438620',2017-10-26,Indiaforensic AEPS NPCI WDL SET,,2017-10-26,,44538047.0,-501690345.0300007,.
409000438620',2017-10-26,Indiaforensic AEPS NPCI DEP SET,,2017-10-26,35060994.0,,-536751339.0300007,.
409000438620',2017-10-26,AEPS ACQUIRING ADJ FEES 2,,2017-10-26,50.51,,-536751389.5400007,.
409000438620',2017-10-26,AEPS Indiaforensic INCOME 251017,,2017-10-26,,192036.6,-536559352.94000065,.
409000438620',2017-10-26,AEPS Indiaforensic GST 251017,,2017-10-26,,34566.59,-536524786.3500007,.
409000438620',2017-10-26,CB726607860274/RMCPL12225/2,,2017-10-26,,10000.0,-536514786.3500007,.
409000438620',2017-10-26,CB726607860291/RMCPL17219/2,,2017-10-26,,10000.0,-536504786.3500007,.
409000438620',2017-10-26,CB725019081598/RMCPL12012/0,,2017-10-26,,5000.0,-536499786.3500007,.
409000438620',2017-10-26,CB725019081855/RMCPL13091/0,,2017-10-26,,10000.0,-536489786.3500007,.
409000438620',2017-10-26,CB725019081719/RMCPL13918/0,,2017-10-26,,2100.0,-536487686.3500007,.
409000438620',2017-10-26,CB725019077882/RMCPL03136/0,,2017-10-26,,3000.0,-536484686.3500007,.
409000438620',2017-10-26,CB727918308087/RMCPL15239/0,,2017-10-26,,1500.0,-536483186.3500007,.
409000438620',2017-10-26,CB727918308030/RMCPL13166/0,,2017-10-26,,10000.0,-536473186.3500007,.
409000438620',2017-10-26,CB728916623331/RMCPL18232/1,,2017-10-26,,1040.0,-536472146.3500007,.
409000438620',2017-10-26,TRF TO  Indiaforensic SERVICES I,,2017-10-26,9700000.0,,-546172146.3500006,.
409000438620',2017-10-27,Indiaforensic AEPS NPCI WDL SET,,2017-10-27,,35536909.0,-510635237.3500006,.
409000438620',2017-10-27,AEPS ACQ CR ADJ FEES 2610,,2017-10-27,439.19,,-510635676.5400006,.
409000438620',2017-10-27,CR728210590112/RMCPL10672/0,,2017-10-27,500.0,,-510636176.5400006,.
409000438620',2017-10-27,CR728214715909/RMCPL11642/0,,2017-10-27,6000.0,,-510642176.5400006,.
409000438620',2017-10-27,CR728214715923/RMCPL10689/0,,2017-10-27,5000.0,,-510647176.5400006,.
409000438620',2017-10-27,CR728217815149/RMCPL16197/0,,2017-10-27,10000.0,,-510657176.5400006,.
409000438620',2017-10-27,CR728214715837/RMCPL16999/0,,2017-10-27,1500.0,,-510658676.5400006,.
409000438620',2017-10-27,CR728214715994/RMCPL17051/0,,2017-10-27,100.0,,-510658776.5400006,.
409000438620',2017-10-27,CR728214716013/RMCPL16068/0,,2017-10-27,2500.0,,-510661276.5400006,.
409000438620',2017-10-27,CR728214716028/RMCPL19141/0,,2017-10-27,200.0,,-510661476.5400006,.
409000438620',2017-10-27,CR728214716006/RMCPL14324/0,,2017-10-27,3000.0,,-510664476.5400006,.
409000438620',2017-10-27,CR728214716074/RMCPL11742/0,,2017-10-27,200.0,,-510664676.5400006,.
409000438620',2017-10-27,CR728315320856/RMCPL14840/1,,2017-10-27,1000.0,,-510665676.5400006,.
409000438620',2017-10-27,CR728321559471/RMCPL06758/1,,2017-10-27,10000.0,,-510675676.5400006,.
409000438620',2017-10-27,CR728314302223/RMCPL18375/1,,2017-10-27,2000.0,,-510677676.5400006,.
409000438620',2017-10-27,CR728711442133/RMCPL18092/1,,2017-10-27,5500.0,,-510683176.5400006,.
409000438620',2017-10-27,CR728610824931/RMCPL14982/1,,2017-10-27,500.0,,-510683676.5400006,.
409000438620',2017-10-27,CR728611866779/RMCPL15232/1,,2017-10-27,10000.0,,-510693676.5400006,.
409000438620',2017-10-27,CR728615005920/RMCPL00138/1,,2017-10-27,6000.0,,-510699676.5400006,.
409000438620',2017-10-27,CR728610828584/RMCPL14811/1,,2017-10-27,900.0,,-510700576.5400006,.
409000438620',2017-10-27,CR728610822766/RMCPL11836/1,,2017-10-27,4500.0,,-510705076.5400006,.
409000438620',2017-10-27,CR728916623439/RMCPL16452/1,,2017-10-27,2000.0,,-510707076.5400006,.
409000438620',2017-10-27,CR728916623181/RMCPL13748/1,,2017-10-27,400.0,,-510707476.5400006,.
409000438620',2017-10-27,CR728916623196/RMCPL16145/1,,2017-10-27,5000.0,,-510712476.5400006,.
409000438620',2017-10-27,CR728916623281/RMCPL14885/1,,2017-10-27,1580.0,,-510714056.5400006,.
409000438620',2017-10-27,CR728916623301/RMCPL11891/1,,2017-10-27,1000.0,,-510715056.5400006,.
409000438620',2017-10-27,CR728916623311/RMCPL17017/1,,2017-10-27,1500.0,,-510716556.5400006,.
409000438620',2017-10-27,CR728916623416/RMCPL19609/1,,2017-10-27,2500.0,,-510719056.5400006,.
409000438620',2017-10-27,AEPS ACQ REP ADJ FEES 261,,2017-10-27,,50.51,-510719006.0300006,.
409000438620',2017-10-27,CR728916623315/RMCPL15907/1,,2017-10-27,160.0,,-510719166.0300006,.
409000438620',2017-10-27,CR728916623336/RMCPL13062/1,,2017-10-27,5020.0,,-510724186.0300006,.
409000438620',2017-10-27,CR728916623341/RMCPL12613/1,,2017-10-27,10000.0,,-510734186.0300006,.
409000438620',2017-10-27,CR728916623443/RMCPL11260/1,,2017-10-27,1000.0,,-510735186.0300006,.
409000438620',2017-10-27,CR728916623454/RMCPL17453/1,,2017-10-27,4450.0,,-510739636.0300006,.
409000438620',2017-10-27,CR728916623478/RMCPL14332/1,,2017-10-27,10000.0,,-510749636.0300006,.
409000438620',2017-10-27,CR728916623483/RMCPL11459/1,,2017-10-27,5000.0,,-510754636.0300006,.
409000438620',2017-10-27,CR728916623491/RMCPL13806/1,,2017-10-27,1000.0,,-510755636.0300006,.
409000438620',2017-10-27,CR728916623498/RMCPL09726/1,,2017-10-27,10000.0,,-510765636.0300006,.
409000438620',2017-10-27,CR728916624037/RMCPL18123/1,,2017-10-27,3000.0,,-510768636.0300006,.
409000438620',2017-10-27,CR729610044425/RMCPL15491/2,,2017-10-27,2500.0,,-510771136.0300006,.
409000438620',2017-10-27,CR729715801751/RMCPL17924/2,,2017-10-27,400.0,,-510771536.0300006,.
409000438620',2017-10-27,AEPS Indiaforensic INCOME 261017,,2017-10-27,,154734.06,-510616801.9700006,.
409000438620',2017-10-27,AEPS Indiaforensic GST 261017,,2017-10-27,,27852.13,-510588949.8400006,.
409000438620',2017-10-27,Indiaforensic AEPS NPCI DEP SET,,2017-10-27,28102835.0,,-538691784.8400006,.
409000438620',2017-10-27,TRANSFER TO  Indiaforensic SERVI,,2017-10-27,7600000.0,,-546291784.8400006,.
409000438620',2017-10-30,Indiaforensic AEPS NPCI WDL SET,,2017-10-30,,33938494.0,-512353290.8400006,.
409000438620',2017-10-30,Indiaforensic AEPS NPCI WDL SET,,2017-10-30,,36282953.0,-476070337.8400006,.
409000438620',2017-10-30,Indiaforensic AEPS NPCI WDL SET,,2017-10-30,,27331958.0,-448738379.8400006,.
409000438620',2017-10-30,Indiaforensic AEPS NPCI DEP SET,,2017-10-30,27820290.0,,-476558669.8400006,.
409000438620',2017-10-30,Indiaforensic AEPS NPCI DEP SET,,2017-10-30,25673190.0,,-502231859.8400006,.
409000438620',2017-10-30,Indiaforensic AEPS NPCI DEP SET,,2017-10-30,22895866.0,,-525127725.8400006,.
409000438620',2017-10-30,TRANSFER TO  Indiaforensic SERVI,,2017-10-30,15000000.0,,-540127725.8400006,.
409000438620',2017-10-30,TRANSFER TO  Indiaforensic SERVI,,2017-10-30,6100000.0,,-546227725.8400006,.
409000438620',2017-10-30,AEPS ACQ REP ADJ FEES 271,,2017-10-30,,92.75,-546227633.0900006,.
409000438620',2017-10-30,AEPS Indiaforensic INCOME 271017,,2017-10-30,,149253.05,-546078380.0400007,.
409000438620',2017-10-30,AEPS Indiaforensic GST 271017,,2017-10-30,,26865.55,-546051514.4900007,.
409000438620',2017-10-30,AEPS Indiaforensic INCOME 281017,,2017-10-30,,152976.26,-545898538.2300007,.
409000438620',2017-10-30,AEPS Indiaforensic GST 281017,,2017-10-30,,27535.73,-545871002.5000007,.
409000438620',2017-10-30,AEPS Indiaforensic INCOME 291017,,2017-10-30,,125802.93,-545745199.5700008,.
409000438620',2017-10-30,AEPS Indiaforensic GST 291017,,2017-10-30,,22644.53,-545722555.0400008,.
409000438620',2017-10-31,AEPS ACQUIRING ADJ FEES 3,,2017-10-31,17.7,,-545722572.7400008,.
409000438620',2017-10-31,AEPS Indiaforensic INCOME 301017,,2017-10-31,,205926.38,-545516646.3600008,.
409000438620',2017-10-31,AEPS Indiaforensic GST 301017,,2017-10-31,,37066.75,-545479579.6100008,.
409000438620',2017-10-31,Indiaforensic AEPS NPCI WDL SET,,2017-10-31,,48675765.0,-496803814.61000085,.
409000438620',2017-10-31,Indiaforensic AEPS NPCI DEP SET,,2017-10-31,35040046.0,,-531843860.61000085,.
409000438620',2017-10-31,TRF TO  Indiaforensic SERVICES I,,2017-10-31,14400000.0,,-546243860.6100008,.
409000438620',2017-11-01,AEPS Indiaforensic INCOME 311017,,2017-11-01,,187905.46,-546055955.1500008,.
409000438620',2017-11-01,AEPS Indiaforensic GST 311017,,2017-11-01,,33822.98,-546022132.1700008,.
409000438620',2017-11-01,AEPS ACQUIRING ADJ FEES 3,,2017-11-01,29.5,,-546022161.6700008,.
409000438620',2017-11-01,Indiaforensic AEPS NPCI WDL SET,,2017-11-01,,46112114.0,-499910047.6700008,.
409000438620',2017-11-01,Indiaforensic AEPS NPCI DEP SET,,2017-11-01,32365202.0,,-532275249.6700008,.
409000438620',2017-11-01,TRANSFER TO  Indiaforensic SERVI,,2017-11-01,14000000.0,,-546275249.6700008,.
409000438620',2017-11-02,AEPS Indiaforensic INCOME 011117,,2017-11-02,,181631.08,-546093618.5900007,.
409000438620',2017-11-02,AEPS Indiaforensic GST 011117,,2017-11-02,,32693.59,-546060925.0000007,.
409000438620',2017-11-02,Indiaforensic AEPS NPCI WDL SET,,2017-11-02,,44396253.0,-501664672.0000007,.
409000438620',2017-11-02,Indiaforensic AEPS NPCI DEP SET,,2017-11-02,31817739.0,,-533482411.0000007,.
409000438620',2017-11-02,TRF TO  Indiaforensic SERVICES I,,2017-11-02,12800000.0,,-546282411.0000007,.
409000438620',2017-11-03,AEPS ACQUIRING ADJ FEES 0,,2017-11-03,35.99,,-546282446.9900007,.
409000438620',2017-11-03,AEPS ACQ REP ADJ FEES 021,,2017-11-03,,29.5,-546282417.4900007,.
409000438620',2017-11-03,AEPS Indiaforensic INCOME 021117,,2017-11-03,,201617.26,-546080800.2300007,.
409000438620',2017-11-03,AEPS Indiaforensic GST 021117,,2017-11-03,,36291.11,-546044509.1200007,.
409000438620',2017-11-03,Indiaforensic AEPS NPCI WDL SET,,2017-11-03,,47301760.0,-498742749.1200007,.
409000438620',2017-11-03,Indiaforensic AEPS NPCI DEP SET,,2017-11-03,36675558.0,,-535418307.1200007,.
409000438620',2017-11-03,TRF TO  Indiaforensic SERVICES I,,2017-11-03,10800000.0,,-546218307.1200007,.
409000438620',2017-11-06,Indiaforensic AEPS NPCI WDL SET,,2017-11-06,,49135047.0,-497083260.1200007,.
409000438620',2017-11-06,Indiaforensic AEPS NPCI DEP SET,,2017-11-06,36659315.0,,-533742575.1200007,.
409000438620',2017-11-06,AEPS ACQUIRING ADJ FEES 0,,2017-11-06,47.2,,-533742622.3200007,.
409000438620',2017-11-06,REP ADJ FEES 031117,,2017-11-06,,17.7,-533742604.6200007,.
409000438620',2017-11-06,AEPS Indiaforensic INCOME 031117,,2017-11-06,,207322.76,-533535281.8600007,.
409000438620',2017-11-06,AEPS Indiaforensic GST 031117,,2017-11-06,,37318.1,-533497963.7600007,.
409000438620',2017-11-06,AEPS Indiaforensic INCOME 041117,,2017-11-06,,183643.61,-533314320.1500007,.
409000438620',2017-11-06,AEPS Indiaforensic GST 041117,,2017-11-06,,33055.85,-533281264.30000067,.
409000438620',2017-11-06,AEPS Indiaforensic INCOME 051117,,2017-11-06,,137677.38,-533143586.9200007,.
409000438620',2017-11-06,AEPS Indiaforensic GST 051117,,2017-11-06,,24781.93,-533118804.99000067,.
409000438620',2017-11-06,Indiaforensic AEPS NPCI WDL SET,,2017-11-06,,42840450.0,-490278354.99000067,.
409000438620',2017-11-06,Indiaforensic AEPS NPCI DEP SET,,2017-11-06,32591654.0,,-522870008.99000067,.
409000438620',2017-11-06,TRF TO  Indiaforensic SERVICES I,,2017-11-06,2000000.0,,-524870008.99000067,.
409000438620',2017-11-06,TRF TO  Indiaforensic SERVICES I,,2017-11-06,10000000.0,,-534870008.99000067,.
409000438620',2017-11-06,TRF TO  Indiaforensic SERVICES I,,2017-11-06,10000000.0,,-544870008.9900007,.
409000438620',2017-11-06,Indiaforensic AEPS NPCI WDL SET,,2017-11-06,,30051298.0,-514818710.9900007,.
409000438620',2017-11-06,Indiaforensic AEPS NPCI DEP SET,,2017-11-06,25407903.0,,-540226613.9900007,.
409000438620',2017-11-07,TRF TO  Indiaforensic SERVICES I,,2017-11-07,5000000.0,,-545226613.9900007,.
409000438620',2017-11-07,AEPS ACQ REP ADJ FEES 061,,2017-11-07,,65.49,-545226548.5000007,.
409000438620',2017-11-07,AEPS Indiaforensic INCOME 061117,,2017-11-07,,204712.82,-545021835.6800007,.
409000438620',2017-11-07,AEPS Indiaforensic GST 061117,,2017-11-07,,36848.31,-544984987.3700007,.
409000438620',2017-11-07,Indiaforensic AEPS NPCI WDL SET,,2017-11-07,,48560099.0,-496424888.3700007,.
409000438620',2017-11-07,Indiaforensic AEPS NPCI DEP SET,,2017-11-07,33838994.0,,-530263882.3700007,.
409000438620',2017-11-07,TRF TO  Indiaforensic SERVICES I,,2017-11-07,10000000.0,,-540263882.3700007,.
409000438620',2017-11-07,TRF TO  Indiaforensic SERVICES I,,2017-11-07,4000000.0,,-544263882.3700007,.
409000438620',2017-11-07,TRF TO  Indiaforensic SERVICES I,,2017-11-07,2000000.0,,-546263882.3700007,.
409000438620',2017-11-08,AEPS ACQUIRING ADJ FEES 0,,2017-11-08,45.43,,-546263927.8000007,.
409000438620',2017-11-08,AEPS ACQ REP ADJ FEES 071,,2017-11-08,,17.7,-546263910.1000006,.
409000438620',2017-11-08,AEPS Indiaforensic INCOME 071117,,2017-11-08,,213031.8,-546050878.3000007,.
409000438620',2017-11-08,AEPS Indiaforensic GST 071117,,2017-11-08,,38345.72,-546012532.5800006,.
409000438620',2017-11-08,Indiaforensic AEPS NPCI WDL SET,,2017-11-08,,51256727.0,-494755805.58000064,.
409000438620',2017-11-08,Indiaforensic AEPS NPCI DEP SET,,2017-11-08,34766404.0,,-529522209.58000064,.
409000438620',2017-11-08,TRF TO  Indiaforensic SERVICES I,,2017-11-08,15000000.0,,-544522209.5800006,.
409000438620',2017-11-08,TRF FROM  Indiaforensic SERVICES,,2017-11-08,1700000.0,,-546222209.5800006,.
409000438620',2017-11-09,Indiaforensic AEPS NPCI WDL SET,,2017-11-09,,52191352.0,-494030857.58000064,.
409000438620',2017-11-09,AEPS Indiaforensic INCOME 081117,,2017-11-09,,218423.88,-493812433.70000064,.
409000438620',2017-11-09,AEPS Indiaforensic GST 081117,,2017-11-09,,39316.3,-493773117.40000063,.
409000438620',2017-11-09,Indiaforensic AEPS NPCI DEP SET,,2017-11-09,37050054.0,,-530823171.40000063,.
409000438620',2017-11-09,TRF TO  Indiaforensic SERVICES I,,2017-11-09,10000000.0,,-540823171.4000006,.
409000438620',2017-11-09,TRF TO  Indiaforensic SERVICES I,,2017-11-09,5400000.0,,-546223171.4000006,.
409000438620',2017-11-10,Indiaforensic AEPS NPCI WDL SET,,2017-11-10,,52552138.0,-493671033.4000006,.
409000438620',2017-11-10,AEPS ACQUIRING ADJ FEES 0,,2017-11-10,19.53,,-493671052.93000054,.
409000438620',2017-11-10,AEPS ACQ REP ADJ FEES 091,,2017-11-10,,45.43,-493671007.50000054,.
409000438620',2017-11-10,AEPS Indiaforensic INCOME 091117,,2017-11-10,,217467.07,-493453540.43000054,.
409000438620',2017-11-10,AEPS Indiaforensic GST 091117,,2017-11-10,,39144.07,-493414396.36000055,.
409000438620',2017-11-10,Indiaforensic AEPS NPCI DEP SET,,2017-11-10,36309944.0,,-529724340.36000055,.
409000438620',2017-11-10,TRF TO  Indiaforensic SERVICES I,,2017-11-10,10000000.0,,-539724340.3600006,.
409000438620',2017-11-10,TRF TO  Indiaforensic SERVICES I,,2017-11-10,6500000.0,,-546224340.3600006,.
409000438620',2017-11-13,Indiaforensic AEPS NPCI WDL SET,,2017-11-13,,54485471.0,-491738869.3600006,.
409000438620',2017-11-13,Indiaforensic AEPS NPCI DEP SET,,2017-11-13,36108954.0,,-527847823.3600006,.
409000438620',2017-11-13,AEPS ACQ REP ADJ FEES 101,,2017-11-13,,19.53,-527847803.83000064,.
409000438620',2017-11-13,AEPS Indiaforensic INCOME 101117,,2017-11-13,,219608.71,-527628195.12000066,.
409000438620',2017-11-13,AEPS Indiaforensic GST 101117,,2017-11-13,,39529.57,-527588665.55000067,.
409000438620',2017-11-13,AEPS Indiaforensic INCOME 111117,,2017-11-13,,202540.31,-527386125.24000067,.
409000438620',2017-11-13,AEPS Indiaforensic GST 111117,,2017-11-13,,36457.26,-527349667.9800007,.
409000438620',2017-11-13,AEPS Indiaforensic INCOME 121117,,2017-11-13,,162749.17,-527186918.81000066,.
409000438620',2017-11-13,AEPS Indiaforensic GST 121117,,2017-11-13,,29294.85,-527157623.96000063,.
409000438620',2017-11-13,Indiaforensic AEPS NPCI WDL SET,,2017-11-13,,51029577.0,-476128046.96000063,.
409000438620',2017-11-13,Indiaforensic AEPS NPCI WDL SET,,2017-11-13,,36743881.0,-439384165.96000063,.
409000438620',2017-11-13,Indiaforensic AEPS NPCI DEP SET,,2017-11-13,30521708.0,,-469905873.96000063,.
409000438620',2017-11-13,Indiaforensic AEPS NPCI DEP SET,,2017-11-13,27358963.0,,-497264836.96000063,.
409000438620',2017-11-13,TRF TO  Indiaforensic SERVICES I,,2017-11-13,5000000.0,,-502264836.96000063,.
409000438620',2017-11-13,TRF TO  Indiaforensic SERVICES I,,2017-11-13,5000000.0,,-507264836.96000063,.
409000438620',2017-11-13,TRF TO  Indiaforensic SERVICES I,,2017-11-13,5000000.0,,-512264836.96000063,.
409000438620',2017-11-13,TRF TO  Indiaforensic SERVICES I,,2017-11-13,3000000.0,,-515264836.96000063,.
409000438620',2017-11-13,TRF TO  Indiaforensic SERVICES I,,2017-11-13,15000000.0,,-530264836.96000063,.
409000438620',2017-11-13,TRF TO  Indiaforensic SERVICES I,,2017-11-13,4000000.0,,-534264836.96000063,.
409000438620',2017-11-13,TRF TO  Indiaforensic SERVICES I,,2017-11-13,3000000.0,,-537264836.9600006,.
409000438620',2017-11-13,TRF TO  Indiaforensic SERVICES I,,2017-11-13,3000000.0,,-540264836.9600006,.
409000438620',2017-11-13,TRF TO  Indiaforensic SERVICES I,,2017-11-13,2000000.0,,-542264836.9600006,.
409000438620',2017-11-13,TRF TO  Indiaforensic SERVICES I,,2017-11-13,2000000.0,,-544264836.9600006,.
409000438620',2017-11-13,TRF TO  Indiaforensic SERVICES I,,2017-11-13,2000000.0,,-546264836.9600006,.
409000438620',2017-11-14,AEPS ACQUIRING ADJ FEES 1,,2017-11-14,17.7,,-546264854.6600007,.
409000438620',2017-11-14,AEPS Indiaforensic INCOME 131117,,2017-11-14,,226063.76,-546038790.9000007,.
409000438620',2017-11-14,AEPS Indiaforensic GST 131117,,2017-11-14,,40691.48,-545998099.4200007,.
409000438620',2017-11-14,Indiaforensic AEPS NPCI WDL SET,,2017-11-14,,54952658.0,-491045441.4200007,.
409000438620',2017-11-14,Indiaforensic AEPS NPCI DEP SET,,2017-11-14,36147519.0,,-527192960.4200007,.
409000438620',2017-11-14,TRF TO  Indiaforensic SERVICES I,,2017-11-14,4100000.0,,-531292960.4200007,.
409000438620',2017-11-14,TRF TO  Indiaforensic SERVICES I,,2017-11-14,15000000.0,,-546292960.4200007,.
409000438620',2017-11-15,AEPS Indiaforensic INCOME 141117,,2017-11-15,,234542.79,-546058417.6300007,.
409000438620',2017-11-15,AEPS Indiaforensic GST 141117,,2017-11-15,,42217.7,-546016199.9300007,.
409000438620',2017-11-15,Indiaforensic AEPS NPCI WDL SET,,2017-11-15,,56176205.0,-489839994.93000066,.
409000438620',2017-11-15,Indiaforensic AEPS NPCI DEP SET,,2017-11-15,39130841.0,,-528970835.93000066,.
409000438620',2017-11-15,TRF TO  Indiaforensic SERVICES I,,2017-11-15,15000000.0,,-543970835.9300007,.
409000438620',2017-11-15,TRF TO  Indiaforensic SERVICES I,,2017-11-15,2300000.0,,-546270835.9300007,.
409000438620',2017-11-16,Indiaforensic AEPS NPCI WDL SET,,2017-11-16,,52958444.0,-493312391.93000066,.
409000438620',2017-11-16,Indiaforensic AEPS NPCI DEP SET,,2017-11-16,37756316.0,,-531068707.93000066,.
409000438620',2017-11-16,AEPS ACQUIRING ADJ FEES 1,,2017-11-16,123.9,,-531068831.83000064,.
409000438620',2017-11-16,AEPS ACQ REP ADJ FEES 151,,2017-11-16,,8.91,-531068822.9200006,.
409000438620',2017-11-16,AEPS Indiaforensic INCOME 151117,,2017-11-16,,222286.25,-530846536.6700006,.
409000438620',2017-11-16,AEPS Indiaforensic GST 151117,,2017-11-16,,40011.53,-530806525.14000064,.
409000438620',2017-11-16,TRF TO  Indiaforensic SERVICES I,,2017-11-16,15000000.0,,-545806525.1400006,.
409000438620',2017-11-17,AEPS ACQ REP ADJ FEES 161,,2017-11-17,,53.1,-545806472.0400006,.
409000438620',2017-11-17,AEPS Indiaforensic INCOME 161117,,2017-11-17,,196166.74,-545610305.3000005,.
409000438620',2017-11-17,AEPS Indiaforensic GST 161117,,2017-11-17,,35310.01,-545574995.2900006,.
409000438620',2017-11-17,Indiaforensic AEPS NPCI WDL SET,,2017-11-17,,48338306.0,-497236689.29000056,.
409000438620',2017-11-17,Indiaforensic AEPS NPCI DEP SET,,2017-11-17,31542975.0,,-528779664.29000056,.
409000438620',2017-11-17,TRF TO  Indiaforensic SERVICES I,,2017-11-17,15000000.0,,-543779664.2900006,.
409000438620',2017-11-17,TRF TO  Indiaforensic SERVICES I,,2017-11-17,2500000.0,,-546279664.2900006,.
409000438620',2017-11-18,AEPS ACQUIRING ADJ FEES 1,,2017-11-18,68.73,,-546279733.0200006,.
409000438620',2017-11-18,AEPS Indiaforensic INCOME 171117,,2017-11-18,,215740.35,-546063992.6700006,.
409000438620',2017-11-18,AEPS Indiaforensic GST 171117,,2017-11-18,,38833.26,-546025159.4100006,.
409000438620',2017-11-18,Indiaforensic AEPS NPCI WDL SET,,2017-11-18,,52714317.0,-493310842.41000056,.
409000438620',2017-11-18,Indiaforensic AEPS NPCI DEP SET,,2017-11-18,34518775.0,,-527829617.41000056,.
409000438620',2017-11-18,TRF TO  Indiaforensic SERVICES I,,2017-11-18,15000000.0,,-542829617.4100006,.
409000438620',2017-11-18,TRF TO  Indiaforensic SERVICES I,,2017-11-18,500000.0,,-543329617.4100006,.
409000438620',2017-11-18,TRF TO  Indiaforensic SERVICES I,,2017-11-18,500000.0,,-543829617.4100006,.
409000438620',2017-11-20,TR TO  Indiaforensic SERVICES IN,,2017-11-20,2400000.0,,-546229617.4100006,.
409000438620',2017-11-20,Indiaforensic AEPS NPCI WDL SET,,2017-11-20,,44907751.0,-501321866.41000056,.
409000438620',2017-11-20,Indiaforensic AEPS NPCI WDL SET,,2017-11-20,,27389398.0,-473932468.41000056,.
409000438620',2017-11-20,AEPS ACQUIRING ADJ FEES 1,,2017-11-20,112.1,,-473932580.5100006,.
409000438620',2017-11-20,GF723210735057/RMCPL14751/2,,2017-11-20,505.0,,-473933085.5100006,.
409000438620',2017-11-20,AEPS ACQUIRING ADJ FEES 1,,2017-11-20,2.98,,-473933088.4900006,.
409000438620',2017-11-20,AEPS Indiaforensic INCOME 181117,,2017-11-20,,184826.38,-473748262.1100006,.
409000438620',2017-11-20,AEPS Indiaforensic GST 181117,,2017-11-20,,33268.75,-473714993.3600006,.
409000438620',2017-11-20,AEPS Indiaforensic INCOME 191117,,2017-11-20,,117782.86,-473597210.5000006,.
409000438620',2017-11-20,AEPS Indiaforensic GST 191117,,2017-11-20,,21200.91,-473576009.59000057,.
409000438620',2017-11-20,Indiaforensic AEPS NPCI DEP SET,,2017-11-20,30847661.0,,-504423670.59000057,.
409000438620',2017-11-20,Indiaforensic AEPS NPCI DEP SET,,2017-11-20,18928508.0,,-523352178.59000057,.
409000438620',2017-11-20,TRF TO  Indiaforensic SERVICES I,,2017-11-20,15000000.0,,-538352178.5900006,.
409000438620',2017-11-20,TRF TO  Indiaforensic SERVICES I,,2017-11-20,5000000.0,,-543352178.5900006,.
409000438620',2017-11-20,TRF FROM  Indiaforensic SERVICES,,2017-11-20,2000000.0,,-545352178.5900006,.
409000438620',2017-11-21,AEPS ACQ REP ADJ FEES 201,,2017-11-21,,53.1,-545352125.4900006,.
409000438620',2017-11-21,AEPS Indiaforensic INCOME 201117,,2017-11-21,,110089.16,-545242036.3300006,.
409000438620',2017-11-21,AEPS Indiaforensic GST 201117,,2017-11-21,,19816.05,-545222220.2800007,.
409000438620',2017-11-21,Indiaforensic AEPS NPCI WDL SET,,2017-11-21,,26623853.0,-518598367.2800007,.
409000438620',2017-11-21,Indiaforensic AEPS NPCI DEP SET,,2017-11-21,17633432.0,,-536231799.2800007,.
409000438620',2017-11-21,TRF TO  Indiaforensic SERVICES I,,2017-11-21,10000000.0,,-546231799.2800007,.
409000438620',2017-11-21,AEPS ACQ GF723210735057/R,,2017-11-21,,505.0,-546231294.2800007,.
409000438620',2017-11-22,AEPS ACQUIRING ADJ FEES 2,,2017-11-22,29.68,,-546231323.9600006,.
409000438620',2017-11-22,AEPS ACQ REP ADJ FEES 211,,2017-11-22,,180.84,-546231143.1200006,.
409000438620',2017-11-22,AEPS Indiaforensic INCOME 211117,,2017-11-22,,126232.37,-546104910.7500006,.
409000438620',2017-11-22,AEPS Indiaforensic GST 211117,,2017-11-22,,22721.83,-546082188.9200006,.
409000438620',2017-11-22,Indiaforensic AEPS NPCI WDL SET,,2017-11-22,,30571315.0,-515510873.92000055,.
409000438620',2017-11-22,Indiaforensic AEPS NPCI DEP SET,,2017-11-22,20365745.0,,-535876618.92000055,.
409000438620',2017-11-22,CB731713731256/RMCPL17277/1,,2017-11-22,,10000.0,-535866618.92000055,.
409000438620',2017-11-22,TRF TO  Indiaforensic SERVICES I,,2017-11-22,10400000.0,,-546266618.9200006,.
409000438620',2017-11-23,Indiaforensic AEPS NPCI WDL SET,,2017-11-23,,28315092.0,-517951526.92000055,.
409000438620',2017-11-23,AEPS ACQUIRING ADJ FEES 2,,2017-11-23,57.67,,-517951584.59000057,.
409000438620',2017-11-23,AEPS Indiaforensic INCOME 221117,,2017-11-23,,121982.24,-517829602.35000056,.
409000438620',2017-11-23,AEPS Indiaforensic GST 221117,,2017-11-23,,21956.8,-517807645.55000055,.
409000438620',2017-11-23,Indiaforensic AEPS NPCI DEP SET,,2017-11-23,21808529.0,,-539616174.5500005,.
409000438620',2017-11-23,TRF TO  Indiaforensic SERVICES I,,2017-11-23,6600000.0,,-546216174.5500005,.
409000438620',2017-11-24,Indiaforensic AEPS NPCI WDL SET,,2017-11-24,,36060570.0,-510155604.55000055,.
409000438620',2017-11-24,Indiaforensic AEPS NPCI DEP SET,,2017-11-24,27078379.0,,-537233983.5500005,.
409000438620',2017-11-24,AEPS ACQ REP ADJ FEES 231,,2017-11-24,,87.34,-537233896.2100005,.
409000438620',2017-11-24,AEPS Indiaforensic INCOME 231117,,2017-11-24,,157613.38,-537076282.8300005,.
409000438620',2017-11-24,AEPS Indiaforensic GST 231117,,2017-11-24,,28370.41,-537047912.4200006,.
409000438620',2017-11-24,TRF TO  Indiaforensic SERVICES I,,2017-11-24,9200000.0,,-546247912.4200006,.
409000438620',2017-11-27,Indiaforensic AEPS NPCI WDL SET,,2017-11-27,,37283734.0,-508964178.42000055,.
409000438620',2017-11-27,Indiaforensic AEPS NPCI WDL SET,,2017-11-27,,37862206.0,-471101972.42000055,.
409000438620',2017-11-27,Indiaforensic AEPS NPCI WDL SET,,2017-11-27,,27541291.0,-443560681.42000055,.
409000438620',2017-11-27,Indiaforensic AEPS NPCI DEP SET,,2017-11-27,26760645.0,,-470321326.42000055,.
409000438620',2017-11-27,Indiaforensic AEPS NPCI DEP SET,,2017-11-27,25080090.0,,-495401416.42000055,.
409000438620',2017-11-27,Indiaforensic AEPS NPCI DEP SET,,2017-11-27,20008977.0,,-515410393.42000055,.
409000438620',2017-11-27,TRF TO  Indiaforensic SERVICES I,,2017-11-27,15000000.0,,-530410393.42000055,.
409000438620',2017-11-27,TRF TO  Indiaforensic SERVICES I,,2017-11-27,15000000.0,,-545410393.4200006,.
409000438620',2017-11-27,AEPS ACQUIRING ADJ FEES 2,,2017-11-27,155.78,,-545410549.2000005,.
409000438620',2017-11-27,AEPS Indiaforensic INCOME 241117,,2017-11-27,,157356.08,-545253193.1200005,.
409000438620',2017-11-27,AEPS Indiaforensic GST 241117,,2017-11-27,,28324.09,-545224869.0300004,.
409000438620',2017-11-27,AEPS Indiaforensic INCOME 251117,,2017-11-27,,160412.51,-545064456.5200005,.
409000438620',2017-11-27,AEPS Indiaforensic GST 251117,,2017-11-27,,28874.25,-545035582.2700005,.
409000438620',2017-11-27,AEPS Indiaforensic INCOME 261117,,2017-11-27,,121967.5,-544913614.7700005,.
409000438620',2017-11-27,AEPS Indiaforensic GST 261117,,2017-11-27,,21954.15,-544891660.6200005,.
409000438620',2017-11-28,AEPS ACQUIRING ADJ FEES 2,,2017-11-28,35.4,,-544891696.0200005,.
409000438620',2017-11-28,AEPS ACQ REP ADJ FEES 271,,2017-11-28,,40.12,-544891655.9000005,.
409000438620',2017-11-28,AEPS Indiaforensic INCOME 271117,,2017-11-28,,174417.53,-544717238.3700005,.
409000438620',2017-11-28,AEPS Indiaforensic GST 271117,,2017-11-28,,31395.16,-544685843.2100005,.
409000438620',2017-11-28,Indiaforensic AEPS NPCI WDL SET,,2017-11-28,,42018820.0,-502667023.2100005,.
409000438620',2017-11-28,Indiaforensic AEPS NPCI DEP SET,,2017-11-28,27474604.0,,-530141627.2100005,.
409000438620',2017-11-28,TRF TO  Indiaforensic SERVICES I,,2017-11-28,10000000.0,,-540141627.2100005,.
409000438620',2017-11-28,TRF TO  Indiaforensic SERVICES I,,2017-11-28,3000000.0,,-543141627.2100005,.
409000438620',2017-11-28,TRF TO  Indiaforensic SERVICES I,,2017-11-28,2000000.0,,-545141627.2100005,.
409000438620',2017-11-29,Indiaforensic AEPS NPCI WDL SET,,2017-11-29,,41838914.0,-503302713.2100005,.
409000438620',2017-11-29,AEPS ACQ REP ADJ FEES 281,,2017-11-29,,35.4,-503302677.81000054,.
409000438620',2017-11-29,AEPS Indiaforensic INCOME 281117,,2017-11-29,,180425.54,-503122252.2700005,.
409000438620',2017-11-29,AEPS Indiaforensic GST 281117,,2017-11-29,,32476.6,-503089775.6700005,.
409000438620',2017-11-29,Indiaforensic AEPS NPCI DEP SET,,2017-11-29,31244025.0,,-534333800.6700005,.
409000438620',2017-11-29,TRF TO  Indiaforensic SERVICES I,,2017-11-29,11900000.0,,-546233800.6700006,.
409000438620',2017-11-30,AEPS ACQUIRING ADJ FEES 2,,2017-11-30,91.45,,-546233892.1200006,.
409000438620',2017-11-30,AEPS ACQ REP ADJ FEES 291,,2017-11-30,,73.75,-546233818.3700006,.
409000438620',2017-11-30,AEPS Indiaforensic INCOME 291117,,2017-11-30,,168751.43,-546065066.9400007,.
409000438620',2017-11-30,AEPS Indiaforensic GST 291117,,2017-11-30,,30375.26,-546034691.6800007,.
409000438620',2017-11-30,Indiaforensic AEPS NPCI WDL SET,,2017-11-30,,39070586.0,-506964105.68000066,.
409000438620',2017-11-30,Indiaforensic AEPS NPCI DEP SET,,2017-11-30,29671066.0,,-536635171.68000066,.
409000438620',2017-11-30,TRF TO  Indiaforensic SERVICES I,,2017-11-30,9600000.0,,-546235171.6800007,.
409000438620',2017-12-02,Indiaforensic AEPS NPCI WDL SET,,2017-12-02,,37529327.0,-508705844.68000066,.
409000438620',2017-12-02,Indiaforensic AEPS NPCI WDL SET,,2017-12-02,,32640685.0,-476065159.68000066,.
409000438620',2017-12-02,Indiaforensic AEPS NPCI DEP SET,,2017-12-02,29285130.0,,-505350289.68000066,.
409000438620',2017-12-02,Indiaforensic AEPS NPCI DEP SET,,2017-12-02,22464135.0,,-527814424.68000066,.
409000438620',2017-12-02,FUND TRF TO  Indiaforensic SERVI,,2017-12-02,15000000.0,,-542814424.6800007,.
409000438620',2017-12-02,FUND TRF TO  Indiaforensic SERVI,,2017-12-02,3000000.0,,-545814424.6800007,.
409000438620',2017-12-02,AEPS ACQUIRING ADJ FEES 0,,2017-12-02,29.5,,-545814454.1800007,.
409000438620',2017-12-02,AEPS Indiaforensic INCOME 301117,,2017-12-02,,161908.42,-545652545.7600007,.
409000438620',2017-12-02,AEPS Indiaforensic GST 301117,,2017-12-02,,29143.52,-545623402.2400007,.
409000438620',2017-12-02,AEPS Indiaforensic INCOME 011217,,2017-12-02,,132084.36,-545491317.8800007,.
409000438620',2017-12-02,AEPS Indiaforensic GST 011217,,2017-12-02,,23775.18,-545467542.7000008,.
409000438620',2017-12-04,Indiaforensic AEPS NPCI WDL SET,,2017-12-04,,34170088.0,-511297454.70000076,.
409000438620',2017-12-04,Indiaforensic AEPS NPCI WDL SET,,2017-12-04,,25047758.0,-486249696.70000076,.
409000438620',2017-12-04,Indiaforensic AEPS NPCI DEP SET,,2017-12-04,24579331.0,,-510829027.70000076,.
409000438620',2017-12-04,Indiaforensic AEPS NPCI DEP SET,,2017-12-04,19098613.0,,-529927640.70000076,.
409000438620',2017-12-04,TRF TO  Indiaforensic SERVICES I,,2017-12-04,10000000.0,,-539927640.7000008,.
409000438620',2017-12-04,TRF TO  Indiaforensic SERVICES I,,2017-12-04,6300000.0,,-546227640.7000008,.
409000438620',2017-12-04,AEPS ACQ CR ADJ FEES 0212,,2017-12-04,1225.41,,-546228866.1100007,.
409000438620',2017-12-04,AEPS ACQ REP ADJ FEES 021,,2017-12-04,,70.8,-546228795.3100008,.
409000438620',2017-12-04,AEPS Indiaforensic INCOME 021217,,2017-12-04,,142546.27,-546086249.0400008,.
409000438620',2017-12-04,AEPS Indiaforensic GST 021217,,2017-12-04,,25658.33,-546060590.7100008,.
409000438620',2017-12-04,AEPS Indiaforensic INCOME 031217,,2017-12-04,,109107.58,-545951483.1300007,.
409000438620',2017-12-04,AEPS Indiaforensic GST 031217,,2017-12-04,,19639.36,-545931843.7700007,.
409000438620',2017-12-05,Indiaforensic AEPS NPCI WDL SET,,2017-12-05,,36416574.0,-509515269.7700007,.
409000438620',2017-12-05,Indiaforensic AEPS NPCI DEP SET,,2017-12-05,23049245.0,,-532564514.7700007,.
409000438620',2017-12-05,CR730414432430/RMCPL13344/3,,2017-12-05,1000.0,,-532565514.7700007,.
409000438620',2017-12-05,CR730414457863/RMCPL18803/3,,2017-12-05,500.0,,-532566014.7700007,.
409000438620',2017-12-05,CR730414432302/RMCPL00220/3,,2017-12-05,6000.0,,-532572014.7700007,.
409000438620',2017-12-05,CR730414432322/RMCPL12045/3,,2017-12-05,1220.0,,-532573234.7700007,.
409000438620',2017-12-05,CR730414432366/RMCPL15559/3,,2017-12-05,1020.0,,-532574254.7700007,.
409000438620',2017-12-05,CR730414432368/RMCPL12005/3,,2017-12-05,4800.0,,-532579054.7700007,.
409000438620',2017-12-05,CR730414432377/RMCPL17908/3,,2017-12-05,3000.0,,-532582054.7700007,.
409000438620',2017-12-05,CR730414432387/RMCPL14773/3,,2017-12-05,10000.0,,-532592054.7700007,.
409000438620',2017-12-05,CR730414432397/RMCPL17307/3,,2017-12-05,2500.0,,-532594554.7700007,.
409000438620',2017-12-05,CR730414432404/RMCPL18590/3,,2017-12-05,6000.0,,-532600554.7700007,.
409000438620',2017-12-05,CR730414432410/RMCPL10426/3,,2017-12-05,5000.0,,-532605554.7700007,.
409000438620',2017-12-05,CR730414432429/RMCPL09152/3,,2017-12-05,3000.0,,-532608554.7700007,.
409000438620',2017-12-05,CR731213671578/RMCPL15744/0,,2017-12-05,100.0,,-532608654.7700007,.
409000438620',2017-12-05,CR731513434787/RMCPL12121/1,,2017-12-05,2020.0,,-532610674.7700007,.
409000438620',2017-12-05,CR731513434922/RMCPL17122/1,,2017-12-05,1500.0,,-532612174.7700007,.
409000438620',2017-12-05,CR731513434916/RMCPL14558/1,,2017-12-05,800.0,,-532612974.7700007,.
409000438620',2017-12-05,CR731513434923/RMCPL01852/1,,2017-12-05,2000.0,,-532614974.7700007,.
409000438620',2017-12-05,CR731513434821/RMCPL11588/1,,2017-12-05,2000.0,,-532616974.7700007,.
409000438620',2017-12-05,CR731513434839/RMCPL16871/1,,2017-12-05,300.0,,-532617274.7700007,.
409000438620',2017-12-05,CR731513434789/RMCPL15451/1,,2017-12-05,3000.0,,-532620274.7700007,.
409000438620',2017-12-05,CR731713731044/RMCPL17937/1,,2017-12-05,2800.0,,-532623074.7700007,.
409000438620',2017-12-05,CR731713731047/RMCPL09061/1,,2017-12-05,10000.0,,-532633074.7700007,.
409000438620',2017-12-05,CR731713731083/RMCPL17555/1,,2017-12-05,500.0,,-532633574.7700007,.
409000438620',2017-12-05,CR731713731099/RMCPL20674/1,,2017-12-05,500.0,,-532634074.7700007,.
409000438620',2017-12-05,CR731713731120/RMCPL11680/1,,2017-12-05,2010.0,,-532636084.7700007,.
409000438620',2017-12-05,CR731713731131/RMCPL17270/1,,2017-12-05,6000.0,,-532642084.7700007,.
409000438620',2017-12-05,CR731713731147/RMCPL14720/1,,2017-12-05,1210.0,,-532643294.7700007,.
409000438620',2017-12-05,CR731713730975/RMCPL15577/1,,2017-12-05,5100.0,,-532648394.7700007,.
409000438620',2017-12-05,CR731713731269/RMCPL14181/1,,2017-12-05,1000.0,,-532649394.7700007,.
409000438620',2017-12-05,CR731713731203/RMCPL17745/1,,2017-12-05,2030.0,,-532651424.7700007,.
409000438620',2017-12-05,CR731713731052/RMCPL09117/1,,2017-12-05,10000.0,,-532661424.7700007,.
409000438620',2017-12-05,CR731713730970/RMCPL11091/1,,2017-12-05,1000.0,,-532662424.7700007,.
409000438620',2017-12-05,CR731713730985/RMCPL11676/1,,2017-12-05,700.0,,-532663124.7700007,.
409000438620',2017-12-05,CR731713730995/RMCPL16781/1,,2017-12-05,400.0,,-532663524.7700007,.
409000438620',2017-12-05,CR731713731039/RMCPL09840/1,,2017-12-05,1000.0,,-532664524.7700007,.
409000438620',2017-12-05,CR731713731076/RMCPL19241/1,,2017-12-05,10000.0,,-532674524.7700007,.
409000438620',2017-12-05,CR731713731246/RMCPL10820/1,,2017-12-05,2500.0,,-532677024.7700007,.
409000438620',2017-12-05,CR732216310489/RMCPL16291/1,,2017-12-05,720.0,,-532677744.7700007,.
409000438620',2017-12-05,CR732216310508/RMCPL17668/1,,2017-12-05,1000.0,,-532678744.7700007,.
409000438620',2017-12-05,CR732216310517/RMCPL14017/1,,2017-12-05,510.0,,-532679254.7700007,.
409000438620',2017-12-05,CR732216314747/RMCPL14040/1,,2017-12-05,620.0,,-532679874.7700007,.
409000438620',2017-12-05,CR732216314751/RMCPL12429/1,,2017-12-05,500.0,,-532680374.7700007,.
409000438620',2017-12-05,CR732216314756/RMCPL14185/1,,2017-12-05,100.0,,-532680474.7700007,.
409000438620',2017-12-05,CR732216314784/RMCPL11889/1,,2017-12-05,1000.0,,-532681474.7700007,.
409000438620',2017-12-05,CR732216314834/RMCPL18298/1,,2017-12-05,310.0,,-532681784.7700007,.
409000438620',2017-12-05,CR732216314839/RMCPL21340/1,,2017-12-05,100.0,,-532681884.7700007,.
409000438620',2017-12-05,CR732216314896/RMCPL16723/1,,2017-12-05,400.0,,-532682284.7700007,.
409000438620',2017-12-05,CR732216314906/RMCPL20625/1,,2017-12-05,200.0,,-532682484.7700007,.
409000438620',2017-12-05,CR732216314916/RMCPL16624/1,,2017-12-05,5000.0,,-532687484.7700007,.
409000438620',2017-12-05,CR732216314971/RMCPL16467/1,,2017-12-05,1010.0,,-532688494.7700007,.
409000438620',2017-12-05,CR732216314986/RMCPL17202/1,,2017-12-05,620.0,,-532689114.7700007,.
409000438620',2017-12-05,CR732216315030/RMCPL18299/1,,2017-12-05,3000.0,,-532692114.7700007,.
409000438620',2017-12-05,CR732216315082/RMCPL17486/1,,2017-12-05,1000.0,,-532693114.7700007,.
409000438620',2017-12-05,CR732216315094/RMCPL18702/1,,2017-12-05,2002.0,,-532695116.7700007,.
409000438620',2017-12-05,CR732217329010/RMCPL14190/1,,2017-12-05,1600.0,,-532696716.7700007,.
409000438620',2017-12-05,CR732217329020/RMCPL15556/1,,2017-12-05,5000.0,,-532701716.7700007,.
409000438620',2017-12-05,CR732217329142/RMCPL17486/1,,2017-12-05,300.0,,-532702016.7700007,.
409000438620',2017-12-05,CR732217329159/RMCPL09925/1,,2017-12-05,1000.0,,-532703016.7700007,.
409000438620',2017-12-05,CR732217329181/RMCPL12826/1,,2017-12-05,5000.0,,-532708016.7700007,.
409000438620',2017-12-05,CR732217321394/RMCPL14609/1,,2017-12-05,4000.0,,-532712016.7700007,.
409000438620',2017-12-05,CR732217321398/RMCPL00045/1,,2017-12-05,1020.0,,-532713036.7700007,.
409000438620',2017-12-05,CR732217329282/RMCPL18509/1,,2017-12-05,5000.0,,-532718036.7700007,.
409000438620',2017-12-05,CR732217329292/RMCPL19955/1,,2017-12-05,5000.0,,-532723036.7700007,.
409000438620',2017-12-05,CR732217329323/RMCPL11281/1,,2017-12-05,400.0,,-532723436.7700007,.
409000438620',2017-12-05,CR732217329441/RMCPL14838/1,,2017-12-05,1000.0,,-532724436.7700007,.
409000438620',2017-12-05,CR732217329501/RMCPL19665/1,,2017-12-05,350.0,,-532724786.7700007,.
409000438620',2017-12-05,CR732217338866/RMCPL14809/1,,2017-12-05,816.0,,-532725602.7700007,.
409000438620',2017-12-05,CR732217338894/RMCPL20339/1,,2017-12-05,2000.0,,-532727602.7700007,.
409000438620',2017-12-05,CR732217338901/RMCPL17152/1,,2017-12-05,3500.0,,-532731102.7700007,.
409000438620',2017-12-05,CR732217329355/RMCPL11613/1,,2017-12-05,6000.0,,-532737102.7700007,.
409000438620',2017-12-05,CR732217329406/RMCPL14181/1,,2017-12-05,420.0,,-532737522.7700007,.
409000438620',2017-12-05,CR732217323077/RMCPL16496/1,,2017-12-05,300.0,,-532737822.7700007,.
409000438620',2017-12-05,CR732217323087/RMCPL15393/1,,2017-12-05,2537.0,,-532740359.7700007,.
409000438620',2017-12-05,CR732217323093/RMCPL18650/1,,2017-12-05,500.0,,-532740859.7700007,.
409000438620',2017-12-05,CR732217323135/RMCPL15038/1,,2017-12-05,4000.0,,-532744859.7700007,.
409000438620',2017-12-05,CR732217339023/RMCPL17076/1,,2017-12-05,600.0,,-532745459.7700007,.
409000438620',2017-12-05,CR732217339057/RMCPL16050/1,,2017-12-05,3000.0,,-532748459.7700007,.
409000438620',2017-12-05,CR732217319291/RMCPL17924/1,,2017-12-05,405.0,,-532748864.7700007,.
409000438620',2017-12-05,CR732217319339/RMCPL14980/1,,2017-12-05,5000.0,,-532753864.7700007,.
409000438620',2017-12-05,CR732217319254/RMCPL02162/1,,2017-12-05,910.0,,-532754774.7700007,.
409000438620',2017-12-05,CR732217319348/RMCPL16988/1,,2017-12-05,175.0,,-532754949.7700007,.
409000438620',2017-12-05,CR732217319362/RMCPL20885/1,,2017-12-05,5000.0,,-532759949.7700007,.
409000438620',2017-12-05,CR732217319388/RMCPL10689/1,,2017-12-05,205.0,,-532760154.7700007,.
409000438620',2017-12-05,CR732217323168/RMCPL18763/1,,2017-12-05,400.0,,-532760554.7700007,.
409000438620',2017-12-05,CR732217323187/RMCPL19821/1,,2017-12-05,2000.0,,-532762554.7700007,.
409000438620',2017-12-05,CR732217323246/RMCPL20466/1,,2017-12-05,1000.0,,-532763554.7700007,.
409000438620',2017-12-05,CR732217338819/RMCPL18468/1,,2017-12-05,100.0,,-532763654.7700007,.
409000438620',2017-12-05,CR732217324727/RMCPL14126/1,,2017-12-05,300.0,,-532763954.7700007,.
409000438620',2017-12-05,CR732217324745/RMCPL11949/1,,2017-12-05,410.0,,-532764364.7700007,.
409000438620',2017-12-05,CR732216314653/RMCPL19362/1,,2017-12-05,500.0,,-532764864.7700007,.
409000438620',2017-12-05,CR732216314656/RMCPL12378/1,,2017-12-05,1200.0,,-532766064.7700007,.
409000438620',2017-12-05,CR732216314660/RMCPL15468/1,,2017-12-05,3000.0,,-532769064.7700007,.
409000438620',2017-12-05,CR732217324497/RMCPL14040/1,,2017-12-05,2040.0,,-532771104.7700007,.
409000438620',2017-12-05,CR732217324502/RMCPL11213/1,,2017-12-05,10000.0,,-532781104.7700007,.
409000438620',2017-12-05,CR732217324515/RMCPL17010/1,,2017-12-05,1010.0,,-532782114.7700007,.
409000438620',2017-12-05,CR732217324563/RMCPL16185/1,,2017-12-05,205.0,,-532782319.7700007,.
409000438620',2017-12-05,CR732217324582/RMCPL08170/1,,2017-12-05,7800.0,,-532790119.7700007,.
409000438620',2017-12-05,CR732217324596/RMCPL16481/1,,2017-12-05,100.0,,-532790219.7700007,.
409000438620',2017-12-05,CR732217324642/RMCPL16215/1,,2017-12-05,1000.0,,-532791219.7700007,.
409000438620',2017-12-05,CR732217324653/RMCPL15895/1,,2017-12-05,1500.0,,-532792719.7700007,.
409000438620',2017-12-05,CR732217324656/RMCPL13553/1,,2017-12-05,4000.0,,-532796719.7700007,.
409000438620',2017-12-05,CR732217338758/RMCPL16925/1,,2017-12-05,1000.0,,-532797719.7700007,.
409000438620',2017-12-05,CR732217338776/RMCPL14429/1,,2017-12-05,6000.0,,-532803719.7700007,.
409000438620',2017-12-05,CR732216310420/RMCPL10316/1,,2017-12-05,8000.0,,-532811719.7700007,.
409000438620',2017-12-05,CR732216310487/RMCPL18702/1,,2017-12-05,5005.0,,-532816724.7700007,.
409000438620',2017-12-05,CR732217329027/RMCPL16433/1,,2017-12-05,1010.0,,-532817734.7700007,.
409000438620',2017-12-05,CR732217329028/RMCPL14428/1,,2017-12-05,5000.0,,-532822734.7700007,.
409000438620',2017-12-05,CR732217319519/RMCPL17904/1,,2017-12-05,1500.0,,-532824234.7700007,.
409000438620',2017-12-05,CR732217338844/RMCPL11406/1,,2017-12-05,1000.0,,-532825234.7700007,.
409000438620',2017-12-05,CR732217338982/RMCPL18142/1,,2017-12-05,2000.0,,-532827234.7700007,.
409000438620',2017-12-05,CR732217319410/RMCPL19949/1,,2017-12-05,5360.0,,-532832594.7700007,.
409000438620',2017-12-05,CR732217319434/RMCPL20339/1,,2017-12-05,1100.0,,-532833694.7700007,.
409000438620',2017-12-05,CR732217319464/RMCPL13070/1,,2017-12-05,500.0,,-532834194.7700007,.
409000438620',2017-12-05,CR732217319499/RMCPL19639/1,,2017-12-05,810.0,,-532835004.7700007,.
409000438620',2017-12-05,CR732217319513/RMCPL17202/1,,2017-12-05,615.0,,-532835619.7700007,.
409000438620',2017-12-05,CR732216311767/RMCPL17699/1,,2017-12-05,1500.0,,-532837119.7700007,.
409000438620',2017-12-05,CR732217324762/RMCPL17668/1,,2017-12-05,1000.0,,-532838119.7700007,.
409000438620',2017-12-05,CR732216311749/RMCPL20956/1,,2017-12-05,147.0,,-532838266.7700007,.
409000438620',2017-12-05,CR732216314685/RMCPL14163/1,,2017-12-05,800.0,,-532839066.7700007,.
409000438620',2017-12-05,CR732216314717/RMCPL11850/1,,2017-12-05,900.0,,-532839966.7700007,.
409000438620',2017-12-05,CR732216314721/RMCPL14838/1,,2017-12-05,2000.0,,-532841966.7700007,.
409000438620',2017-12-05,CR732217329044/RMCPL13776/1,,2017-12-05,500.0,,-532842466.7700007,.
409000438620',2017-12-05,CR732217329058/RMCPL16911/1,,2017-12-05,1020.0,,-532843486.7700007,.
409000438620',2017-12-05,CR732217329068/RMCPL00704/1,,2017-12-05,1030.0,,-532844516.7700007,.
409000438620',2017-12-05,CR732217329078/RMCPL17533/1,,2017-12-05,320.0,,-532844836.7700007,.
409000438620',2017-12-05,CR732217329137/RMCPL00256/1,,2017-12-05,2020.0,,-532846856.7700007,.
409000438620',2017-12-05,CR732416538032/RMCPL21060/2,,2017-12-05,500.0,,-532847356.7700007,.
409000438620',2017-12-05,CR732416540438/RMCPL13814/2,,2017-12-05,100.0,,-532847456.7700007,.
409000438620',2017-12-05,CR732416540549/RMCPL20942/2,,2017-12-05,5000.0,,-532852456.7700007,.
409000438620',2017-12-05,CR732415532044/RMCPL19539/2,,2017-12-05,1800.0,,-532854256.7700007,.
409000438620',2017-12-05,CR732416537773/RMCPL17653/2,,2017-12-05,3000.0,,-532857256.7700007,.
409000438620',2017-12-05,CR732416539347/RMCPL13148/2,,2017-12-05,500.0,,-532857756.7700007,.
409000438620',2017-12-05,CR732416543380/RMCPL00015/2,,2017-12-05,100.0,,-532857856.7700007,.
409000438620',2017-12-05,CR732415531792/RMCPL19499/2,,2017-12-05,900.0,,-532858756.7700007,.
409000438620',2017-12-05,CR732415531825/RMCPL14102/2,,2017-12-05,2020.0,,-532860776.7700007,.
409000438620',2017-12-05,CR732416543532/RMCPL20731/2,,2017-12-05,10000.0,,-532870776.7700007,.
409000438620',2017-12-05,AEPS ACQUIRING ADJ FEES 0,,2017-12-05,2.95,,-532870779.7200007,.
409000438620',2017-12-05,AEPS ACQ REP ADJ FEES 041,,2017-12-05,,29.5,-532870750.2200007,.
409000438620',2017-12-05,AEPS Indiaforensic INCOME 041217,,2017-12-05,,147199.57,-532723550.6500007,.
409000438620',2017-12-05,AEPS Indiaforensic GST 041217,,2017-12-05,,26495.92,-532697054.7300007,.
409000438620',2017-12-05,TRF TO  Indiaforensic SERVICES I,,2017-12-05,10000000.0,,-542697054.7300007,.
409000438620',2017-12-05,TRF TO  Indiaforensic SERVICES I,,2017-12-05,3000000.0,,-545697054.7300007,.
409000438620',2017-12-06,Indiaforensic AEPS NPCI WDL SET,,2017-12-06,,39736727.0,-505960327.73000073,.
409000438620',2017-12-06,AEPS Indiaforensic INCOME 051217,,2017-12-06,,163312.28,-505797015.45000076,.
409000438620',2017-12-06,AEPS Indiaforensic GST 051217,,2017-12-06,,29396.21,-505767619.2400008,.
409000438620',2017-12-06,Indiaforensic AEPS NPCI DEP SET,,2017-12-06,27038201.0,,-532805820.2400008,.
409000438620',2017-12-06,TRF TO  Indiaforensic SERVICES I,,2017-12-06,13500000.0,,-546305820.2400007,.
409000438620',2017-12-06,CB732416538603/RMCPL20706/2,,2017-12-06,,500.0,-546305320.2400007,.
409000438620',2017-12-06,CB732217329517/RMCPL20458/1,,2017-12-06,,6900.0,-546298420.2400007,.
409000438620',2017-12-06,CB732217339041/RMCPL13527/1,,2017-12-06,10000.0,,-546308420.2400007,.
409000438620',2017-12-06,CB732217324663/RMCPL21301/1,,2017-12-06,100.0,,-546308520.2400007,.
409000438620',2017-12-06,CB732217319322/RMCPL15922/1,,2017-12-06,4000.0,,-546312520.2400007,.
409000438620',2017-12-06,CB732217319442/RMCPL15900/1,,2017-12-06,1000.0,,-546313520.2400007,.
409000438620',2017-12-07,AEPS ACQUIRING ADJ FEES 0,,2017-12-07,17.7,,-546313537.9400008,.
409000438620',2017-12-07,AEPS Indiaforensic INCOME 061217,,2017-12-07,,173574.98,-546139962.9600008,.
409000438620',2017-12-07,AEPS Indiaforensic GST 061217,,2017-12-07,,31243.5,-546108719.4600008,.
409000438620',2017-12-07,Indiaforensic AEPS NPCI WDL SET,,2017-12-07,,41540136.0,-504568583.46000075,.
409000438620',2017-12-07,Indiaforensic AEPS NPCI DEP SET,,2017-12-07,29420721.0,,-533989304.46000075,.
409000438620',2017-12-07,REV CB732416538603/RMCPL207,,2017-12-07,500.0,,-533989804.46000075,.
409000438620',2017-12-07,REV CB732217329517/RMCPL204,,2017-12-07,6900.0,,-533996704.46000075,.
409000438620',2017-12-07,CB732416538603/RMCPL20706/2,,2017-12-07,500.0,,-533997204.46000075,.
409000438620',2017-12-07,CB732217329517/RMCPL20458/1,,2017-12-07,6900.0,,-534004104.46000075,.
409000438620',2017-12-07,REV CB732217339041/RMCPL135,,2017-12-07,,10000.0,-533994104.46000075,.
409000438620',2017-12-07,REV CB732217324663/RMCPL213,,2017-12-07,,100.0,-533994004.46000075,.
409000438620',2017-12-07,REV CB732217319322/RMCPL159,,2017-12-07,,4000.0,-533990004.46000075,.
409000438620',2017-12-07,REV CB732217319442/RMCPL159,,2017-12-07,,1000.0,-533989004.46000075,.
409000438620',2017-12-07,CB732217339041/RMCPL13527/1,,2017-12-07,,10000.0,-533979004.46000075,.
409000438620',2017-12-07,CB732217324663/RMCPL21301/1,,2017-12-07,,100.0,-533978904.46000075,.
409000438620',2017-12-07,CB732217319322/RMCPL15922/1,,2017-12-07,,4000.0,-533974904.46000075,.
409000438620',2017-12-07,CB732217319442/RMCPL15900/1,,2017-12-07,,1000.0,-533973904.46000075,.
409000438620',2017-12-07,TRF TO  Indiaforensic SERVICES I,,2017-12-07,12300000.0,,-546273904.4600008,.
409000438620',2017-12-08,Indiaforensic AEPS NPCI WDL SET,,2017-12-08,,45158759.0,-501115145.46000075,.
409000438620',2017-12-08,Indiaforensic AEPS NPCI DEP SET,,2017-12-08,32815401.0,,-533930546.46000075,.
409000438620',2017-12-08,AEPS ACQ CR ADJ FEES 0612,,2017-12-08,440.13,,-533930986.59000075,.
409000438620',2017-12-08,CR733008873599/RMCPL12793/2,,2017-12-08,500.0,,-533931486.59000075,.
409000438620',2017-12-08,CR733410237514/RMCPL18600/3,,2017-12-08,1000.0,,-533932486.59000075,.
409000438620',2017-12-08,CR733811498473/RMCPL12120/0,,2017-12-08,2500.0,,-533934986.59000075,.
409000438620',2017-12-08,CR733812589790/RMCPL16935/0,,2017-12-08,500.0,,-533935486.59000075,.
409000438620',2017-12-08,CR733812589783/RMCPL13751/0,,2017-12-08,1000.0,,-533936486.59000075,.
409000438620',2017-12-08,CR733812559608/RMCPL11248/0,,2017-12-08,600.0,,-533937086.59000075,.
409000438620',2017-12-08,CR733812559615/RMCPL12312/0,,2017-12-08,1000.0,,-533938086.59000075,.
409000438620',2017-12-08,CR733812559552/RMCPL13514/0,,2017-12-08,4000.0,,-533942086.59000075,.
409000438620',2017-12-08,CR733812559555/RMCPL18160/0,,2017-12-08,500.0,,-533942586.59000075,.
409000438620',2017-12-08,CR733810444808/RMCPL19052/0,,2017-12-08,2000.0,,-533944586.59000075,.
409000438620',2017-12-08,CR733812555567/RMCPL13344/0,,2017-12-08,3000.0,,-533947586.59000075,.
409000438620',2017-12-08,CR733812555643/RMCPL16726/0,,2017-12-08,500.0,,-533948086.59000075,.
409000438620',2017-12-08,CR733812555654/RMCPL18173/0,,2017-12-08,500.0,,-533948586.59000075,.
409000438620',2017-12-08,CR733812559761/RMCPL18859/0,,2017-12-08,1000.0,,-533949586.59000075,.
409000438620',2017-12-08,CR733812561975/RMCPL18859/0,,2017-12-08,1000.0,,-533950586.59000075,.
409000438620',2017-12-08,CR733812562041/RMCPL14786/0,,2017-12-08,10000.0,,-533960586.59000075,.
409000438620',2017-12-08,CR733812562059/RMCPL16835/0,,2017-12-08,3000.0,,-533963586.59000075,.
409000438620',2017-12-08,CR733812562067/RMCPL17498/0,,2017-12-08,5000.0,,-533968586.59000075,.
409000438620',2017-12-08,CR733812562167/RMCPL15788/0,,2017-12-08,6000.0,,-533974586.59000075,.
409000438620',2017-12-08,CR733812555657/RMCPL19734/0,,2017-12-08,1500.0,,-533976086.59000075,.
409000438620',2017-12-08,CR733812555672/RMCPL20188/0,,2017-12-08,2500.0,,-533978586.59000075,.
409000438620',2017-12-08,CR733812555684/RMCPL16428/0,,2017-12-08,2000.0,,-533980586.59000075,.
409000438620',2017-12-08,CR733812589498/RMCPL16388/0,,2017-12-08,2500.0,,-533983086.59000075,.
409000438620',2017-12-08,CR733812589613/RMCPL20403/0,,2017-12-08,2000.0,,-533985086.59000075,.
409000438620',2017-12-08,CR733813610240/RMCPL19414/0,,2017-12-08,2000.0,,-533987086.59000075,.
409000438620',2017-12-08,CR733813610243/RMCPL17095/0,,2017-12-08,10000.0,,-533997086.59000075,.
409000438620',2017-12-08,CR733813610275/RMCPL18236/0,,2017-12-08,1000.0,,-533998086.59000075,.
409000438620',2017-12-08,CR733813610312/RMCPL16353/0,,2017-12-08,500.0,,-533998586.59000075,.
409000438620',2017-12-08,CR733812555693/RMCPL14609/0,,2017-12-08,10000.0,,-534008586.59000075,.
409000438620',2017-12-08,CR733812559662/RMCPL16684/0,,2017-12-08,2000.0,,-534010586.59000075,.
409000438620',2017-12-08,CR733812559667/RMCPL20519/0,,2017-12-08,6000.0,,-534016586.59000075,.
409000438620',2017-12-08,CR733812559729/RMCPL18440/0,,2017-12-08,2000.0,,-534018586.59000075,.
409000438620',2017-12-08,CR733811498585/RMCPL16637/0,,2017-12-08,1500.0,,-534020086.59000075,.
409000438620',2017-12-08,CR733811498676/RMCPL17600/0,,2017-12-08,1000.0,,-534021086.59000075,.
409000438620',2017-12-08,CR733811498686/RMCPL16127/0,,2017-12-08,10000.0,,-534031086.59000075,.
409000438620',2017-12-08,CR733812589711/RMCPL19689/0,,2017-12-08,3000.0,,-534034086.59000075,.
409000438620',2017-12-08,CR733812589716/RMCPL16396/0,,2017-12-08,1000.0,,-534035086.59000075,.
409000438620',2017-12-08,CR733812589717/RMCPL13344/0,,2017-12-08,1000.0,,-534036086.59000075,.
409000438620',2017-12-08,CR733812559636/RMCPL11264/0,,2017-12-08,500.0,,-534036586.59000075,.
409000438620',2017-12-08,CR733811498453/RMCPL18551/0,,2017-12-08,3020.0,,-534039606.59000075,.
409000438620',2017-12-08,CR733811498477/RMCPL21281/0,,2017-12-08,3000.0,,-534042606.59000075,.
409000438620',2017-12-08,AEPS Indiaforensic INCOME 071217,,2017-12-08,,192811.45,-533849795.14000076,.
409000438620',2017-12-08,AEPS Indiaforensic GST 071217,,2017-12-08,,34706.06,-533815089.08000076,.
409000438620',2017-12-08,TRF TO  Indiaforensic SERVICES I,,2017-12-08,12400000.0,,-546215089.0800008,.
409000438620',2017-12-11,AEPS ACQUIRING ADJ FEES 0,,2017-12-11,65.26,,-546215154.3400007,.
409000438620',2017-12-11,AEPS ACQ REP ADJ FEES 081,,2017-12-11,,17.7,-546215136.6400007,.
409000438620',2017-12-11,Indiaforensic AEPS NPCI WDL SET,,2017-12-11,,48857863.0,-497357273.6400007,.
409000438620',2017-12-11,Indiaforensic AEPS NPCI WDL SET,,2017-12-11,,43841696.0,-453515577.6400007,.
409000438620',2017-12-11,Indiaforensic AEPS NPCI WDL SET,,2017-12-11,,30459280.0,-423056297.6400007,.
409000438620',2017-12-11,Indiaforensic AEPS NPCI DEP SET,,2017-12-11,33116852.0,,-456173149.6400007,.
409000438620',2017-12-11,Indiaforensic AEPS NPCI DEP SET,,2017-12-11,27469782.0,,-483642931.6400007,.
409000438620',2017-12-11,Indiaforensic AEPS NPCI DEP SET,,2017-12-11,24297435.0,,-507940366.6400007,.
409000438620',2017-12-12,TRF TO  Indiaforensic SERVICES I,,2017-12-12,15000000.0,,-522940366.6400007,.
409000438620',2017-12-12,TRF TO  Indiaforensic SERVICES I,,2017-12-12,15000000.0,,-537940366.6400007,.
409000438620',2017-12-12,TRF TO  Indiaforensic SERVICES I,,2017-12-12,8300000.0,,-546240366.6400007,.
409000438620',2017-12-12,AEPS Indiaforensic INCOME 081217,,2017-12-12,,201757.27,-546038609.3700007,.
409000438620',2017-12-12,AEPS Indiaforensic GST 081217,,2017-12-12,,36316.31,-546002293.0600008,.
409000438620',2017-12-12,AEPS Indiaforensic INCOME 091217,,2017-12-12,,178241.57,-545824051.4900007,.
409000438620',2017-12-12,AEPS Indiaforensic GST 091217,,2017-12-12,,32083.48,-545791968.0100007,.
409000438620',2017-12-12,AEPS Indiaforensic INCOME 101217,,2017-12-12,,136510.84,-545655457.1700007,.
409000438620',2017-12-12,AEPS Indiaforensic GST 101217,,2017-12-12,,24571.95,-545630885.2200006,.
409000438620',2017-12-12,AEPS ACQUIRING ADJ FEES 1,,2017-12-12,17.7,,-545630902.9200007,.
409000438620',2017-12-12,Indiaforensic AEPS NPCI WDL SET,,2017-12-12,,47055982.0,-498574920.9200007,.
409000438620',2017-12-12,Indiaforensic AEPS NPCI DEP SET,,2017-12-12,31845398.0,,-530420318.9200007,.
409000438620',2017-12-12,TRF TO  Indiaforensic SERVICES I,,2017-12-12,5000000.0,,-535420318.9200007,.
409000438620',2017-12-12,TRF TO  Indiaforensic SERVICES I,,2017-12-12,10000000.0,,-545420318.9200007,.
409000438620',2017-12-13,AEPS ACQUIRING ADJ FEES 1,,2017-12-13,56.05,,-545420374.9700006,.
409000438620',2017-12-13,AEPS ACQ REP ADJ FEES 121,,2017-12-13,,65.26,-545420309.7100006,.
409000438620',2017-12-13,AEPS Indiaforensic INCOME 111217,,2017-12-13,,195536.7,-545224773.0100006,.
409000438620',2017-12-13,AEPS Indiaforensic GST 111217,,2017-12-13,,35196.61,-545189576.4000006,.
409000438620',2017-12-13,AEPS Indiaforensic INCOME 121217,,2017-12-13,,196467.83,-544993108.5700005,.
409000438620',2017-12-13,AEPS Indiaforensic GST 121217,,2017-12-13,,35364.21,-544957744.3600005,.
409000438620',2017-12-13,Indiaforensic AEPS NPCI WDL SET,,2017-12-13,,46891414.0,-498066330.3600005,.
409000438620',2017-12-13,Indiaforensic AEPS NPCI DEP SET,,2017-12-13,32212219.0,,-530278549.3600005,.
409000438620',2017-12-14,TRF TO  Indiaforensic SERVICES I,,2017-12-14,10000000.0,,-540278549.3600005,.
409000438620',2017-12-14,TRF TO  Indiaforensic SERVICES I,,2017-12-14,5000000.0,,-545278549.3600005,.
409000438620',2017-12-14,AEPS ACQ REP ADJ FEES 131,,2017-12-14,,17.7,-545278531.6600004,.
409000438620',2017-12-15,AEPS ACQUIRING ADJ FEES 1,,2017-12-15,8.85,,-545278540.5100005,.
409000438620',2017-12-15,TRF TO  Indiaforensic SERVICES I,,2017-12-15,1000000.0,,-546278540.5100005,.
409000438620',2017-12-16,AEPS ACQUIRING ADJ FEES 1,,2017-12-16,29.5,,-546278570.0100005,.
409000438620',2017-12-16,Indiaforensic AEPS NPCI WDL SET,,2017-12-16,,45185132.0,-501093438.01000047,.
409000438620',2017-12-16,Indiaforensic AEPS NPCI DEP SET,,2017-12-16,32051239.0,,-533144677.01000047,.
409000438620',2017-12-16,Indiaforensic AEPS NPCI WDL SET,,2017-12-16,,42202206.0,-490942471.01000047,.
409000438620',2017-12-16,Indiaforensic AEPS NPCI DEP SET,,2017-12-16,29681718.0,,-520624189.01000047,.
409000438620',2017-12-16,Indiaforensic AEPS NPCI WDL SET,,2017-12-16,,46857240.0,-473766949.01000047,.
409000438620',2017-12-16,Indiaforensic AEPS NPCI DEP SET,,2017-12-16,32568629.0,,-506335578.01000047,.
409000438620',2017-12-18,TRF TO  Indiaforensic SERVICES I,,2017-12-18,4000000.0,,-510335578.01000047,.
409000438620',2017-12-18,TRF TO  Indiaforensic SERVICES I,,2017-12-18,10000000.0,,-520335578.01000047,.
409000438620',2017-12-18,TRF TO  Indiaforensic SERVICES I,,2017-12-18,10000000.0,,-530335578.01000047,.
409000438620',2017-12-18,TRF TO  Indiaforensic SERVICES I,,2017-12-18,15000000.0,,-545335578.0100005,.
409000438620',2017-12-18,AEPS Indiaforensic INCOME 131217,,2017-12-18,,189169.64,-545146408.3700005,.
409000438620',2017-12-18,AEPS Indiaforensic GST 131217,,2017-12-18,,34050.54,-545112357.8300005,.
409000438620',2017-12-18,AEPS Indiaforensic INCOME 141217,,2017-12-18,,175384.33,-544936973.5000005,.
409000438620',2017-12-18,AEPS Indiaforensic GST 141217,,2017-12-18,,31569.18,-544905404.3200005,.
409000438620',2017-12-18,AEPS Indiaforensic INCOME 151217,,2017-12-18,,191174.74,-544714229.5800005,.
409000438620',2017-12-18,AEPS Indiaforensic GST 151217,,2017-12-18,,34411.45,-544679818.1300005,.
409000438620',2017-12-18,AEPS ACQUIRING ADJ FEES 1,,2017-12-18,9.03,,-544679827.1600004,.
409000438620',2017-12-18,AEPS ACQ REP ADJ FEES 161,,2017-12-18,,20.65,-544679806.5100005,.
409000438620',2017-12-18,Indiaforensic AEPS NPCI WDL SET,,2017-12-18,,37659354.0,-507020452.51000047,.
409000438620',2017-12-18,Indiaforensic AEPS NPCI WDL SET,,2017-12-18,,32184436.0,-474836016.51000047,.
409000438620',2017-12-18,Indiaforensic AEPS NPCI DEP SET,,2017-12-18,28400981.0,,-503236997.51000047,.
409000438620',2017-12-18,Indiaforensic AEPS NPCI DEP SET,,2017-12-18,24342569.0,,-527579566.51000047,.
409000438620',2017-12-19,TRF TO  Indiaforensic SERVICES I,,2017-12-19,15000000.0,,-542579566.5100005,.
409000438620',2017-12-19,TRF TO  Indiaforensic SERVICES I,,2017-12-19,2000000.0,,-544579566.5100005,.
409000438620',2017-12-19,TRF TO  Indiaforensic SERVICES I,,2017-12-19,500000.0,,-545079566.5100005,.
409000438620',2017-12-19,Indiaforensic AEPS NPCI WDL SET,,2017-12-19,,44129420.0,-500950146.51000047,.
409000438620',2017-12-19,AEPS ACQUIRING ADJ FEES 1,,2017-12-19,289.1,,-500950435.6100005,.
409000438620',2017-12-19,AEPS ACQ REP ADJ FEES 181,,2017-12-19,,47.38,-500950388.2300005,.
409000438620',2017-12-19,AEPS Indiaforensic INCOME 161217,,2017-12-19,,163475.05,-500786913.1800005,.
409000438620',2017-12-19,AEPS Indiaforensic GST 161217,,2017-12-19,,29425.51,-500757487.6700005,.
409000438620',2017-12-19,AEPS Indiaforensic INCOME 171217,,2017-12-19,,141140.8,-500616346.8700005,.
409000438620',2017-12-19,AEPS Indiaforensic GST 171217,,2017-12-19,,25405.34,-500590941.5300005,.
409000438620',2017-12-19,AEPS Indiaforensic INCOME 181217,,2017-12-19,,183661.85,-500407279.6800005,.
409000438620',2017-12-19,AEPS Indiaforensic GST 181217,,2017-12-19,,33059.13,-500374220.5500005,.
409000438620',2017-12-19,Indiaforensic AEPS NPCI DEP SET,,2017-12-19,29688492.0,,-530062712.5500005,.
409000438620',2017-12-19,TRF TO  Indiaforensic SERVICES I,,2017-12-19,1200000.0,,-531262712.5500005,.
409000438620',2017-12-19,TRF TO  Indiaforensic SERVICES I,,2017-12-19,15000000.0,,-546262712.5500004,.
409000438620',2017-12-20,Indiaforensic AEPS NPCI WDL SET,,2017-12-20,,46691183.0,-499571529.5500004,.
409000438620',2017-12-20,Indiaforensic AEPS NPCI DEP SET,,2017-12-20,35410792.0,,-534982321.5500004,.
409000438620',2017-12-20,AEPS ACQUIRING ADJ FEES 1,,2017-12-20,88.5,,-534982410.0500004,.
409000438620',2017-12-20,AEPS ACQ REP ADJ FEES 191,,2017-12-20,,47.2,-534982362.85000044,.
409000438620',2017-12-20,TRF TO  Indiaforensic SERVICES I,,2017-12-20,11300000.0,,-546282362.8500004,.
409000438620',2017-12-21,Indiaforensic AEPS NPCI WDL SET,,2017-12-21,,36917590.0,-509364772.8500004,.
409000438620',2017-12-21,Indiaforensic AEPS NPCI DEP SET,,2017-12-21,28326631.0,,-537691403.8500004,.
409000438620',2017-12-21,TRF TO  Indiaforensic SERVICES I,,2017-12-21,4000000.0,,-541691403.8500004,.
409000438620',2017-12-21,TRF TO  Indiaforensic SERVICES I,,2017-12-21,4000000.0,,-545691403.8500004,.
409000438620',2017-12-21,TRF TO  Indiaforensic SERVICES I,,2017-12-21,500000.0,,-546191403.8500004,.
409000438620',2017-12-21,AEPS ACQUIRING ADJ FEES 2,,2017-12-21,53.1,,-546191456.9500004,.
409000438620',2017-12-21,AEPS ACQ REP ADJ FEES 201,,2017-12-21,,17.7,-546191439.2500004,.
409000438620',2017-12-21,AEPS Indiaforensic INCOME 201217,,2017-12-21,,162446.28,-546028992.9700004,.
409000438620',2017-12-21,AEPS Indiaforensic GST 201217,,2017-12-21,,29240.33,-545999752.6400003,.
409000438620',2017-12-22,AEPS ACQ REP ADJ FEES 211,,2017-12-22,,106.2,-545999646.4400003,.
409000438620',2017-12-22,Indiaforensic AEPS NPCI WDL SET,,2017-12-22,,44254870.0,-501744776.4400003,.
409000438620',2017-12-22,Indiaforensic AEPS NPCI DEP SET,,2017-12-22,30988332.0,,-532733108.4400003,.
409000438620',2017-12-22,TRF TO  Indiaforensic SERVICES I,,2017-12-22,10000000.0,,-542733108.4400003,.
409000438620',2017-12-22,TRF TO  Indiaforensic SERVICES I,,2017-12-22,500000.0,,-543233108.4400003,.
409000438620',2017-12-22,TRF TO  Indiaforensic SERVICES I,,2017-12-22,3000000.0,,-546233108.4400003,.
409000438620',2017-12-22,AEPS Indiaforensic INCOME 211217,,2017-12-22,,187437.22,-546045671.2200003,.
409000438620',2017-12-22,AEPS Indiaforensic GST 211217,,2017-12-22,,33738.7,-546011932.5200002,.
409000438620',2017-12-22,AEPS Indiaforensic INCOME 191217,,2017-12-22,,202027.39,-545809905.1300002,.
409000438620',2017-12-22,AEPS Indiaforensic GST 191217,,2017-12-22,,36364.93,-545773540.2000003,.
409000438620',2017-12-26,Indiaforensic AEPS NPCI WDL SET,,2017-12-26,,46928719.0,-498844821.2000003,.
409000438620',2017-12-26,Indiaforensic AEPS NPCI WDL SET,,2017-12-26,,45065270.0,-453779551.2000003,.
409000438620',2017-12-26,Indiaforensic AEPS NPCI WDL SET,,2017-12-26,,26893194.0,-426886357.2000003,.
409000438620',2017-12-26,Indiaforensic AEPS NPCI WDL SET,,2017-12-26,,31164048.0,-395722309.2000003,.
409000438620',2017-12-26,Indiaforensic AEPS NPCI DEP SET,,2017-12-26,33857888.0,,-429580197.2000003,.
409000438620',2017-12-26,Indiaforensic AEPS NPCI DEP SET,,2017-12-26,33383700.0,,-462963897.2000003,.
409000438620',2017-12-26,Indiaforensic AEPS NPCI DEP SET,,2017-12-26,23792118.0,,-486756015.2000003,.
409000438620',2017-12-26,Indiaforensic AEPS NPCI DEP SET,,2017-12-26,26464321.0,,-513220336.2000003,.
409000438620',2017-12-26,TRF TO  Indiaforensic SERVICES I,,2017-12-26,3000000.0,,-516220336.2000003,.
409000438620',2017-12-26,TRF TO  Indiaforensic SERVICES I,,2017-12-26,10000000.0,,-526220336.2000003,.
409000438620',2017-12-26,TRF TO  Indiaforensic SERVICES I,,2017-12-26,10000000.0,,-536220336.2000003,.
409000438620',2017-12-26,TRF TO  Indiaforensic SERVICES I,,2017-12-26,10000000.0,,-546220336.2000003,.
409000438620',2017-12-27,AEPS ACQ REP ADJ FEES 261,,2017-12-27,,35.4,-546220300.8000003,.
409000438620',2017-12-27,AEPS Indiaforensic INCOME 261217,,2017-12-27,,182167.47,-546038133.3300003,.
409000438620',2017-12-27,AEPS Indiaforensic GST 261217,,2017-12-27,,32790.14,-546005343.1900003,.
409000438620',2017-12-27,Indiaforensic AEPS NPCI WDL SET,,2017-12-27,,42040430.0,-503964913.1900003,.
409000438620',2017-12-27,Indiaforensic AEPS NPCI DEP SET,,2017-12-27,32005759.0,,-535970672.1900003,.
409000438620',2017-12-27,TRF TO  Indiaforensic SERVICES I,,2017-12-27,10300000.0,,-546270672.1900003,.
409000438620',2017-12-27,AEPS Indiaforensic INCOME 221217,,2017-12-27,,199295.67,-546071376.5200003,.
409000438620',2017-12-27,AEPS Indiaforensic GST 221217,,2017-12-27,,35873.22,-546035503.3000003,.
409000438620',2017-12-27,AEPS Indiaforensic INCOME 231217,,2017-12-27,,194107.56,-545841395.7400004,.
409000438620',2017-12-27,AEPS Indiaforensic GST 231217,,2017-12-27,,34939.36,-545806456.3800004,.
409000438620',2017-12-27,AEPS Indiaforensic INCOME 241217,,2017-12-27,,126825.92,-545679630.4600004,.
409000438620',2017-12-27,AEPS Indiaforensic GST 241217,,2017-12-27,,22828.67,-545656801.7900004,.
409000438620',2017-12-27,AEPS Indiaforensic INCOME 251217,,2017-12-27,,145594.01,-545511207.7800004,.
409000438620',2017-12-27,AEPS Indiaforensic GST 251217,,2017-12-27,,26206.92,-545485000.8600005,.
409000438620',2017-12-28,Indiaforensic AEPS NPCI WDL SET,,2017-12-28,,41423300.0,-504061700.8600005,.
409000438620',2017-12-28,Indiaforensic AEPS NPCI DEP SET,,2017-12-28,31437948.0,,-535499648.8600005,.
409000438620',2017-12-28,AEPS Indiaforensic INCOME 271217,,2017-12-28,,178518.46,-535321130.4000005,.
409000438620',2017-12-28,AEPS Indiaforensic GST 271217,,2017-12-28,,32133.32,-535288997.0800005,.
409000438620',2017-12-28,AEPS ACQUIRING ADJ FEES 2,,2017-12-28,41.3,,-535289038.38000053,.
409000438620',2017-12-28,AEPS ACQ CR ADJ FEES 2712,,2017-12-28,1508.06,,-535290546.44000053,.
409000438620',2017-12-28,CR733911736401/RMCPL18497/0,,2017-12-28,2000.0,,-535292546.44000053,.
409000438620',2017-12-28,CR733912808732/RMCPL11131/0,,2017-12-28,2000.0,,-535294546.44000053,.
409000438620',2017-12-28,CR733912808742/RMCPL14730/0,,2017-12-28,1500.0,,-535296046.44000053,.
409000438620',2017-12-28,CR733912808763/RMCPL18497/0,,2017-12-28,1000.0,,-535297046.44000053,.
409000438620',2017-12-28,CR733913885824/RMCPL10067/0,,2017-12-28,500.0,,-535297546.44000053,.
409000438620',2017-12-28,CR734111193620/RMCPL12959/0,,2017-12-28,3000.0,,-535300546.44000053,.
409000438620',2017-12-28,CR734111193653/RMCPL16126/0,,2017-12-28,1500.0,,-535302046.44000053,.
409000438620',2017-12-28,CR734111193701/RMCPL16100/0,,2017-12-28,1000.0,,-535303046.44000053,.
409000438620',2017-12-28,CR734111193728/RMCPL18457/0,,2017-12-28,6500.0,,-535309546.44000053,.
409000438620',2017-12-28,CR734109068544/RMCPL15716/0,,2017-12-28,500.0,,-535310046.44000053,.
409000438620',2017-12-28,CR734113343166/RMCPL15740/0,,2017-12-28,500.0,,-535310546.44000053,.
409000438620',2017-12-28,CR734113343208/RMCPL19980/0,,2017-12-28,2000.0,,-535312546.44000053,.
409000438620',2017-12-28,CR734113343213/RMCPL15014/0,,2017-12-28,1500.0,,-535314046.44000053,.
409000438620',2017-12-28,AEPS ACQ REP ADJ FEES 271,,2017-12-28,,135.7,-535313910.74000055,.
409000438620',2017-12-28,CR734113343269/RMCPL21644/0,,2017-12-28,5000.0,,-535318910.74000055,.
409000438620',2017-12-28,CR734210341667/RMCPL19241/0,,2017-12-28,8000.0,,-535326910.74000055,.
409000438620',2017-12-28,CR734217826611/RMCPL10108/0,,2017-12-28,500.0,,-535327410.74000055,.
409000438620',2017-12-28,CR734217826785/RMCPL18984/0,,2017-12-28,5000.0,,-535332410.74000055,.
409000438620',2017-12-28,CR734217826439/RMCPL16746/0,,2017-12-28,500.0,,-535332910.74000055,.
409000438620',2017-12-28,CR734217824082/RMCPL11699/0,,2017-12-28,5000.0,,-535337910.74000055,.
409000438620',2017-12-28,CR734210297958/RMCPL17155/0,,2017-12-28,500.0,,-535338410.74000055,.
409000438620',2017-12-28,CR734217827256/RMCPL11139/0,,2017-12-28,1500.0,,-535339910.74000055,.
409000438620',2017-12-28,CR734613512079/RMCPL15755/1,,2017-12-28,500.0,,-535340410.74000055,.
409000438620',2017-12-28,CR734613512389/RMCPL17307/1,,2017-12-28,2000.0,,-535342410.74000055,.
409000438620',2017-12-28,CR734613511868/RMCPL20307/1,,2017-12-28,3000.0,,-535345410.74000055,.
409000438620',2017-12-28,CR734613512179/RMCPL14558/1,,2017-12-28,5000.0,,-535350410.74000055,.
409000438620',2017-12-28,CR734613511942/RMCPL18804/1,,2017-12-28,1000.0,,-535351410.74000055,.
409000438620',2017-12-28,CR734613512229/RMCPL19744/1,,2017-12-28,2500.0,,-535353910.74000055,.
409000438620',2017-12-28,CR734613511952/RMCPL20091/1,,2017-12-28,3000.0,,-535356910.74000055,.
409000438620',2017-12-28,CR734613512044/RMCPL18712/1,,2017-12-28,10000.0,,-535366910.74000055,.
409000438620',2017-12-28,CR734613512327/RMCPL17505/1,,2017-12-28,6000.0,,-535372910.74000055,.
409000438620',2017-12-28,CR734613512052/RMCPL17405/1,,2017-12-28,2500.0,,-535375410.74000055,.
409000438620',2017-12-28,CR734510327969/RMCPL13078/1,,2017-12-28,100.0,,-535375510.74000055,.
409000438620',2017-12-28,CR734510329552/RMCPL16761/1,,2017-12-28,7000.0,,-535382510.74000055,.
409000438620',2017-12-28,CR734510325571/RMCPL13947/1,,2017-12-28,4000.0,,-535386510.74000055,.
409000438620',2017-12-28,CR734510326643/RMCPL17553/1,,2017-12-28,2000.0,,-535388510.74000055,.
409000438620',2017-12-28,CR734511410872/RMCPL16366/1,,2017-12-28,4000.0,,-535392510.74000055,.
409000438620',2017-12-28,CR734512439605/RMCPL15403/1,,2017-12-28,1000.0,,-535393510.74000055,.
409000438620',2017-12-28,CR734512439568/RMCPL20241/1,,2017-12-28,2500.0,,-535396010.74000055,.
409000438620',2017-12-28,CR734512444486/RMCPL20088/1,,2017-12-28,1000.0,,-535397010.74000055,.
409000438620',2017-12-28,CR734512444055/RMCPL20594/1,,2017-12-28,1500.0,,-535398510.74000055,.
409000438620',2017-12-28,CR734512444085/RMCPL13294/1,,2017-12-28,2500.0,,-535401010.74000055,.
409000438620',2017-12-28,CR734510326470/RMCPL20534/1,,2017-12-28,1000.0,,-535402010.74000055,.
409000438620',2017-12-28,CR734510325332/RMCPL10073/1,,2017-12-28,5200.0,,-535407210.74000055,.
409000438620',2017-12-28,CR734510329930/RMCPL18708/1,,2017-12-28,1000.0,,-535408210.74000055,.
409000438620',2017-12-28,CR734512444380/RMCPL13336/1,,2017-12-28,500.0,,-535408710.74000055,.
409000438620',2017-12-28,CR734512444205/RMCPL16877/1,,2017-12-28,500.0,,-535409210.74000055,.
409000438620',2017-12-28,CR734512447550/RMCPL18940/1,,2017-12-28,500.0,,-535409710.74000055,.
409000438620',2017-12-28,CR734510330084/RMCPL11873/1,,2017-12-28,5000.0,,-535414710.74000055,.
409000438620',2017-12-28,CR734512444387/RMCPL17453/1,,2017-12-28,1000.0,,-535415710.74000055,.
409000438620',2017-12-28,CR734511410860/RMCPL16112/1,,2017-12-28,1400.0,,-535417110.74000055,.
409000438620',2017-12-28,CR734512447519/RMCPL20760/1,,2017-12-28,1000.0,,-535418110.74000055,.
409000438620',2017-12-28,CR734510331816/RMCPL11748/1,,2017-12-28,1500.0,,-535419610.74000055,.
409000438620',2017-12-28,CR734512441184/RMCPL18898/1,,2017-12-28,1500.0,,-535421110.74000055,.
409000438620',2017-12-28,CR734512440720/RMCPL21953/1,,2017-12-28,1000.0,,-535422110.74000055,.
409000438620',2017-12-28,CR734510326344/RMCPL17511/1,,2017-12-28,500.0,,-535422610.74000055,.
409000438620',2017-12-28,CR734512447697/RMCPL18408/1,,2017-12-28,6500.0,,-535429110.74000055,.
409000438620',2017-12-28,CR734512447845/RMCPL17438/1,,2017-12-28,500.0,,-535429610.74000055,.
409000438620',2017-12-28,CR734512447851/RMCPL19871/1,,2017-12-28,3000.0,,-535432610.74000055,.
409000438620',2017-12-28,CR734512444310/RMCPL20587/1,,2017-12-28,7000.0,,-535439610.74000055,.
409000438620',2017-12-28,CR734510333151/RMCPL20251/1,,2017-12-28,500.0,,-535440110.74000055,.
409000438620',2017-12-28,CR734510332187/RMCPL21434/1,,2017-12-28,2500.0,,-535442610.74000055,.
409000438620',2017-12-28,CR734510333199/RMCPL15983/1,,2017-12-28,3000.0,,-535445610.74000055,.
409000438620',2017-12-28,CR734510326072/RMCPL15030/1,,2017-12-28,500.0,,-535446110.74000055,.
409000438620',2017-12-28,CR734510333021/RMCPL14916/1,,2017-12-28,2500.0,,-535448610.74000055,.
409000438620',2017-12-28,CR734512444338/RMCPL19966/1,,2017-12-28,10000.0,,-535458610.74000055,.
409000438620',2017-12-28,CR734512447656/RMCPL12896/1,,2017-12-28,1000.0,,-535459610.74000055,.
409000438620',2017-12-28,CR734512439433/RMCPL10725/1,,2017-12-28,10000.0,,-535469610.74000055,.
409000438620',2017-12-28,CR734512444056/RMCPL20534/1,,2017-12-28,5500.0,,-535475110.74000055,.
409000438620',2017-12-28,CR734512447539/RMCPL16975/1,,2017-12-28,2000.0,,-535477110.74000055,.
409000438620',2017-12-28,CR734517792834/RMCPL16735/1,,2017-12-28,3000.0,,-535480110.74000055,.
409000438620',2017-12-28,CR734512447521/RMCPL19012/1,,2017-12-28,1000.0,,-535481110.74000055,.
409000438620',2017-12-28,CR734512444419/RMCPL19639/1,,2017-12-28,1000.0,,-535482110.74000055,.
409000438620',2017-12-28,CR734510329315/RMCPL15697/1,,2017-12-28,500.0,,-535482610.74000055,.
409000438620',2017-12-28,CR734510332146/RMCPL14340/1,,2017-12-28,500.0,,-535483110.74000055,.
409000438620',2017-12-28,CR734510334140/RMCPL21477/1,,2017-12-28,500.0,,-535483610.74000055,.
409000438620',2017-12-28,CR734510331834/RMCPL15447/1,,2017-12-28,1000.0,,-535484610.74000055,.
409000438620',2017-12-28,CR734510329566/RMCPL15490/1,,2017-12-28,10000.0,,-535494610.74000055,.
409000438620',2017-12-28,CR734510326460/RMCPL15725/1,,2017-12-28,2500.0,,-535497110.74000055,.
409000438620',2017-12-28,CR734512439723/RMCPL18408/1,,2017-12-28,3000.0,,-535500110.74000055,.
409000438620',2017-12-28,CR734510330710/RMCPL15914/1,,2017-12-28,4000.0,,-535504110.74000055,.
409000438620',2017-12-28,CR734510331402/RMCPL19124/1,,2017-12-28,2000.0,,-535506110.74000055,.
409000438620',2017-12-28,CR734510332611/RMCPL20239/1,,2017-12-28,2000.0,,-535508110.74000055,.
409000438620',2017-12-28,CR734510329232/RMCPL11680/1,,2017-12-28,10000.0,,-535518110.74000055,.
409000438620',2017-12-28,CR734510330143/RMCPL13947/1,,2017-12-28,4000.0,,-535522110.74000055,.
409000438620',2017-12-28,CR734512444193/RMCPL17261/1,,2017-12-28,3000.0,,-535525110.74000055,.
409000438620',2017-12-28,CR734512447752/RMCPL21463/1,,2017-12-28,4000.0,,-535529110.74000055,.
409000438620',2017-12-28,CR734512439602/RMCPL13756/1,,2017-12-28,2500.0,,-535531610.74000055,.
409000438620',2017-12-28,CR734512444031/RMCPL12450/1,,2017-12-28,10000.0,,-535541610.74000055,.
409000438620',2017-12-28,CR734816594422/RMCPL13616/1,,2017-12-28,1500.0,,-535543110.74000055,.
409000438620',2017-12-28,CR734816594258/RMCPL17350/1,,2017-12-28,1500.0,,-535544610.74000055,.
409000438620',2017-12-28,CR734816594199/RMCPL19812/1,,2017-12-28,1000.0,,-535545610.74000055,.
409000438620',2017-12-28,CR734816594204/RMCPL00045/1,,2017-12-28,5000.0,,-535550610.74000055,.
409000438620',2017-12-28,CR734816594245/RMCPL20061/1,,2017-12-28,1000.0,,-535551610.74000055,.
409000438620',2017-12-28,CR734714559958/RMCPL15921/1,,2017-12-28,1000.0,,-535552610.74000055,.
409000438620',2017-12-28,CR735212649781/RMCPL21584/1,,2017-12-28,500.0,,-535553110.74000055,.
409000438620',2017-12-28,CR735211589121/RMCPL18382/1,,2017-12-28,1000.0,,-535554110.74000055,.
409000438620',2017-12-28,CR735212649809/RMCPL20295/1,,2017-12-28,500.0,,-535554610.74000055,.
409000438620',2017-12-28,CR735212649776/RMCPL20317/1,,2017-12-28,2500.0,,-535557110.74000055,.
409000438620',2017-12-28,CR735212649796/RMCPL13927/1,,2017-12-28,2500.0,,-535559610.74000055,.
409000438620',2017-12-28,CR735212649766/RMCPL18859/1,,2017-12-28,500.0,,-535560110.74000055,.
409000438620',2017-12-28,CR735212649803/RMCPL00152/1,,2017-12-28,1500.0,,-535561610.74000055,.
409000438620',2017-12-28,CR735012065648/RMCPL16831/1,,2017-12-28,4000.0,,-535565610.74000055,.
409000438620',2017-12-28,CR735017271339/RMCPL21378/1,,2017-12-28,3000.0,,-535568610.74000055,.
409000438620',2017-12-28,CR735014119631/RMCPL18460/1,,2017-12-28,500.0,,-535569110.74000055,.
409000438620',2017-12-28,CR735012055077/RMCPL17184/1,,2017-12-28,5000.0,,-535574110.74000055,.
409000438620',2017-12-28,CR735017271162/RMCPL14939/1,,2017-12-28,150.0,,-535574260.74000055,.
409000438620',2017-12-28,CR735012055204/RMCPL18215/1,,2017-12-28,1500.0,,-535575760.74000055,.
409000438620',2017-12-28,CR735017271026/RMCPL11699/1,,2017-12-28,1000.0,,-535576760.74000055,.
409000438620',2017-12-28,CR735017271027/RMCPL15393/1,,2017-12-28,1522.0,,-535578282.74000055,.
409000438620',2017-12-28,CR735012055283/RMCPL17909/1,,2017-12-28,5000.0,,-535583282.74000055,.
409000438620',2017-12-28,CR735017271122/RMCPL16399/1,,2017-12-28,1000.0,,-535584282.74000055,.
409000438620',2017-12-28,CR735017271192/RMCPL19216/1,,2017-12-28,1000.0,,-535585282.74000055,.
409000438620',2017-12-28,CR735014119419/RMCPL22028/1,,2017-12-28,3000.0,,-535588282.74000055,.
409000438620',2017-12-28,CR735012065716/RMCPL20541/1,,2017-12-28,5000.0,,-535593282.74000055,.
409000438620',2017-12-28,CR735017271397/RMCPL17049/1,,2017-12-28,400.0,,-535593682.74000055,.
409000438620',2017-12-28,CR735012055016/RMCPL11246/1,,2017-12-28,4000.0,,-535597682.74000055,.
409000438620',2017-12-28,CR735012065681/RMCPL21333/1,,2017-12-28,1000.0,,-535598682.74000055,.
409000438620',2017-12-28,CR735012054791/RMCPL08013/1,,2017-12-28,500.0,,-535599182.74000055,.
409000438620',2017-12-28,CR735014140949/RMCPL18625/1,,2017-12-28,500.0,,-535599682.74000055,.
409000438620',2017-12-28,CR735012065710/RMCPL20319/1,,2017-12-28,10000.0,,-535609682.74000055,.
409000438620',2017-12-28,CR735014119514/RMCPL14017/1,,2017-12-28,3000.0,,-535612682.74000055,.
409000438620',2017-12-28,CR735014119560/RMCPL17086/1,,2017-12-28,3500.0,,-535616182.74000055,.
409000438620',2017-12-28,CR735012055224/RMCPL16856/1,,2017-12-28,1500.0,,-535617682.74000055,.
409000438620',2017-12-28,CR735012055139/RMCPL10425/1,,2017-12-28,2000.0,,-535619682.74000055,.
409000438620',2017-12-28,CR735014140963/RMCPL16946/1,,2017-12-28,1000.0,,-535620682.74000055,.
409000438620',2017-12-28,CR735017271287/RMCPL18367/1,,2017-12-28,1000.0,,-535621682.74000055,.
409000438620',2017-12-28,CR735017270907/RMCPL17641/1,,2017-12-28,500.0,,-535622182.74000055,.
409000438620',2017-12-28,CR735012055157/RMCPL16781/1,,2017-12-28,1000.0,,-535623182.74000055,.
409000438620',2017-12-28,CR735014140986/RMCPL11736/1,,2017-12-28,3000.0,,-535626182.74000055,.
409000438620',2017-12-28,CR735017270948/RMCPL20542/1,,2017-12-28,10000.0,,-535636182.74000055,.
409000438620',2017-12-28,CR735017311334/RMCPL16671/1,,2017-12-28,5000.0,,-535641182.74000055,.
409000438620',2017-12-28,CR735012055266/RMCPL20090/1,,2017-12-28,2020.0,,-535643202.74000055,.
409000438620',2017-12-28,CR735012055098/RMCPL20093/1,,2017-12-28,5000.0,,-535648202.74000055,.
409000438620',2017-12-28,CR735014119589/RMCPL20516/1,,2017-12-28,1010.0,,-535649212.74000055,.
409000438620',2017-12-28,CR735014141702/RMCPL16674/1,,2017-12-28,1500.0,,-535650712.74000055,.
409000438620',2017-12-28,CR735012054880/RMCPL16516/1,,2017-12-28,8000.0,,-535658712.74000055,.
409000438620',2017-12-28,CR735315670177/RMCPL16185/1,,2017-12-28,500.0,,-535659212.74000055,.
409000438620',2017-12-28,CR734009809624/RMCPL18122/0,,2017-12-28,2000.0,,-535661212.74000055,.
409000438620',2017-12-28,CR734009809639/RMCPL13871/0,,2017-12-28,6000.0,,-535667212.74000055,.
409000438620',2017-12-28,TRF TO  Indiaforensic SERVICES I,,2017-12-28,10000000.0,,-545667212.7400005,.
409000438620',2017-12-28,TRF TO  Indiaforensic SERVICES I,,2017-12-28,500000.0,,-546167212.7400005,.
409000438620',2017-12-29,Indiaforensic AEPS NPCI WDL SET,,2017-12-29,,47877493.0,-498289719.7400005,.
409000438620',2017-12-29,Indiaforensic AEPS NPCI DEP SET,,2017-12-29,37808535.0,,-536098254.7400005,.
409000438620',2017-12-29,AEPS Indiaforensic INCOME 281217,,2017-12-29,,205529.51,-535892725.2300005,.
409000438620',2017-12-29,AEPS Indiaforensic GST 281217,,2017-12-29,,36995.31,-535855729.9200005,.
409000438620',2017-12-29,TRF TO  Indiaforensic SERVICES I,,2017-12-29,10000000.0,,-545855729.9200006,.
409000438620',2017-12-30,AEPS ACQUIRING ADJ FEES 2,,2017-12-30,59.0,,-545855788.9200006,.
409000438620',2017-12-30,AEPS ACQ REP ADJ FEES 291,,2017-12-30,,41.3,-545855747.6200006,.
409000438620',2017-12-30,AEPS Indiaforensic INCOME 291217,,2017-12-30,,193201.14,-545662546.4800006,.
409000438620',2017-12-30,AEPS Indiaforensic GST 291217,,2017-12-30,,34776.21,-545627770.2700006,.
409000438620',2017-12-30,Indiaforensic AEPS NPCI WDL SET,,2017-12-30,,45612373.0,-500015397.2700006,.
409000438620',2017-12-30,Indiaforensic AEPS NPCI DEP SET,,2017-12-30,34405148.0,,-534420545.2700006,.
409000438620',2017-12-30,TRF TO  Indiaforensic SERVICES I,,2017-12-30,500000.0,,-534920545.2700006,.
409000438620',2017-12-30,TRF TO  Indiaforensic SERVICES I,,2017-12-30,10000000.0,,-544920545.2700006,.
409000438620',2017-12-30,TRF TO  Indiaforensic SERVICES I,,2017-12-30,1000000.0,,-545920545.2700006,.
409000438620',2017-12-30,AEPS ACQUIRING ADJ FEES 2,,2017-12-30,234.23,,-545920779.5000006,.
409000438620',2017-12-30,AEPS ACQ REP ADJ FEES 221,,2017-12-30,,106.2,-545920673.3000005,.
409000438620',2018-01-01,AEPS Indiaforensic INCOME 301217,,2018-01-01,,187027.63,-545733645.6700006,.
409000438620',2018-01-01,AEPS Indiaforensic GST 301217,,2018-01-01,,33664.97,-545699980.7000005,.
409000438620',2018-01-01,AEPS Indiaforensic INCOME 311217,,2018-01-01,,133543.25,-545566437.4500005,.
409000438620',2018-01-01,AEPS Indiaforensic GST 311217,,2018-01-01,,24037.78,-545542399.6700006,.
409000438620',2018-01-01,Indiaforensic AEPS NPCI WDL SET,,2018-01-01,,42220056.0,-503322343.67000055,.
409000438620',2018-01-01,Indiaforensic AEPS NPCI WDL SET,,2018-01-01,,28842441.0,-474479902.67000055,.
409000438620',2018-01-01,Indiaforensic AEPS NPCI DEP SET,,2018-01-01,34748966.0,,-509228868.67000055,.
409000438620',2018-01-01,Indiaforensic AEPS NPCI DEP SET,,2018-01-01,24426693.0,,-533655561.67000055,.
409000438620',2018-01-01,TRF TO  Indiaforensic SERVICES I,,2018-01-01,2000000.0,,-535655561.67000055,.
409000438620',2018-01-01,TRF TO  Indiaforensic SERVICES I,,2018-01-01,10000000.0,,-545655561.6700006,.
409000438620',2018-01-01,TRF TO  Indiaforensic SERVICES I,,2018-01-01,500000.0,,-546155561.6700006,.
409000438620',2018-01-02,AEPS Indiaforensic INCOME 010118,,2018-01-02,,119542.23,-546036019.4400005,.
409000438620',2018-01-02,AEPS Indiaforensic GST 010118,,2018-01-02,,21517.6,-546014501.8400005,.
409000438620',2018-01-02,Indiaforensic AEPS NPCI WDL SET,,2018-01-02,,26281758.0,-519732743.8400005,.
409000438620',2018-01-02,Indiaforensic AEPS NPCI DEP SET,,2018-01-02,21898671.0,,-541631414.8400005,.
409000438620',2018-01-02,TRF TO  Indiaforensic SERVICES I,,2018-01-02,4600000.0,,-546231414.8400005,.
409000438620',2018-01-03,AEPS Indiaforensic INCOME 020118,,2018-01-03,,190555.73,-546040859.1100005,.
409000438620',2018-01-03,AEPS Indiaforensic GST 020118,,2018-01-03,,34300.03,-546006559.0800005,.
409000438620',2018-01-03,Indiaforensic AEPS NPCI WDL SET,,2018-01-03,,45304997.0,-500701562.0800005,.
409000438620',2018-01-03,AEPS ACQUIRING ADJ FEES 0,,2018-01-03,88.5,,-500701650.5800005,.
409000438620',2018-01-03,AEPS ACQ REP ADJ FEES 020,,2018-01-03,,59.0,-500701591.5800005,.
409000438620',2018-01-03,Indiaforensic AEPS NPCI DEP SET,,2018-01-03,32022619.0,,-532724210.5800005,.
409000438620',2018-01-03,TRF TO  Indiaforensic SERVICES I,,2018-01-03,13500000.0,,-546224210.5800005,.
409000438620',2018-01-04,Indiaforensic AEPS NPCI WDL SET,,2018-01-04,,46421066.0,-499803144.5800005,.
409000438620',2018-01-04,AEPS ACQUIRING ADJ FEES 0,,2018-01-04,17.7,,-499803162.2800005,.
409000438620',2018-01-04,AEPS Indiaforensic INCOME 030118,,2018-01-04,,203728.77,-499599433.5100005,.
409000438620',2018-01-04,AEPS Indiaforensic GST 030118,,2018-01-04,,36671.18,-499562762.3300005,.
409000438620',2018-01-04,Indiaforensic AEPS NPCI DEP SET,,2018-01-04,37896427.0,,-537459189.3300005,.
409000438620',2018-01-04,TRF TO  Indiaforensic SERVICES I,,2018-01-04,8800000.0,,-546259189.3300005,.
409000438620',2018-01-05,Indiaforensic AEPS NPCI WDL SET,,2018-01-05,,44256042.0,-502003147.3300005,.
409000438620',2018-01-05,Indiaforensic AEPS NPCI DEP SET,,2018-01-05,37693730.0,,-539696877.3300005,.
409000438620',2018-01-05,AEPS ACQ REP ADJ FEES 040,,2018-01-05,,88.5,-539696788.8300005,.
409000438620',2018-01-05,AEPS Indiaforensic INCOME 040118,,2018-01-05,,199872.24,-539496916.5900005,.
409000438620',2018-01-05,AEPS Indiaforensic GST 040118,,2018-01-05,,35977.0,-539460939.5900005,.
409000438620',2018-01-05,TRF TO  Indiaforensic SERVICES I,,2018-01-05,3000000.0,,-542460939.5900005,.
409000438620',2018-01-05,TRF TO  Indiaforensic SERVICES I,,2018-01-05,3000000.0,,-545460939.5900005,.
409000438620',2018-01-06,Indiaforensic AEPS NPCI WDL SET,,2018-01-06,,44583319.0,-500877620.5900005,.
409000438620',2018-01-06,AEPS ACQUIRING ADJ FEES 0,,2018-01-06,56.05,,-500877676.6400005,.
409000438620',2018-01-06,Indiaforensic AEPS NPCI DEP SET,,2018-01-06,35784266.0,,-536661942.6400005,.
409000438620',2018-01-06,AEPS Indiaforensic INCOME 050118,,2018-01-06,,198695.99,-536463246.6500005,.
409000438620',2018-01-06,AEPS Indiaforensic GST 050118,,2018-01-06,,35765.28,-536427481.37000054,.
409000438620',2018-01-06,TRF TO  Indiaforensic SERVICES I,,2018-01-06,3000000.0,,-539427481.3700006,.
409000438620',2018-01-06,TRF TO  Indiaforensic SERVICES I,,2018-01-06,3000000.0,,-542427481.3700006,.
409000438620',2018-01-06,TRF TO  Indiaforensic SERVICES I,,2018-01-06,3000000.0,,-545427481.3700006,.
409000438620',2018-01-08,Indiaforensic AEPS NPCI WDL SET,,2018-01-08,,44107979.0,-501319502.3700006,.
409000438620',2018-01-08,Indiaforensic AEPS NPCI WDL SET,,2018-01-08,,31469794.0,-469849708.3700006,.
409000438620',2018-01-08,AEPS ACQUIRING ADJ FEES 0,,2018-01-08,302.07,,-469850010.4400006,.
409000438620',2018-01-08,AEPS Indiaforensic INCOME 060118,,2018-01-08,,195467.89,-469654542.5500006,.
409000438620',2018-01-08,AEPS Indiaforensic GST 060118,,2018-01-08,,35184.22,-469619358.3300006,.
409000438620',2018-01-08,AEPS Indiaforensic INCOME 070118,,2018-01-08,,143628.09,-469475730.2400006,.
409000438620',2018-01-08,AEPS Indiaforensic GST 070118,,2018-01-08,,25853.06,-469449877.1800006,.
409000438620',2018-01-08,Indiaforensic AEPS NPCI DEP SET,,2018-01-08,35299565.0,,-504749442.1800006,.
409000438620',2018-01-08,Indiaforensic AEPS NPCI DEP SET,,2018-01-08,26341855.0,,-531091297.1800006,.
409000438620',2018-01-08,TRF TO  Indiaforensic SERVICES I,,2018-01-08,15000000.0,,-546091297.1800005,.
409000438620',2018-01-08,CB734512443906/RMCPL16998/1,,2018-01-08,5000.0,,-546096297.1800005,.
409000438620',2018-01-08,CB734713491992/RMCPL12814/1,,2018-01-08,1000.0,,-546097297.1800005,.
409000438620',2018-01-08,CB731511349381/RMCPL15250/1,,2018-01-08,10000.0,,-546107297.1800005,.
409000438620',2018-01-08,CB734712444301/RMCPL21147/1,,2018-01-08,3000.0,,-546110297.1800005,.
409000438620',2018-01-08,CB734816594359/RMCPL15328/1,,2018-01-08,2000.0,,-546112297.1800005,.
409000438620',2018-01-08,CB735515169681/RMCPL20273/2,,2018-01-08,7000.0,,-546119297.1800005,.
409000438620',2018-01-08,CB733812559693/RMCPL18736/0,,2018-01-08,,10000.0,-546109297.1800005,.
409000438620',2018-01-08,CB733811498368/RMCPL13957/0,,2018-01-08,,9500.0,-546099797.1800005,.
409000438620',2018-01-08,CB734510328137/RMCPL21476/1,,2018-01-08,,10000.0,-546089797.1800005,.
409000438620',2018-01-08,CB734512447515/RMCPL17988/1,,2018-01-08,,2000.0,-546087797.1800005,.
409000438620',2018-01-08,CB734512447618/RMCPL18192/1,,2018-01-08,,10000.0,-546077797.1800005,.
409000438620',2018-01-08,CB734512439567/RMCPL12832/1,,2018-01-08,,10000.0,-546067797.1800005,.
409000438620',2018-01-08,CB734613512083/RMCPL16545/1,,2018-01-08,,10000.0,-546057797.1800005,.
409000438620',2018-01-08,CB735313581670/RMCPL19124/1,,2018-01-08,,8000.0,-546049797.1800005,.
409000438620',2018-01-08,CB735017271350/RMCPL14779/1,,2018-01-08,,500.0,-546049297.1800005,.
409000438620',2018-01-08,CB735014140965/RMCPL19664/1,,2018-01-08,,10000.0,-546039297.1800005,.
409000438620',2018-01-08,CB735012055165/RMCPL19724/1,,2018-01-08,,1200.0,-546038097.1800005,.
409000438620',2018-01-08,CB735012054759/RMCPL19068/1,,2018-01-08,,3500.0,-546034597.1800005,.
409000438620',2018-01-09,Indiaforensic AEPS NPCI WDL SET,,2018-01-09,,52353572.0,-493681025.18000054,.
409000438620',2018-01-09,AEPS ACQUIRING ADJ FEES 0,,2018-01-09,17.7,,-493681042.88000053,.
409000438620',2018-01-09,AEPS ACQ CR ADJ FEES 0801,,2018-01-09,2507.66,,-493683550.54000056,.
409000438620',2018-01-09,CR735512048508/RMCPL13859/2,,2018-01-09,500.0,,-493684050.54000056,.
409000438620',2018-01-09,CR735515167533/RMCPL10817/2,,2018-01-09,6000.0,,-493690050.54000056,.
409000438620',2018-01-09,CR735515168185/RMCPL22051/2,,2018-01-09,6000.0,,-493696050.54000056,.
409000438620',2018-01-09,CR735515169613/RMCPL17146/2,,2018-01-09,10000.0,,-493706050.54000056,.
409000438620',2018-01-09,CR735515169630/RMCPL20499/2,,2018-01-09,2500.0,,-493708550.54000056,.
409000438620',2018-01-09,CR735512049052/RMCPL17470/2,,2018-01-09,166.0,,-493708716.54000056,.
409000438620',2018-01-09,CR735515169785/RMCPL17511/2,,2018-01-09,3000.0,,-493711716.54000056,.
409000438620',2018-01-09,CR735515167923/RMCPL15232/2,,2018-01-09,2000.0,,-493713716.54000056,.
409000438620',2018-01-09,CR735512048035/RMCPL14700/2,,2018-01-09,5000.0,,-493718716.54000056,.
409000438620',2018-01-09,CR735512047074/RMCPL12509/2,,2018-01-09,500.0,,-493719216.54000056,.
409000438620',2018-01-09,CR735514122362/RMCPL16880/2,,2018-01-09,1500.0,,-493720716.54000056,.
409000438620',2018-01-09,CR735515168153/RMCPL16146/2,,2018-01-09,500.0,,-493721216.54000056,.
409000438620',2018-01-09,CR735515167953/RMCPL14609/2,,2018-01-09,1500.0,,-493722716.54000056,.
409000438620',2018-01-09,CR735511020377/RMCPL16880/2,,2018-01-09,1500.0,,-493724216.54000056,.
409000438620',2018-01-09,CR735512048787/RMCPL19012/2,,2018-01-09,3000.0,,-493727216.54000056,.
409000438620',2018-01-09,CR735515167389/RMCPL18492/2,,2018-01-09,5000.0,,-493732216.54000056,.
409000438620',2018-01-09,CR735515167160/RMCPL20676/2,,2018-01-09,5000.0,,-493737216.54000056,.
409000438620',2018-01-09,CR735514122258/RMCPL21735/2,,2018-01-09,500.0,,-493737716.54000056,.
409000438620',2018-01-09,CR735515167934/RMCPL15094/2,,2018-01-09,2000.0,,-493739716.54000056,.
409000438620',2018-01-09,CR735511019904/RMCPL11353/2,,2018-01-09,2000.0,,-493741716.54000056,.
409000438620',2018-01-09,CR735512047077/RMCPL19329/2,,2018-01-09,4000.0,,-493745716.54000056,.
409000438620',2018-01-09,CR735512050179/RMCPL20493/2,,2018-01-09,2000.0,,-493747716.54000056,.
409000438620',2018-01-09,CR735514122268/RMCPL15751/2,,2018-01-09,3000.0,,-493750716.54000056,.
409000438620',2018-01-09,CR735512048312/RMCPL16637/2,,2018-01-09,2500.0,,-493753216.54000056,.
409000438620',2018-01-09,CR735512047092/RMCPL16824/2,,2018-01-09,100.0,,-493753316.54000056,.
409000438620',2018-01-09,CR735514122265/RMCPL05271/2,,2018-01-09,2000.0,,-493755316.54000056,.
409000438620',2018-01-09,CR735515169717/RMCPL19867/2,,2018-01-09,500.0,,-493755816.54000056,.
409000438620',2018-01-09,CR735515169174/RMCPL09843/2,,2018-01-09,500.0,,-493756316.54000056,.
409000438620',2018-01-09,CR735515167526/RMCPL19182/2,,2018-01-09,1500.0,,-493757816.54000056,.
409000438620',2018-01-09,CR735511020818/RMCPL17616/2,,2018-01-09,1000.0,,-493758816.54000056,.
409000438620',2018-01-09,CR735515169650/RMCPL17775/2,,2018-01-09,10000.0,,-493768816.54000056,.
409000438620',2018-01-09,CR735514122261/RMCPL18740/2,,2018-01-09,10000.0,,-493778816.54000056,.
409000438620',2018-01-09,CR735511019923/RMCPL12312/2,,2018-01-09,1010.0,,-493779826.54000056,.
409000438620',2018-01-09,CR735515167555/RMCPL09649/2,,2018-01-09,500.0,,-493780326.54000056,.
409000438620',2018-01-09,CR735511019929/RMCPL14190/2,,2018-01-09,1500.0,,-493781826.54000056,.
409000438620',2018-01-09,CR735511019932/RMCPL13301/2,,2018-01-09,1500.0,,-493783326.54000056,.
409000438620',2018-01-09,CR735511020500/RMCPL00154/2,,2018-01-09,7000.0,,-493790326.54000056,.
409000438620',2018-01-09,CR735511022351/RMCPL17438/2,,2018-01-09,500.0,,-493790826.54000056,.
409000438620',2018-01-09,CR735512050144/RMCPL21490/2,,2018-01-09,5000.0,,-493795826.54000056,.
409000438620',2018-01-09,CR735511019933/RMCPL13893/2,,2018-01-09,5500.0,,-493801326.54000056,.
409000438620',2018-01-09,CR735515168060/RMCPL18414/2,,2018-01-09,10000.0,,-493811326.54000056,.
409000438620',2018-01-09,CR735515167156/RMCPL16323/2,,2018-01-09,10000.0,,-493821326.54000056,.
409000438620',2018-01-09,CR735515168072/RMCPL16092/2,,2018-01-09,500.0,,-493821826.54000056,.
409000438620',2018-01-09,CR735515167985/RMCPL19308/2,,2018-01-09,1000.0,,-493822826.54000056,.
409000438620',2018-01-09,CR735515169783/RMCPL20016/2,,2018-01-09,1000.0,,-493823826.54000056,.
409000438620',2018-01-09,CR735511019938/RMCPL18863/2,,2018-01-09,2000.0,,-493825826.54000056,.
409000438620',2018-01-09,CR735512049381/RMCPL22099/2,,2018-01-09,2000.0,,-493827826.54000056,.
409000438620',2018-01-09,CR735515169185/RMCPL11624/2,,2018-01-09,10000.0,,-493837826.54000056,.
409000438620',2018-01-09,CR735515169195/RMCPL20613/2,,2018-01-09,500.0,,-493838326.54000056,.
409000438620',2018-01-09,CR735511019903/RMCPL19562/2,,2018-01-09,500.0,,-493838826.54000056,.
409000438620',2018-01-09,CR735915929758/RMCPL16571/2,,2018-01-09,2000.0,,-493840826.54000056,.
409000438620',2018-01-09,CR735915929725/RMCPL21122/2,,2018-01-09,5000.0,,-493845826.54000056,.
409000438620',2018-01-09,CR735611673122/RMCPL18968/2,,2018-01-09,1000.0,,-493846826.54000056,.
409000438620',2018-01-09,CR735611673152/RMCPL21551/2,,2018-01-09,500.0,,-493847326.54000056,.
409000438620',2018-01-09,CR735611673062/RMCPL21507/2,,2018-01-09,500.0,,-493847826.54000056,.
409000438620',2018-01-09,CR735611673131/RMCPL17642/2,,2018-01-09,10000.0,,-493857826.54000056,.
409000438620',2018-01-09,CR735611673141/RMCPL21565/2,,2018-01-09,4000.0,,-493861826.54000056,.
409000438620',2018-01-09,CR735611672997/RMCPL17812/2,,2018-01-09,500.0,,-493862326.54000056,.
409000438620',2018-01-09,CR736111067950/RMCPL13088/2,,2018-01-09,2000.0,,-493864326.54000056,.
409000438620',2018-01-09,CR736212797872/RMCPL15594/2,,2018-01-09,5000.0,,-493869326.54000056,.
409000438620',2018-01-09,CR736212797977/RMCPL17307/2,,2018-01-09,3000.0,,-493872326.54000056,.
409000438620',2018-01-09,CR736212797868/RMCPL17123/2,,2018-01-09,700.0,,-493873026.54000056,.
409000438620',2018-01-09,CR736212798028/RMCPL19235/2,,2018-01-09,500.0,,-493873526.54000056,.
409000438620',2018-01-09,CR800216339006/RMCPL21647/0,,2018-01-09,1500.0,,-493875026.54000056,.
409000438620',2018-01-09,CR800214256878/RMCPL08124/0,,2018-01-09,500.0,,-493875526.54000056,.
409000438620',2018-01-09,CR800214256869/RMCPL17219/0,,2018-01-09,5000.0,,-493880526.54000056,.
409000438620',2018-01-09,CR800213216785/RMCPL14739/0,,2018-01-09,5000.0,,-493885526.54000056,.
409000438620',2018-01-09,CR800214258657/RMCPL10984/0,,2018-01-09,2000.0,,-493887526.54000056,.
409000438620',2018-01-09,CR800213216828/RMCPL15612/0,,2018-01-09,10000.0,,-493897526.54000056,.
409000438620',2018-01-09,CR800216339082/RMCPL22365/0,,2018-01-09,5000.0,,-493902526.54000056,.
409000438620',2018-01-09,CR800214256798/RMCPL18141/0,,2018-01-09,500.0,,-493903026.54000056,.
409000438620',2018-01-09,CR800216339330/RMCPL20241/0,,2018-01-09,3000.0,,-493906026.54000056,.
409000438620',2018-01-09,CR800216329019/RMCPL21235/0,,2018-01-09,500.0,,-493906526.54000056,.
409000438620',2018-01-09,CR800217384240/RMCPL22565/0,,2018-01-09,1000.0,,-493907526.54000056,.
409000438620',2018-01-09,CR800218401335/RMCPL18488/0,,2018-01-09,500.0,,-493908026.54000056,.
409000438620',2018-01-09,CR800216339087/RMCPL10820/0,,2018-01-09,2000.0,,-493910026.54000056,.
409000438620',2018-01-09,CR800214256984/RMCPL16122/0,,2018-01-09,1000.0,,-493911026.54000056,.
409000438620',2018-01-09,CR800214258554/RMCPL21375/0,,2018-01-09,2000.0,,-493913026.54000056,.
409000438620',2018-01-09,CR800214256823/RMCPL14536/0,,2018-01-09,5000.0,,-493918026.54000056,.
409000438620',2018-01-09,CR800214256944/RMCPL09500/0,,2018-01-09,10000.0,,-493928026.54000056,.
409000438620',2018-01-09,CR800216339238/RMCPL20680/0,,2018-01-09,1000.0,,-493929026.54000056,.
409000438620',2018-01-09,CR800216339297/RMCPL17843/0,,2018-01-09,5000.0,,-493934026.54000056,.
409000438620',2018-01-09,CR800217384313/RMCPL18497/0,,2018-01-09,1000.0,,-493935026.54000056,.
409000438620',2018-01-09,CR800214256887/RMCPL13036/0,,2018-01-09,500.0,,-493935526.54000056,.
409000438620',2018-01-09,CR800214258572/RMCPL18519/0,,2018-01-09,3000.0,,-493938526.54000056,.
409000438620',2018-01-09,CR800214259646/RMCPL17273/0,,2018-01-09,900.0,,-493939426.54000056,.
409000438620',2018-01-09,CR800216329066/RMCPL17413/0,,2018-01-09,3030.0,,-493942456.54000056,.
409000438620',2018-01-09,CR800216339309/RMCPL20451/0,,2018-01-09,2000.0,,-493944456.54000056,.
409000438620',2018-01-09,CR800216339053/RMCPL18576/0,,2018-01-09,7000.0,,-493951456.54000056,.
409000438620',2018-01-09,CR800214256990/RMCPL15896/0,,2018-01-09,4000.0,,-493955456.54000056,.
409000438620',2018-01-09,CR800217384486/RMCPL21493/0,,2018-01-09,1000.0,,-493956456.54000056,.
409000438620',2018-01-09,CR800217384350/RMCPL21219/0,,2018-01-09,1000.0,,-493957456.54000056,.
409000438620',2018-01-09,CR800217384482/RMCPL16787/0,,2018-01-09,2500.0,,-493959956.54000056,.
409000438620',2018-01-09,CR800214259635/RMCPL18607/0,,2018-01-09,2000.0,,-493961956.54000056,.
409000438620',2018-01-09,CR800213216786/RMCPL12897/0,,2018-01-09,500.0,,-493962456.54000056,.
409000438620',2018-01-09,CR800213216762/RMCPL19040/0,,2018-01-09,2500.0,,-493964956.54000056,.
409000438620',2018-01-09,CR800216339018/RMCPL16977/0,,2018-01-09,500.0,,-493965456.54000056,.
409000438620',2018-01-09,CR800213216794/RMCPL22266/0,,2018-01-09,310.0,,-493965766.54000056,.
409000438620',2018-01-09,CR800216339124/RMCPL19895/0,,2018-01-09,500.0,,-493966266.54000056,.
409000438620',2018-01-09,CR800214258739/RMCPL20369/0,,2018-01-09,3000.0,,-493969266.54000056,.
409000438620',2018-01-09,CR800214258616/RMCPL16021/0,,2018-01-09,10000.0,,-493979266.54000056,.
409000438620',2018-01-09,CR800214258668/RMCPL21061/0,,2018-01-09,10000.0,,-493989266.54000056,.
409000438620',2018-01-09,CR800218401426/RMCPL15518/0,,2018-01-09,2000.0,,-493991266.54000056,.
409000438620',2018-01-09,CR800216339079/RMCPL09136/0,,2018-01-09,5000.0,,-493996266.54000056,.
409000438620',2018-01-09,CR800214258677/RMCPL21970/0,,2018-01-09,1500.0,,-493997766.54000056,.
409000438620',2018-01-09,CR800214258621/RMCPL20329/0,,2018-01-09,1000.0,,-493998766.54000056,.
409000438620',2018-01-09,CR800217384331/RMCPL11796/0,,2018-01-09,4000.0,,-494002766.54000056,.
409000438620',2018-01-09,CR800214258650/RMCPL11707/0,,2018-01-09,10000.0,,-494012766.54000056,.
409000438620',2018-01-09,CR800213216735/RMCPL21258/0,,2018-01-09,5000.0,,-494017766.54000056,.
409000438620',2018-01-09,CR800213216969/RMCPL09099/0,,2018-01-09,1500.0,,-494019266.54000056,.
409000438620',2018-01-09,CR800213216795/RMCPL18815/0,,2018-01-09,5960.0,,-494025226.54000056,.
409000438620',2018-01-09,CR800214258605/RMCPL21685/0,,2018-01-09,500.0,,-494025726.54000056,.
409000438620',2018-01-09,CR800215262943/RMCPL14588/0,,2018-01-09,1500.0,,-494027226.54000056,.
409000438620',2018-01-09,CR800215262908/RMCPL22133/0,,2018-01-09,1000.0,,-494028226.54000056,.
409000438620',2018-01-09,CR800215262976/RMCPL22606/0,,2018-01-09,7500.0,,-494035726.54000056,.
409000438620',2018-01-09,CR800215263203/RMCPL10073/0,,2018-01-09,500.0,,-494036226.54000056,.
409000438620',2018-01-09,CR800215263308/RMCPL17905/0,,2018-01-09,1000.0,,-494037226.54000056,.
409000438620',2018-01-09,CR800215262938/RMCPL16095/0,,2018-01-09,4000.0,,-494041226.54000056,.
409000438620',2018-01-09,CR800215263041/RMCPL20628/0,,2018-01-09,4000.0,,-494045226.54000056,.
409000438620',2018-01-09,CR800215263313/RMCPL19453/0,,2018-01-09,500.0,,-494045726.54000056,.
409000438620',2018-01-09,CR800215263023/RMCPL19040/0,,2018-01-09,6000.0,,-494051726.54000056,.
409000438620',2018-01-09,CR800211119242/RMCPL14751/0,,2018-01-09,2000.0,,-494053726.54000056,.
409000438620',2018-01-09,CR800215263325/RMCPL16216/0,,2018-01-09,1000.0,,-494054726.54000056,.
409000438620',2018-01-09,CR800215263136/RMCPL13526/0,,2018-01-09,500.0,,-494055226.54000056,.
409000438620',2018-01-09,CR800215262948/RMCPL16925/0,,2018-01-09,2500.0,,-494057726.54000056,.
409000438620',2018-01-09,CR800215263100/RMCPL21378/0,,2018-01-09,2000.0,,-494059726.54000056,.
409000438620',2018-01-09,CR800215263375/RMCPL19609/0,,2018-01-09,3000.0,,-494062726.54000056,.
409000438620',2018-01-09,CR800211119240/RMCPL14165/0,,2018-01-09,510.0,,-494063236.54000056,.
409000438620',2018-01-09,CR800215263052/RMCPL18313/0,,2018-01-09,1000.0,,-494064236.54000056,.
409000438620',2018-01-09,CR735412331067/RMCPL12330/2,,2018-01-09,500.0,,-494064736.54000056,.
409000438620',2018-01-09,CR735412330940/RMCPL19959/2,,2018-01-09,500.0,,-494065236.54000056,.
409000438620',2018-01-09,CR735412331112/RMCPL12720/2,,2018-01-09,600.0,,-494065836.54000056,.
409000438620',2018-01-09,CR735412331117/RMCPL18921/2,,2018-01-09,2000.0,,-494067836.54000056,.
409000438620',2018-01-09,CR735412331062/RMCPL13301/2,,2018-01-09,500.0,,-494068336.54000056,.
409000438620',2018-01-09,CR735412330931/RMCPL20395/2,,2018-01-09,2500.0,,-494070836.54000056,.
409000438620',2018-01-09,CR735412331027/RMCPL14615/2,,2018-01-09,7000.0,,-494077836.54000056,.
409000438620',2018-01-09,CR735412330836/RMCPL15577/2,,2018-01-09,3000.0,,-494080836.54000056,.
409000438620',2018-01-09,CR735412330858/RMCPL15030/2,,2018-01-09,10000.0,,-494090836.54000056,.
409000438620',2018-01-09,CR735412331024/RMCPL20528/2,,2018-01-09,3000.0,,-494093836.54000056,.
409000438620',2018-01-09,CR735412330872/RMCPL14215/2,,2018-01-09,10000.0,,-494103836.54000056,.
409000438620',2018-01-09,CR735412331079/RMCPL21904/2,,2018-01-09,2000.0,,-494105836.54000056,.
409000438620',2018-01-09,CR735412331011/RMCPL20318/2,,2018-01-09,1000.0,,-494106836.54000056,.
409000438620',2018-01-09,CR735412330832/RMCPL12288/2,,2018-01-09,1500.0,,-494108336.54000056,.
409000438620',2018-01-09,CR735412330868/RMCPL16572/2,,2018-01-09,500.0,,-494108836.54000056,.
409000438620',2018-01-09,CR735412331113/RMCPL14954/2,,2018-01-09,500.0,,-494109336.54000056,.
409000438620',2018-01-09,CR735412331111/RMCPL17350/2,,2018-01-09,5000.0,,-494114336.54000056,.
409000438620',2018-01-09,CR736111068862/RMCPL20908/2,,2018-01-09,500.0,,-494114836.54000056,.
409000438620',2018-01-09,CR800216330156/RMCPL18302/0,,2018-01-09,3000.0,,-494117836.54000056,.
409000438620',2018-01-09,CR800216330192/RMCPL17428/0,,2018-01-09,2000.0,,-494119836.54000056,.
409000438620',2018-01-09,CR800214260985/RMCPL16629/0,,2018-01-09,2000.0,,-494121836.54000056,.
409000438620',2018-01-09,CR800216330061/RMCPL17562/0,,2018-01-09,500.0,,-494122336.54000056,.
409000438620',2018-01-09,CR800216330049/RMCPL13710/0,,2018-01-09,500.0,,-494122836.54000056,.
409000438620',2018-01-09,CR800216330198/RMCPL17405/0,,2018-01-09,2000.0,,-494124836.54000056,.
409000438620',2018-01-09,CR800218395346/RMCPL09181/0,,2018-01-09,500.0,,-494125336.54000056,.
409000438620',2018-01-09,CR800216330132/RMCPL00152/0,,2018-01-09,1000.0,,-494126336.54000056,.
409000438620',2018-01-09,CR800214261045/RMCPL16467/0,,2018-01-09,2000.0,,-494128336.54000056,.
409000438620',2018-01-09,CR800214261173/RMCPL17273/0,,2018-01-09,2500.0,,-494130836.54000056,.
409000438620',2018-01-09,CR800214261203/RMCPL16571/0,,2018-01-09,1000.0,,-494131836.54000056,.
409000438620',2018-01-09,CR800218395279/RMCPL18271/0,,2018-01-09,2500.0,,-494134336.54000056,.
409000438620',2018-01-09,CR800218395378/RMCPL17285/0,,2018-01-09,1500.0,,-494135836.54000056,.
409000438620',2018-01-09,CR800216330140/RMCPL17259/0,,2018-01-09,1000.0,,-494136836.54000056,.
409000438620',2018-01-09,CR800218395561/RMCPL22397/0,,2018-01-09,2000.0,,-494138836.54000056,.
409000438620',2018-01-09,CR800216330330/RMCPL22497/0,,2018-01-09,10000.0,,-494148836.54000056,.
409000438620',2018-01-09,CR800214261167/RMCPL21320/0,,2018-01-09,500.0,,-494149336.54000056,.
409000438620',2018-01-09,CR800214261146/RMCPL16185/0,,2018-01-09,1000.0,,-494150336.54000056,.
409000438620',2018-01-09,CR800218395516/RMCPL16162/0,,2018-01-09,5000.0,,-494155336.54000056,.
409000438620',2018-01-09,CR800218395543/RMCPL16643/0,,2018-01-09,1000.0,,-494156336.54000056,.
409000438620',2018-01-09,CR800214261153/RMCPL17019/0,,2018-01-09,10000.0,,-494166336.54000056,.
409000438620',2018-01-09,CR800214261102/RMCPL19138/0,,2018-01-09,1000.0,,-494167336.54000056,.
409000438620',2018-01-09,CR800214261087/RMCPL13173/0,,2018-01-09,1000.0,,-494168336.54000056,.
409000438620',2018-01-09,CR800214261169/RMCPL14982/0,,2018-01-09,1000.0,,-494169336.54000056,.
409000438620',2018-01-09,CR800216330250/RMCPL19890/0,,2018-01-09,500.0,,-494169836.54000056,.
409000438620',2018-01-09,CR800214261130/RMCPL16004/0,,2018-01-09,1000.0,,-494170836.54000056,.
409000438620',2018-01-09,CR800214261077/RMCPL20548/0,,2018-01-09,5000.0,,-494175836.54000056,.
409000438620',2018-01-09,CR800214261099/RMCPL16210/0,,2018-01-09,10000.0,,-494185836.54000056,.
409000438620',2018-01-09,CR800214261061/RMCPL15781/0,,2018-01-09,5000.0,,-494190836.54000056,.
409000438620',2018-01-09,CR800214228242/RMCPL20472/0,,2018-01-09,500.0,,-494191336.54000056,.
409000438620',2018-01-09,CR800218395333/RMCPL16230/0,,2018-01-09,4000.0,,-494195336.54000056,.
409000438620',2018-01-09,CR800218395361/RMCPL15518/0,,2018-01-09,1000.0,,-494196336.54000056,.
409000438620',2018-01-09,CR800214261188/RMCPL17219/0,,2018-01-09,10000.0,,-494206336.54000056,.
409000438620',2018-01-09,CR800214261084/RMCPL17664/0,,2018-01-09,3000.0,,-494209336.54000056,.
409000438620',2018-01-09,CR800214261043/RMCPL19682/0,,2018-01-09,610.0,,-494209946.54000056,.
409000438620',2018-01-09,CR800216330333/RMCPL18884/0,,2018-01-09,500.0,,-494210446.54000056,.
409000438620',2018-01-09,CR800214261009/RMCPL20138/0,,2018-01-09,2500.0,,-494212946.54000056,.
409000438620',2018-01-09,CR800312854269/RMCPL21530/0,,2018-01-09,500.0,,-494213446.54000056,.
409000438620',2018-01-09,CR800312836797/RMCPL18349/0,,2018-01-09,2000.0,,-494215446.54000056,.
409000438620',2018-01-09,CR800313866951/RMCPL16821/0,,2018-01-09,5500.0,,-494220946.54000056,.
409000438620',2018-01-09,CR800312823879/RMCPL16092/0,,2018-01-09,5000.0,,-494225946.54000056,.
409000438620',2018-01-09,CR800312854215/RMCPL21514/0,,2018-01-09,1500.0,,-494227446.54000056,.
409000438620',2018-01-09,CR800312836586/RMCPL22265/0,,2018-01-09,10000.0,,-494237446.54000056,.
409000438620',2018-01-09,CR800312836656/RMCPL14406/0,,2018-01-09,5000.0,,-494242446.54000056,.
409000438620',2018-01-09,CR800312854254/RMCPL17616/0,,2018-01-09,1000.0,,-494243446.54000056,.
409000438620',2018-01-09,CR800312836845/RMCPL18465/0,,2018-01-09,1000.0,,-494244446.54000056,.
409000438620',2018-01-09,CR800317024766/RMCPL14809/0,,2018-01-09,500.0,,-494244946.54000056,.
409000438620',2018-01-09,CR800313866920/RMCPL20706/0,,2018-01-09,2000.0,,-494246946.54000056,.
409000438620',2018-01-09,CR800312826020/RMCPL17511/0,,2018-01-09,500.0,,-494247446.54000056,.
409000438620',2018-01-09,CR800312836517/RMCPL16092/0,,2018-01-09,1000.0,,-494248446.54000056,.
409000438620',2018-01-09,CR800312836319/RMCPL15334/0,,2018-01-09,8000.0,,-494256446.54000056,.
409000438620',2018-01-09,CR800312854392/RMCPL19796/0,,2018-01-09,5000.0,,-494261446.54000056,.
409000438620',2018-01-09,CR800313867033/RMCPL07629/0,,2018-01-09,3000.0,,-494264446.54000056,.
409000438620',2018-01-09,CR800312854307/RMCPL11811/0,,2018-01-09,1000.0,,-494265446.54000056,.
409000438620',2018-01-09,CR800313867071/RMCPL14662/0,,2018-01-09,1000.0,,-494266446.54000056,.
409000438620',2018-01-09,CR800312836755/RMCPL19859/0,,2018-01-09,800.0,,-494267246.54000056,.
409000438620',2018-01-09,CR800312830054/RMCPL16390/0,,2018-01-09,7000.0,,-494274246.54000056,.
409000438620',2018-01-09,CR800317024620/RMCPL11811/0,,2018-01-09,2020.0,,-494276266.54000056,.
409000438620',2018-01-09,CR800317024798/RMCPL20430/0,,2018-01-09,3000.0,,-494279266.54000056,.
409000438620',2018-01-09,CR800312854378/RMCPL19763/0,,2018-01-09,3000.0,,-494282266.54000056,.
409000438620',2018-01-09,CR800312836582/RMCPL13851/0,,2018-01-09,1000.0,,-494283266.54000056,.
409000438620',2018-01-09,CR800312854240/RMCPL16355/0,,2018-01-09,500.0,,-494283766.54000056,.
409000438620',2018-01-09,CR800312854265/RMCPL14780/0,,2018-01-09,3500.0,,-494287266.54000056,.
409000438620',2018-01-09,CR800313866896/RMCPL11227/0,,2018-01-09,1000.0,,-494288266.54000056,.
409000438620',2018-01-09,CR800312836513/RMCPL21946/0,,2018-01-09,3000.0,,-494291266.54000056,.
409000438620',2018-01-09,CR800312836675/RMCPL20319/0,,2018-01-09,1000.0,,-494292266.54000056,.
409000438620',2018-01-09,CR800317024771/RMCPL15468/0,,2018-01-09,2000.0,,-494294266.54000056,.
409000438620',2018-01-09,CR800317024712/RMCPL18343/0,,2018-01-09,1000.0,,-494295266.54000056,.
409000438620',2018-01-09,CR800317024681/RMCPL09117/0,,2018-01-09,1000.0,,-494296266.54000056,.
409000438620',2018-01-09,CR800312836710/RMCPL20507/0,,2018-01-09,6000.0,,-494302266.54000056,.
409000438620',2018-01-09,CR800312836814/RMCPL17423/0,,2018-01-09,2000.0,,-494304266.54000056,.
409000438620',2018-01-09,CR800313867132/RMCPL17747/0,,2018-01-09,1000.0,,-494305266.54000056,.
409000438620',2018-01-09,CR800313867029/RMCPL12634/0,,2018-01-09,1000.0,,-494306266.54000056,.
409000438620',2018-01-09,CR800317024612/RMCPL15015/0,,2018-01-09,1000.0,,-494307266.54000056,.
409000438620',2018-01-09,CR800317024893/RMCPL11759/0,,2018-01-09,500.0,,-494307766.54000056,.
409000438620',2018-01-09,CR800312836502/RMCPL16185/0,,2018-01-09,6000.0,,-494313766.54000056,.
409000438620',2018-01-09,CR800312854148/RMCPL12064/0,,2018-01-09,1500.0,,-494315266.54000056,.
409000438620',2018-01-09,CR800312854176/RMCPL22000/0,,2018-01-09,2500.0,,-494317766.54000056,.
409000438620',2018-01-09,CR800317024606/RMCPL17115/0,,2018-01-09,1000.0,,-494318766.54000056,.
409000438620',2018-01-09,CR800313866960/RMCPL21498/0,,2018-01-09,1000.0,,-494319766.54000056,.
409000438620',2018-01-09,CR800312836576/RMCPL11827/0,,2018-01-09,1000.0,,-494320766.54000056,.
409000438620',2018-01-09,CR800317024967/RMCPL15954/0,,2018-01-09,3000.0,,-494323766.54000056,.
409000438620',2018-01-09,CR800312836796/RMCPL14498/0,,2018-01-09,2000.0,,-494325766.54000056,.
409000438620',2018-01-09,CR800312836563/RMCPL17234/0,,2018-01-09,500.0,,-494326266.54000056,.
409000438620',2018-01-09,CR800317024793/RMCPL12522/0,,2018-01-09,1300.0,,-494327566.54000056,.
409000438620',2018-01-09,CR800312836679/RMCPL17115/0,,2018-01-09,1000.0,,-494328566.54000056,.
409000438620',2018-01-09,CR800312854284/RMCPL19939/0,,2018-01-09,1000.0,,-494329566.54000056,.
409000438620',2018-01-09,CR800312854380/RMCPL15397/0,,2018-01-09,2000.0,,-494331566.54000056,.
409000438620',2018-01-09,CR800312836632/RMCPL13879/0,,2018-01-09,6000.0,,-494337566.54000056,.
409000438620',2018-01-09,CR800312836531/RMCPL17352/0,,2018-01-09,10000.0,,-494347566.54000056,.
409000438620',2018-01-09,AEPS Indiaforensic INCOME 080118,,2018-01-09,,219212.8,-494128353.74000055,.
409000438620',2018-01-09,AEPS Indiaforensic GST 080118,,2018-01-09,,39458.3,-494088895.44000053,.
409000438620',2018-01-09,Indiaforensic AEPS NPCI DEP SET,,2018-01-09,36658289.0,,-530747184.44000053,.
409000438620',2018-01-09,TRF TO  Indiaforensic SERVICES I,,2018-01-09,15000000.0,,-545747184.4400005,.
409000438620',2018-01-09,TRF TO  Indiaforensic SERVICES I,,2018-01-09,500000.0,,-546247184.4400005,.
409000438620',2018-01-10,AEPS ACQ REP ADJ FEES 090,,2018-01-10,,100.3,-546247084.1400006,.
409000438620',2018-01-10,AEPS Indiaforensic INCOME 090118,,2018-01-10,,225615.53,-546021468.6100006,.
409000438620',2018-01-10,AEPS Indiaforensic GST 090118,,2018-01-10,,40610.8,-545980857.8100007,.
409000438620',2018-01-10,Indiaforensic AEPS NPCI WDL SET,,2018-01-10,,52483897.0,-493496960.81000066,.
409000438620',2018-01-10,Indiaforensic AEPS NPCI DEP SET,,2018-01-10,39897123.0,,-533394083.81000066,.
409000438620',2018-01-10,TRF TO  Indiaforensic SERVICES I,,2018-01-10,12900000.0,,-546294083.8100007,.
409000438620',2018-01-11,Indiaforensic AEPS NPCI WDL SET,,2018-01-11,,51467187.0,-494826896.81000066,.
409000438620',2018-01-11,Indiaforensic AEPS NPCI DEP SET,,2018-01-11,41208746.0,,-536035642.81000066,.
409000438620',2018-01-11,AEPS Indiaforensic INCOME 100118,,2018-01-11,,226040.01,-535809602.80000067,.
409000438620',2018-01-11,AEPS Indiaforensic GST 100118,,2018-01-11,,40687.2,-535768915.6000007,.
409000438620',2018-01-11,TRF TO  Indiaforensic SERVICES I,,2018-01-11,10500000.0,,-546268915.6000006,.
409000438620',2018-01-11,Indiaforensic AEPS NPCI DEP SET,,2018-01-11,3000.0,,-546271915.6000006,.
409000438620',2018-01-12,Indiaforensic AEPS NPCI WDL SET,,2018-01-12,,49056114.0,-497215801.6000006,.
409000438620',2018-01-12,AEPS ACQUIRING ADJ FEES 1,,2018-01-12,94.98,,-497215896.58000064,.
409000438620',2018-01-12,Indiaforensic AEPS NPCI DEP SET,,2018-01-12,36529439.0,,-533745335.58000064,.
409000438620',2018-01-12,AEPS Indiaforensic INCOME 110118,,2018-01-12,,207173.05,-533538162.5300006,.
409000438620',2018-01-12,AEPS Indiaforensic GST 110118,,2018-01-12,,37291.15,-533500871.38000065,.
409000438620',2018-01-12,TRF TO  Indiaforensic SERVICES I,,2018-01-12,12500000.0,,-546000871.3800006,.
409000438620',2018-01-15,Indiaforensic AEPS NPCI WDL SET,,2018-01-15,,51879422.0,-494121449.3800006,.
409000438620',2018-01-15,Indiaforensic AEPS NPCI WDL SET,,2018-01-15,,56096135.0,-438025314.3800006,.
409000438620',2018-01-15,Indiaforensic AEPS NPCI WDL SET,,2018-01-15,,31238902.0,-406786412.3800006,.
409000438620',2018-01-15,Indiaforensic AEPS NPCI DEP SET,,2018-01-15,37794896.0,,-444581308.3800006,.
409000438620',2018-01-15,Indiaforensic AEPS NPCI DEP SET,,2018-01-15,41386936.0,,-485968244.3800006,.
409000438620',2018-01-15,Indiaforensic AEPS NPCI DEP SET,,2018-01-15,29918078.0,,-515886322.3800006,.
409000438620',2018-01-15,AEPS ACQ REP ADJ FEES 120,,2018-01-15,,41.3,-515886281.0800006,.
409000438620',2018-01-15,TRF TO  Indiaforensic SERVICES I,,2018-01-15,15000000.0,,-530886281.0800006,.
409000438620',2018-01-15,TRF TO  Indiaforensic SERVICES I,,2018-01-15,15000000.0,,-545886281.0800006,.
409000438620',2018-01-15,GF735017271350/RMCPL14779/1,,2018-01-15,500.0,,-545886781.0800006,.
409000438620',2018-01-15,AEPS ACQ GF REP ADJ FEES1,,2018-01-15,,2.95,-545886778.1300006,.
409000438620',2018-01-15,AEPS Indiaforensic INCOME 120118,,2018-01-15,,221438.09,-545665340.0400006,.
409000438620',2018-01-15,AEPS Indiaforensic GST 120118,,2018-01-15,,39858.86,-545625481.1800005,.
409000438620',2018-01-15,AEPS Indiaforensic INCOME 120118,,2018-01-15,,239776.39,-545385704.7900006,.
409000438620',2018-01-15,AEPS Indiaforensic GST 120118,,2018-01-15,,43159.75,-545342545.0400006,.
409000438620',2018-01-15,AEPS Indiaforensic INCOME 140118,,2018-01-15,,153339.28,-545189205.7600006,.
409000438620',2018-01-15,AEPS Indiaforensic GST 140118,,2018-01-15,,27601.07,-545161604.6900005,.
409000438620',2018-01-16,Indiaforensic AEPS NPCI WDL SET,,2018-01-16,,45552955.0,-499608649.69000053,.
409000438620',2018-01-16,AEPS ACQUIRING ADJ FEES 1,,2018-01-16,95.88,,-499608745.5700005,.
409000438620',2018-01-16,Indiaforensic AEPS NPCI DEP SET,,2018-01-16,35657151.0,,-535265896.5700005,.
409000438620',2018-01-16,AEPS Indiaforensic INCOME 150118,,2018-01-16,,200116.64,-535065779.93000054,.
409000438620',2018-01-16,AEPS Indiaforensic GST 150118,,2018-01-16,,36021.0,-535029758.93000054,.
409000438620',2018-01-16,TRF TO  Indiaforensic SERVICES I,,2018-01-16,11000000.0,,-546029758.9300005,.
409000438620',2018-01-17,Indiaforensic AEPS NPCI WDL SET,,2018-01-17,,54673592.0,-491356166.93000054,.
409000438620',2018-01-17,Indiaforensic AEPS NPCI DEP SET,,2018-01-17,43914275.0,,-535270441.93000054,.
409000438620',2018-01-17,AEPS ACQUIRING ADJ FEES 1,,2018-01-17,67.85,,-535270509.78000057,.
409000438620',2018-01-17,AEPS Indiaforensic INCOME 160118,,2018-01-17,,240672.3,-535029837.48000056,.
409000438620',2018-01-17,AEPS Indiaforensic GST 160118,,2018-01-17,,43321.01,-534986516.47000057,.
409000438620',2018-01-17,TRF TO  Indiaforensic SERVICES I,,2018-01-17,10000000.0,,-544986516.4700005,.
409000438620',2018-01-17,TRF TO  Indiaforensic SERVICES I,,2018-01-17,1000000.0,,-545986516.4700005,.
409000438620',2018-01-18,Indiaforensic AEPS NPCI WDL SET,,2018-01-18,,50683424.0,-495303092.4700005,.
409000438620',2018-01-18,Indiaforensic AEPS NPCI DEP SET,,2018-01-18,42215613.0,,-537518705.4700005,.
409000438620',2018-01-18,AEPS ACQUIRING ADJ FEES 1,,2018-01-18,115.11,,-537518820.5800005,.
409000438620',2018-01-18,AEPS ACQ CR ADJ FEES 1701,,2018-01-18,1467.1,,-537520287.6800005,.
409000438620',2018-01-18,AEPS Indiaforensic INCOME 170118,,2018-01-18,,226338.38,-537293949.3000005,.
409000438620',2018-01-18,AEPS Indiaforensic GST 170118,,2018-01-18,,40740.91,-537253208.3900006,.
409000438620',2018-01-18,CR800917586889/RMCPL17872/0,,2018-01-18,2500.0,,-537255708.3900006,.
409000438620',2018-01-18,CR800917587230/RMCPL21498/0,,2018-01-18,2000.0,,-537257708.3900006,.
409000438620',2018-01-18,CR800917578140/RMCPL21243/0,,2018-01-18,3000.0,,-537260708.3900006,.
409000438620',2018-01-18,CR800917587212/RMCPL13807/0,,2018-01-18,300.0,,-537261008.3900006,.
409000438620',2018-01-18,CR800917586568/RMCPL03048/0,,2018-01-18,3050.0,,-537264058.3900006,.
409000438620',2018-01-18,CR800917586562/RMCPL20319/0,,2018-01-18,1000.0,,-537265058.3900006,.
409000438620',2018-01-18,CR800917586621/RMCPL19756/0,,2018-01-18,6000.0,,-537271058.3900006,.
409000438620',2018-01-18,CR800917586435/RMCPL11898/0,,2018-01-18,500.0,,-537271558.3900006,.
409000438620',2018-01-18,CR800917587297/RMCPL10937/0,,2018-01-18,500.0,,-537272058.3900006,.
409000438620',2018-01-18,CR800917587275/RMCPL19554/0,,2018-01-18,1000.0,,-537273058.3900006,.
409000438620',2018-01-18,CR800917587205/RMCPL12824/0,,2018-01-18,2000.0,,-537275058.3900006,.
409000438620',2018-01-18,CR800917587312/RMCPL21765/0,,2018-01-18,1000.0,,-537276058.3900006,.
409000438620',2018-01-18,CR800415517797/RMCPL15703/0,,2018-01-18,2000.0,,-537278058.3900006,.
409000438620',2018-01-18,CR800415517674/RMCPL18649/0,,2018-01-18,8000.0,,-537286058.3900006,.
409000438620',2018-01-18,CR800415517874/RMCPL19899/0,,2018-01-18,1000.0,,-537287058.3900006,.
409000438620',2018-01-18,CR800415517577/RMCPL19112/0,,2018-01-18,3500.0,,-537290558.3900006,.
409000438620',2018-01-18,CR800415517574/RMCPL13310/0,,2018-01-18,500.0,,-537291058.3900006,.
409000438620',2018-01-18,CR800415517948/RMCPL22050/0,,2018-01-18,4000.0,,-537295058.3900006,.
409000438620',2018-01-18,CR800415517694/RMCPL19235/0,,2018-01-18,1000.0,,-537296058.3900006,.
409000438620',2018-01-18,CR800415517767/RMCPL17018/0,,2018-01-18,5000.0,,-537301058.3900006,.
409000438620',2018-01-18,CR800415517798/RMCPL21136/0,,2018-01-18,7000.0,,-537308058.3900006,.
409000438620',2018-01-18,CR800415517571/RMCPL14833/0,,2018-01-18,500.0,,-537308558.3900006,.
409000438620',2018-01-18,CR800415517865/RMCPL18868/0,,2018-01-18,10000.0,,-537318558.3900006,.
409000438620',2018-01-18,CR800415517756/RMCPL16717/0,,2018-01-18,3000.0,,-537321558.3900006,.
409000438620',2018-01-18,CR800415517912/RMCPL18240/0,,2018-01-18,1000.0,,-537322558.3900006,.
409000438620',2018-01-18,CR800815905636/RMCPL00112/0,,2018-01-18,2000.0,,-537324558.3900006,.
409000438620',2018-01-18,CR800816963225/RMCPL16793/0,,2018-01-18,3000.0,,-537327558.3900006,.
409000438620',2018-01-18,CR800816963223/RMCPL18493/0,,2018-01-18,2500.0,,-537330058.3900006,.
409000438620',2018-01-18,CR800815905596/RMCPL14181/0,,2018-01-18,5000.0,,-537335058.3900006,.
409000438620',2018-01-18,CR800815905475/RMCPL10452/0,,2018-01-18,2500.0,,-537337558.3900006,.
409000438620',2018-01-18,CR800815905564/RMCPL16100/0,,2018-01-18,2500.0,,-537340058.3900006,.
409000438620',2018-01-18,CR800815905585/RMCPL11952/0,,2018-01-18,10000.0,,-537350058.3900006,.
409000438620',2018-01-18,CR800815905549/RMCPL14471/0,,2018-01-18,5000.0,,-537355058.3900006,.
409000438620',2018-01-18,CR800913418046/RMCPL20594/0,,2018-01-18,600.0,,-537355658.3900006,.
409000438620',2018-01-18,CR800918624761/RMCPL16100/0,,2018-01-18,2000.0,,-537357658.3900006,.
409000438620',2018-01-18,CR800918647966/RMCPL21498/0,,2018-01-18,5000.0,,-537362658.3900006,.
409000438620',2018-01-18,CR800917577295/RMCPL09588/0,,2018-01-18,3000.0,,-537365658.3900006,.
409000438620',2018-01-18,CR800917577270/RMCPL10735/0,,2018-01-18,2000.0,,-537367658.3900006,.
409000438620',2018-01-18,CR800913418017/RMCPL13573/0,,2018-01-18,3000.0,,-537370658.3900006,.
409000438620',2018-01-18,CR800917587578/RMCPL18560/0,,2018-01-18,2000.0,,-537372658.3900006,.
409000438620',2018-01-18,CR800918655088/RMCPL22818/0,,2018-01-18,3000.0,,-537375658.3900006,.
409000438620',2018-01-18,CR800918624132/RMCPL22507/0,,2018-01-18,4000.0,,-537379658.3900006,.
409000438620',2018-01-18,CR800918624678/RMCPL18298/0,,2018-01-18,500.0,,-537380158.3900006,.
409000438620',2018-01-18,CR800917587575/RMCPL14640/0,,2018-01-18,2500.0,,-537382658.3900006,.
409000438620',2018-01-18,CR800918646925/RMCPL11511/0,,2018-01-18,1000.0,,-537383658.3900006,.
409000438620',2018-01-18,CR800918655110/RMCPL15583/0,,2018-01-18,500.0,,-537384158.3900006,.
409000438620',2018-01-18,CR800918655143/RMCPL10922/0,,2018-01-18,1500.0,,-537385658.3900006,.
409000438620',2018-01-18,CR800918624622/RMCPL19429/0,,2018-01-18,1000.0,,-537386658.3900006,.
409000438620',2018-01-18,CR800918623849/RMCPL10752/0,,2018-01-18,1000.0,,-537387658.3900006,.
409000438620',2018-01-18,CR800917587574/RMCPL09664/0,,2018-01-18,3000.0,,-537390658.3900006,.
409000438620',2018-01-18,CR800918624437/RMCPL19570/0,,2018-01-18,2500.0,,-537393158.3900006,.
409000438620',2018-01-18,CR800918624071/RMCPL19904/0,,2018-01-18,3220.0,,-537396378.3900006,.
409000438620',2018-01-18,CR800918655134/RMCPL17812/0,,2018-01-18,500.0,,-537396878.3900006,.
409000438620',2018-01-18,CR800918655022/RMCPL22747/0,,2018-01-18,3000.0,,-537399878.3900006,.
409000438620',2018-01-18,CR800917577247/RMCPL17881/0,,2018-01-18,3000.0,,-537402878.3900006,.
409000438620',2018-01-18,CR800918624647/RMCPL16887/0,,2018-01-18,200.0,,-537403078.3900006,.
409000438620',2018-01-18,CR800918624491/RMCPL15232/0,,2018-01-18,5000.0,,-537408078.3900006,.
409000438620',2018-01-18,CR800918655059/RMCPL02803/0,,2018-01-18,2000.0,,-537410078.3900006,.
409000438620',2018-01-18,CR800917587601/RMCPL16750/0,,2018-01-18,10000.0,,-537420078.3900006,.
409000438620',2018-01-18,CR800917587335/RMCPL19583/0,,2018-01-18,3000.0,,-537423078.3900006,.
409000438620',2018-01-18,CR800410330261/RMCPL18600/0,,2018-01-18,1000.0,,-537424078.3900006,.
409000438620',2018-01-18,CR800411378080/RMCPL17645/0,,2018-01-18,500.0,,-537424578.3900006,.
409000438620',2018-01-18,CR800411378137/RMCPL16353/0,,2018-01-18,3000.0,,-537427578.3900006,.
409000438620',2018-01-18,CR800411378215/RMCPL21284/0,,2018-01-18,5000.0,,-537432578.3900006,.
409000438620',2018-01-18,CR800410330282/RMCPL09640/0,,2018-01-18,10000.0,,-537442578.3900006,.
409000438620',2018-01-18,CR800411378205/RMCPL18992/0,,2018-01-18,3000.0,,-537445578.3900006,.
409000438620',2018-01-18,CR800411378271/RMCPL10084/0,,2018-01-18,1000.0,,-537446578.3900006,.
409000438620',2018-01-18,CR800411378282/RMCPL14949/0,,2018-01-18,1000.0,,-537447578.3900006,.
409000438620',2018-01-18,CR800411378136/RMCPL18804/0,,2018-01-18,3000.0,,-537450578.3900006,.
409000438620',2018-01-18,CR800411378284/RMCPL16858/0,,2018-01-18,500.0,,-537451078.3900006,.
409000438620',2018-01-18,CR800410330375/RMCPL21687/0,,2018-01-18,1000.0,,-537452078.3900006,.
409000438620',2018-01-18,CR800411378244/RMCPL00226/0,,2018-01-18,10000.0,,-537462078.3900006,.
409000438620',2018-01-18,CR800410330300/RMCPL17289/0,,2018-01-18,10000.0,,-537472078.3900006,.
409000438620',2018-01-18,CR800410330374/RMCPL15524/0,,2018-01-18,500.0,,-537472578.3900006,.
409000438620',2018-01-18,CR800410330361/RMCPL19895/0,,2018-01-18,1500.0,,-537474078.3900006,.
409000438620',2018-01-18,CR800816949747/RMCPL00543/0,,2018-01-18,500.0,,-537474578.3900006,.
409000438620',2018-01-18,CR800818027340/RMCPL09506/0,,2018-01-18,1000.0,,-537475578.3900006,.
409000438620',2018-01-18,CR800818027440/RMCPL10418/0,,2018-01-18,5000.0,,-537480578.3900006,.
409000438620',2018-01-18,CR800813863527/RMCPL15874/0,,2018-01-18,210.0,,-537480788.3900006,.
409000438620',2018-01-18,CR800816949614/RMCPL18123/0,,2018-01-18,3000.0,,-537483788.3900006,.
409000438620',2018-01-18,CR800813863626/RMCPL20622/0,,2018-01-18,3000.0,,-537486788.3900006,.
409000438620',2018-01-18,CR800816949701/RMCPL11120/0,,2018-01-18,1500.0,,-537488288.3900006,.
409000438620',2018-01-18,CR800816949521/RMCPL18950/0,,2018-01-18,3000.0,,-537491288.3900006,.
409000438620',2018-01-18,CR800816949630/RMCPL21584/0,,2018-01-18,500.0,,-537491788.3900006,.
409000438620',2018-01-18,CR800813863511/RMCPL14780/0,,2018-01-18,4000.0,,-537495788.3900006,.
409000438620',2018-01-18,CR800813863500/RMCPL16197/0,,2018-01-18,10000.0,,-537505788.3900006,.
409000438620',2018-01-18,CR800812794934/RMCPL18725/0,,2018-01-18,100.0,,-537505888.3900006,.
409000438620',2018-01-18,CR800816949733/RMCPL18092/0,,2018-01-18,1000.0,,-537506888.3900006,.
409000438620',2018-01-18,CR800818027539/RMCPL12720/0,,2018-01-18,10000.0,,-537516888.3900006,.
409000438620',2018-01-18,CR800818027297/RMCPL09664/0,,2018-01-18,5000.0,,-537521888.3900006,.
409000438620',2018-01-18,CR800813863432/RMCPL19235/0,,2018-01-18,1000.0,,-537522888.3900006,.
409000438620',2018-01-18,CR800818027331/RMCPL14614/0,,2018-01-18,1500.0,,-537524388.3900006,.
409000438620',2018-01-18,CR800813863585/RMCPL19075/0,,2018-01-18,4000.0,,-537528388.3900006,.
409000438620',2018-01-18,CR800812794918/RMCPL17914/0,,2018-01-18,500.0,,-537528888.3900006,.
409000438620',2018-01-18,CR800818027452/RMCPL11945/0,,2018-01-18,1000.0,,-537529888.3900006,.
409000438620',2018-01-18,CR800818027464/RMCPL17589/0,,2018-01-18,3000.0,,-537532888.3900006,.
409000438620',2018-01-18,CR800813863353/RMCPL14458/0,,2018-01-18,5000.0,,-537537888.3900006,.
409000438620',2018-01-18,CR800818027303/RMCPL21709/0,,2018-01-18,3000.0,,-537540888.3900006,.
409000438620',2018-01-18,CR800816949736/RMCPL18313/0,,2018-01-18,2000.0,,-537542888.3900006,.
409000438620',2018-01-18,CR800813863232/RMCPL20360/0,,2018-01-18,6000.0,,-537548888.3900006,.
409000438620',2018-01-18,CR800813863369/RMCPL21470/0,,2018-01-18,500.0,,-537549388.3900006,.
409000438620',2018-01-18,CR800816949553/RMCPL13846/0,,2018-01-18,500.0,,-537549888.3900006,.
409000438620',2018-01-18,CR800813863298/RMCPL09987/0,,2018-01-18,10000.0,,-537559888.3900006,.
409000438620',2018-01-18,CR800813863510/RMCPL13062/0,,2018-01-18,2010.0,,-537561898.3900006,.
409000438620',2018-01-18,CR800818027366/RMCPL19812/0,,2018-01-18,1000.0,,-537562898.3900006,.
409000438620',2018-01-18,CR800813863461/RMCPL18011/0,,2018-01-18,500.0,,-537563398.3900006,.
409000438620',2018-01-18,CR800816949577/RMCPL12312/0,,2018-01-18,2220.0,,-537565618.3900006,.
409000438620',2018-01-18,CR800812794953/RMCPL22314/0,,2018-01-18,500.0,,-537566118.3900006,.
409000438620',2018-01-18,CR800816949711/RMCPL13751/0,,2018-01-18,2000.0,,-537568118.3900006,.
409000438620',2018-01-18,CR800816949811/RMCPL16974/0,,2018-01-18,2500.0,,-537570618.3900006,.
409000438620',2018-01-18,CR800917577035/RMCPL19907/0,,2018-01-18,2500.0,,-537573118.3900006,.
409000438620',2018-01-18,CR800912368151/RMCPL19054/0,,2018-01-18,1500.0,,-537574618.3900006,.
409000438620',2018-01-18,CR800913417921/RMCPL06680/0,,2018-01-18,500.0,,-537575118.3900006,.
409000438620',2018-01-18,CR800913417833/RMCPL22663/0,,2018-01-18,1500.0,,-537576618.3900006,.
409000438620',2018-01-18,CR800912368273/RMCPL13573/0,,2018-01-18,2000.0,,-537578618.3900006,.
409000438620',2018-01-18,CR800913417957/RMCPL20432/0,,2018-01-18,3000.0,,-537581618.3900006,.
409000438620',2018-01-18,CR800917577092/RMCPL19531/0,,2018-01-18,2000.0,,-537583618.3900006,.
409000438620',2018-01-18,CR800913417992/RMCPL14561/0,,2018-01-18,2000.0,,-537585618.3900006,.
409000438620',2018-01-18,CR800912368252/RMCPL20141/0,,2018-01-18,3000.0,,-537588618.3900006,.
409000438620',2018-01-18,CR800918624004/RMCPL13504/0,,2018-01-18,520.0,,-537589138.3900006,.
409000438620',2018-01-18,CR800913417844/RMCPL18011/0,,2018-01-18,6000.0,,-537595138.3900006,.
409000438620',2018-01-18,CR800917577044/RMCPL16831/0,,2018-01-18,2500.0,,-537597638.3900006,.
409000438620',2018-01-18,CR800917577163/RMCPL15068/0,,2018-01-18,500.0,,-537598138.3900006,.
409000438620',2018-01-18,CR800917577126/RMCPL00886/0,,2018-01-18,4750.0,,-537602888.3900006,.
409000438620',2018-01-18,CR800918623885/RMCPL16831/0,,2018-01-18,5000.0,,-537607888.3900006,.
409000438620',2018-01-18,CR800912368114/RMCPL16915/0,,2018-01-18,1500.0,,-537609388.3900006,.
409000438620',2018-01-18,TRF TO  Indiaforensic SERVICES I,,2018-01-18,5000000.0,,-542609388.3900006,.
409000438620',2018-01-18,TRF TO  Indiaforensic SERVICES I,,2018-01-18,3000000.0,,-545609388.3900006,.
409000438620',2018-01-18,TRF TO  Indiaforensic SERVICES I,,2018-01-18,500000.0,,-546109388.3900006,.
409000438620',2018-01-19,Indiaforensic AEPS NPCI WDL SET,,2018-01-19,,52569402.0,-493539986.3900006,.
409000438620',2018-01-19,Indiaforensic AEPS NPCI DEP SET,,2018-01-19,42847886.0,,-536387872.3900006,.
409000438620',2018-01-19,AEPS ACQUIRING ADJ FEES 1,,2018-01-19,14.75,,-536387887.1400006,.
409000438620',2018-01-19,GF735313581670/RMCPL19124/1,,2018-01-19,8000.0,,-536395887.1400006,.
409000438620',2018-01-19,AEPS ACQ REP ADJ FEES 180,,2018-01-19,,20.65,-536395866.4900006,.
409000438620',2018-01-19,AEPS ACQ GFREP ADJ FEES 1,,2018-01-19,,17.7,-536395848.7900006,.
409000438620',2018-01-19,AEPS Indiaforensic INCOME 180118,,2018-01-19,,233288.65,-536162560.14000064,.
409000438620',2018-01-19,AEPS Indiaforensic GST 180118,,2018-01-19,,41991.96,-536120568.18000066,.
409000438620',2018-01-19,TRF TO  Indiaforensic SERVICES I,,2018-01-19,10000000.0,,-546120568.1800007,.
409000438620',2018-01-19,AEPS Indiaforensic INCOME 080118,,2018-01-19,,13.0,-546120555.1800007,.
409000438620',2018-01-19,AEPS Indiaforensic GST 080118,,2018-01-19,,2.34,-546120552.8400006,.
409000438620',2018-01-20,Indiaforensic AEPS NPCI WDL SET,,2018-01-20,,50722252.0,-495398300.8400006,.
409000438620',2018-01-20,Indiaforensic AEPS NPCI DEP SET,,2018-01-20,41772514.0,,-537170814.8400006,.
409000438620',2018-01-20,AEPS ACQUIRING ADJ FEES 1,,2018-01-20,64.9,,-537170879.7400006,.
409000438620',2018-01-20,AEPS ACQ REP ADJ FEES 190,,2018-01-20,,70.86,-537170808.8800006,.
409000438620',2018-01-20,AEPS Indiaforensic INCOME 190118,,2018-01-20,,226773.47,-536944035.4100006,.
409000438620',2018-01-20,AEPS Indiaforensic GST 190118,,2018-01-20,,40819.22,-536903216.1900005,.
409000438620',2018-01-20,TRF TO  Indiaforensic SERVICES I,,2018-01-20,2000000.0,,-538903216.1900005,.
409000438620',2018-01-20,TRF TO  Indiaforensic SERVICES I,,2018-01-20,5000000.0,,-543903216.1900005,.
409000438620',2018-01-20,TRF TO  Indiaforensic SERVICES I,,2018-01-20,2000000.0,,-545903216.1900005,.
409000438620',2018-01-22,Indiaforensic AEPS NPCI WDL SET,,2018-01-22,,48774494.0,-497128722.19000053,.
409000438620',2018-01-22,Indiaforensic AEPS NPCI WDL SET,,2018-01-22,,34183203.0,-462945519.19000053,.
409000438620',2018-01-22,Indiaforensic AEPS NPCI DEP SET,,2018-01-22,40836701.0,,-503782220.19000053,.
409000438620',2018-01-22,Indiaforensic AEPS NPCI DEP SET,,2018-01-22,29511122.0,,-533293342.19000053,.
409000438620',2018-01-22,AEPS ACQUIRING ADJ FEES 2,,2018-01-22,17.7,,-533293359.8900005,.
409000438620',2018-01-22,AEPS Indiaforensic INCOME 200118,,2018-01-22,,220405.82,-533072954.0700005,.
409000438620',2018-01-22,AEPS Indiaforensic GST 200118,,2018-01-22,,39673.05,-533033281.0200005,.
409000438620',2018-01-22,AEPS Indiaforensic INCOME 210118,,2018-01-22,,162151.51,-532871129.5100005,.
409000438620',2018-01-22,AEPS Indiaforensic GST 210118,,2018-01-22,,29187.27,-532841942.24000055,.
409000438620',2018-01-22,TRF TO  Indiaforensic SERVICES I,,2018-01-22,13000000.0,,-545841942.2400005,.
409000438620',2018-01-23,Indiaforensic AEPS NPCI WDL SET,,2018-01-23,,43031762.0,-502810180.2400005,.
409000438620',2018-01-23,AEPS ACQ REP ADJ FEES 220,,2018-01-23,,17.7,-502810162.5400005,.
409000438620',2018-01-23,AEPS Indiaforensic INCOME 220118,,2018-01-23,,197800.45,-502612362.0900005,.
409000438620',2018-01-23,AEPS Indiaforensic GST 220118,,2018-01-23,,35604.08,-502576758.0100005,.
409000438620',2018-01-23,Indiaforensic AEPS NPCI DEP SET,,2018-01-23,36287349.0,,-538864107.0100005,.
409000438620',2018-01-23,TRF TO  Indiaforensic SERVICES I,,2018-01-23,7400000.0,,-546264107.0100005,.
409000438620',2018-01-24,Indiaforensic AEPS NPCI WDL SET,,2018-01-24,,47422584.0,-498841523.01000047,.
409000438620',2018-01-24,CB800213216840/RMCPL17770/0,,2018-01-24,1000.0,,-498842523.01000047,.
409000438620',2018-01-24,CB800214256881/RMCPL11061/0,,2018-01-24,700.0,,-498843223.01000047,.
409000438620',2018-01-24,CB800214256883/RMCPL17350/0,,2018-01-24,2000.0,,-498845223.01000047,.
409000438620',2018-01-24,CB800214256911/RMCPL17121/0,,2018-01-24,10000.0,,-498855223.01000047,.
409000438620',2018-01-24,CB800214256933/RMCPL19308/0,,2018-01-24,1000.0,,-498856223.01000047,.
409000438620',2018-01-24,CB800214256960/RMCPL18042/0,,2018-01-24,10000.0,,-498866223.01000047,.
409000438620',2018-01-24,CB800214256961/RMCPL02803/0,,2018-01-24,500.0,,-498866723.01000047,.
409000438620',2018-01-24,CB800214257010/RMCPL15491/0,,2018-01-24,3000.0,,-498869723.01000047,.
409000438620',2018-01-24,CB800214258780/RMCPL16185/0,,2018-01-24,3000.0,,-498872723.01000047,.
409000438620',2018-01-24,CB800214259674/RMCPL20654/0,,2018-01-24,10000.0,,-498882723.01000047,.
409000438620',2018-01-24,CB800214259715/RMCPL18878/0,,2018-01-24,1500.0,,-498884223.01000047,.
409000438620',2018-01-24,CB800215262979/RMCPL18637/0,,2018-01-24,10000.0,,-498894223.01000047,.
409000438620',2018-01-24,CB800215263134/RMCPL18377/0,,2018-01-24,1000.0,,-498895223.01000047,.
409000438620',2018-01-24,CB800215263238/RMCPL15322/0,,2018-01-24,1000.0,,-498896223.01000047,.
409000438620',2018-01-24,CB800215263328/RMCPL15323/0,,2018-01-24,6500.0,,-498902723.01000047,.
409000438620',2018-01-24,CB800216329069/RMCPL14673/0,,2018-01-24,3000.0,,-498905723.01000047,.
409000438620',2018-01-24,CB800312835195/RMCPL18014/0,,2018-01-24,500.0,,-498906223.01000047,.
409000438620',2018-01-24,CB800312836743/RMCPL22215/0,,2018-01-24,1000.0,,-498907223.01000047,.
409000438620',2018-01-24,CB800312836810/RMCPL16122/0,,2018-01-24,500.0,,-498907723.01000047,.
409000438620',2018-01-24,CB800213216688/RMCPL17806/0,,2018-01-24,1000.0,,-498908723.01000047,.
409000438620',2018-01-24,CB800214258728/RMCPL22133/0,,2018-01-24,5000.0,,-498913723.01000047,.
409000438620',2018-01-24,CB800216339331/RMCPL22247/0,,2018-01-24,1000.0,,-498914723.01000047,.
409000438620',2018-01-24,CB800216339055/RMCPL15468/0,,2018-01-24,4000.0,,-498918723.01000047,.
409000438620',2018-01-24,CB800216339102/RMCPL21341/0,,2018-01-24,1000.0,,-498919723.01000047,.
409000438620',2018-01-24,CB800214258602/RMCPL13088/0,,2018-01-24,9500.0,,-498929223.01000047,.
409000438620',2018-01-24,CB800415517939/RMCPL18956/0,,2018-01-24,1000.0,,-498930223.01000047,.
409000438620',2018-01-24,CB800917586577/RMCPL20275/0,,2018-01-24,4000.0,,-498934223.01000047,.
409000438620',2018-01-24,CB800917586796/RMCPL07077/0,,2018-01-24,600.0,,-498934823.01000047,.
409000438620',2018-01-24,CB800917587120/RMCPL11063/0,,2018-01-24,1000.0,,-498935823.01000047,.
409000438620',2018-01-24,CB800917587355/RMCPL15258/0,,2018-01-24,2000.0,,-498937823.01000047,.
409000438620',2018-01-24,CB800917587389/RMCPL22241/0,,2018-01-24,500.0,,-498938323.01000047,.
409000438620',2018-01-24,CB800917587544/RMCPL17567/0,,2018-01-24,1000.0,,-498939323.01000047,.
409000438620',2018-01-24,CB800912367639/RMCPL13006/0,,2018-01-24,1000.0,,-498940323.01000047,.
409000438620',2018-01-24,CB801113655921/RMCPL22792/1,,2018-01-24,3000.0,,-498943323.01000047,.
409000438620',2018-01-24,CB801113644203/RMCPL09843/1,,2018-01-24,3000.0,,-498946323.01000047,.
409000438620',2018-01-24,CB801113644265/RMCPL18177/1,,2018-01-24,3000.0,,-498949323.01000047,.
409000438620',2018-01-24,CB801113644267/RMCPL12008/1,,2018-01-24,500.0,,-498949823.01000047,.
409000438620',2018-01-24,CB801113644887/RMCPL20608/1,,2018-01-24,500.0,,-498950323.01000047,.
409000438620',2018-01-24,CB801113645943/RMCPL10937/1,,2018-01-24,2000.0,,-498952323.01000047,.
409000438620',2018-01-24,CB801113645946/RMCPL17459/1,,2018-01-24,1250.0,,-498953573.01000047,.
409000438620',2018-01-24,CB801110513587/RMCPL12036/1,,2018-01-24,2000.0,,-498955573.01000047,.
409000438620',2018-01-24,CB800813863439/RMCPL13059/0,,2018-01-24,2000.0,,-498957573.01000047,.
409000438620',2018-01-24,CB801008851314/RMCPL20927/1,,2018-01-24,10000.0,,-498967573.01000047,.
409000438620',2018-01-24,CB800813863512/RMCPL20970/0,,2018-01-24,10000.0,,-498977573.01000047,.
409000438620',2018-01-24,CB801016147863/RMCPL20131/1,,2018-01-24,7500.0,,-498985073.01000047,.
409000438620',2018-01-24,CB801110513616/RMCPL00150/1,,2018-01-24,2000.0,,-498987073.01000047,.
409000438620',2018-01-24,CB801113649121/RMCPL15427/1,,2018-01-24,2000.0,,-498989073.01000047,.
409000438620',2018-01-24,CB801512835743/RMCPL18667/1,,2018-01-24,9000.0,,-498998073.01000047,.
409000438620',2018-01-24,Indiaforensic AEPS NPCI DEP SET,,2018-01-24,39930474.0,,-538928547.0100005,.
409000438620',2018-01-24,AEPS ACQUIRING ADJ FEES 2,,2018-01-24,35.4,,-538928582.4100004,.
409000438620',2018-01-24,AEPS Indiaforensic INCOME 230118,,2018-01-24,,216245.13,-538712337.2800004,.
409000438620',2018-01-24,AEPS Indiaforensic GST 230118,,2018-01-24,,38924.12,-538673413.1600004,.
409000438620',2018-01-24,TRF TO  Indiaforensic SERVICES I,,2018-01-24,7400000.0,,-546073413.1600004,.
409000438620',2018-01-25,Indiaforensic AEPS NPCI WDL SET,,2018-01-25,,46775650.0,-499297763.16000044,.
409000438620',2018-01-25,Indiaforensic AEPS NPCI DEP SET,,2018-01-25,38869017.0,,-538166780.1600004,.
409000438620',2018-01-25,AEPS INCOME REV 010417-25,,2018-01-25,1269094.36,,-539435874.5200005,.
409000438620',2018-01-25,AEPS ACQUIRING ADJ FEES 2,,2018-01-25,11.8,,-539435886.3200004,.
409000438620',2018-01-25,AEPS Indiaforensic INCOME 240118,,2018-01-25,,211453.27,-539224433.0500004,.
409000438620',2018-01-25,AEPS Indiaforensic GST 240118,,2018-01-25,,38061.59,-539186371.4600004,.
409000438620',2018-01-25,TRF TO  Indiaforensic SERVICES I,,2018-01-25,5000000.0,,-544186371.4600004,.
409000438620',2018-01-25,TRF TO  Indiaforensic SERVICES I,,2018-01-25,2000000.0,,-546186371.4600004,.
409000438620',2018-01-29,Indiaforensic AEPS NPCI WDL SET,,2018-01-29,,50378654.0,-495807717.4600004,.
409000438620',2018-01-29,Indiaforensic AEPS NPCI WDL SET,,2018-01-29,,30452545.0,-465355172.4600004,.
409000438620',2018-01-29,Indiaforensic AEPS NPCI DEP SET,,2018-01-29,41299200.0,,-506654372.4600004,.
409000438620',2018-01-29,Indiaforensic AEPS NPCI DEP SET,,2018-01-29,26648563.0,,-533302935.4600004,.
409000438620',2018-01-29,Indiaforensic AEPS NPCI WDL SET,,2018-01-29,,37976662.0,-495326273.4600004,.
409000438620',2018-01-29,Indiaforensic AEPS NPCI WDL SET,,2018-01-29,,23114189.0,-472212084.4600004,.
409000438620',2018-01-29,Indiaforensic AEPS NPCI DEP SET,,2018-01-29,30889112.0,,-503101196.4600004,.
409000438620',2018-01-29,Indiaforensic AEPS NPCI DEP SET,,2018-01-29,24328046.0,,-527429242.4600004,.
409000438620',2018-01-29,AEPS ACQ REP ADJ FEES 250,,2018-01-29,,35.4,-527429207.0600004,.
409000438620',2018-01-29,AEPS Indiaforensic INCOME 250118,,2018-01-29,,225909.03,-527203298.03000045,.
409000438620',2018-01-29,AEPS Indiaforensic GST 250118,,2018-01-29,,40663.63,-527162634.40000045,.
409000438620',2018-01-29,AEPS Indiaforensic INCOME 260118,,2018-01-29,,143806.38,-527018828.02000046,.
409000438620',2018-01-29,AEPS Indiaforensic GST 260118,,2018-01-29,,25885.15,-526992942.8700005,.
409000438620',2018-01-29,AEPS Indiaforensic INCOME 270118,,2018-01-29,,171645.23,-526821297.64000046,.
409000438620',2018-01-29,AEPS Indiaforensic GST 270118,,2018-01-29,,30896.14,-526790401.5000005,.
409000438620',2018-01-29,AEPS Indiaforensic INCOME 280118,,2018-01-29,,117507.06,-526672894.4400005,.
409000438620',2018-01-29,AEPS Indiaforensic GST 280118,,2018-01-29,,21151.27,-526651743.1700005,.
409000438620',2018-01-29,TRF TO  Indiaforensic SERVICES I,,2018-01-29,5800000.0,,-532451743.1700005,.
409000438620',2018-01-29,TRF TO  Indiaforensic SERVICES I,,2018-01-29,13000000.0,,-545451743.1700006,.
409000438620',2018-01-30,Indiaforensic AEPS NPCI WDL SET,,2018-01-30,,50599453.0,-494852290.17000055,.
409000438620',2018-01-30,Indiaforensic AEPS NPCI DEP SET,,2018-01-30,41083035.0,,-535935325.17000055,.
409000438620',2018-01-30,AEPS ACQUIRING ADJ FEES 2,,2018-01-30,17.7,,-535935342.87000054,.
409000438620',2018-01-30,AEPS ACQ REP ADJ FEES 290,,2018-01-30,,11.8,-535935331.0700005,.
409000438620',2018-01-30,AEPS Indiaforensic INCOME 290118,,2018-01-30,,225286.26,-535710044.81000054,.
409000438620',2018-01-30,AEPS Indiaforensic GST 290118,,2018-01-30,,40551.53,-535669493.28000057,.
409000438620',2018-01-30,TRF TO  Indiaforensic SERVICES I,,2018-01-30,10500000.0,,-546169493.2800006,.
409000438620',2018-01-31,Indiaforensic AEPS NPCI WDL SET,,2018-01-31,,55267077.0,-490902416.28000057,.
409000438620',2018-01-31,Indiaforensic AEPS NPCI DEP SET,,2018-01-31,44806906.0,,-535709322.28000057,.
409000438620',2018-01-31,AEPS ACQUIRING ADJ FEES 3,,2018-01-31,53.1,,-535709375.3800006,.
409000438620',2018-01-31,AEPS ACQ CR ADJ FEES 3001,,2018-01-31,1811.46,,-535711186.84000057,.
409000438620',2018-01-31,CR801912100937/RMCPL21437/1,,2018-01-31,5000.0,,-535716186.84000057,.
409000438620',2018-01-31,CR801915228935/RMCPL12219/1,,2018-01-31,1000.0,,-535717186.84000057,.
409000438620',2018-01-31,CR801915228817/RMCPL13552/1,,2018-01-31,3000.0,,-535720186.84000057,.
409000438620',2018-01-31,CR801712002062/RMCPL18168/1,,2018-01-31,1000.0,,-535721186.84000057,.
409000438620',2018-01-31,CR801712002275/RMCPL17681/1,,2018-01-31,7000.0,,-535728186.84000057,.
409000438620',2018-01-31,CR801712002278/RMCPL21219/1,,2018-01-31,500.0,,-535728686.84000057,.
409000438620',2018-01-31,CR801712002435/RMCPL19869/1,,2018-01-31,1000.0,,-535729686.84000057,.
409000438620',2018-01-31,CR801712001934/RMCPL18480/1,,2018-01-31,2000.0,,-535731686.84000057,.
409000438620',2018-01-31,CR801712001848/RMCPL20329/1,,2018-01-31,500.0,,-535732186.84000057,.
409000438620',2018-01-31,CR801712002110/RMCPL21432/1,,2018-01-31,500.0,,-535732686.84000057,.
409000438620',2018-01-31,CR801712002277/RMCPL12527/1,,2018-01-31,1000.0,,-535733686.84000057,.
409000438620',2018-01-31,CR801712002911/RMCPL12225/1,,2018-01-31,10000.0,,-535743686.84000057,.
409000438620',2018-01-31,CR801712002994/RMCPL21953/1,,2018-01-31,1000.0,,-535744686.84000057,.
409000438620',2018-01-31,CR801712002844/RMCPL16950/1,,2018-01-31,5000.0,,-535749686.84000057,.
409000438620',2018-01-31,CR801712001331/RMCPL14560/1,,2018-01-31,1000.0,,-535750686.84000057,.
409000438620',2018-01-31,CR801712001652/RMCPL21953/1,,2018-01-31,1000.0,,-535751686.84000057,.
409000438620',2018-01-31,CR801712001315/RMCPL16538/1,,2018-01-31,1500.0,,-535753186.84000057,.
409000438620',2018-01-31,CR801712002695/RMCPL22193/1,,2018-01-31,2500.0,,-535755686.84000057,.
409000438620',2018-01-31,CR801712002282/RMCPL17200/1,,2018-01-31,1000.0,,-535756686.84000057,.
409000438620',2018-01-31,CR801712002120/RMCPL20482/1,,2018-01-31,3000.0,,-535759686.84000057,.
409000438620',2018-01-31,CR801712002760/RMCPL14662/1,,2018-01-31,1000.0,,-535760686.84000057,.
409000438620',2018-01-31,CR801712001777/RMCPL19605/1,,2018-01-31,3000.0,,-535763686.84000057,.
409000438620',2018-01-31,CR801712002656/RMCPL17049/1,,2018-01-31,1000.0,,-535764686.84000057,.
409000438620',2018-01-31,CR801712000928/RMCPL13609/1,,2018-01-31,1000.0,,-535765686.84000057,.
409000438620',2018-01-31,CR801712001677/RMCPL18408/1,,2018-01-31,1000.0,,-535766686.84000057,.
409000438620',2018-01-31,CR801509739690/RMCPL12371/1,,2018-01-31,500.0,,-535767186.84000057,.
409000438620',2018-01-31,CR801509739087/RMCPL11776/1,,2018-01-31,500.0,,-535767686.84000057,.
409000438620',2018-01-31,CR801509738859/RMCPL19438/1,,2018-01-31,3000.0,,-535770686.84000057,.
409000438620',2018-01-31,CR801316974180/RMCPL11592/1,,2018-01-31,1500.0,,-535772186.84000057,.
409000438620',2018-01-31,CR801316974172/RMCPL15869/1,,2018-01-31,1500.0,,-535773686.84000057,.
409000438620',2018-01-31,CR801213256766/RMCPL21691/1,,2018-01-31,2040.0,,-535775726.84000057,.
409000438620',2018-01-31,CR801213257044/RMCPL10426/1,,2018-01-31,1000.0,,-535776726.84000057,.
409000438620',2018-01-31,CR801213256854/RMCPL19298/1,,2018-01-31,1000.0,,-535777726.84000057,.
409000438620',2018-01-31,CR801213256778/RMCPL16467/1,,2018-01-31,1000.0,,-535778726.84000057,.
409000438620',2018-01-31,CR801213251539/RMCPL21229/1,,2018-01-31,3000.0,,-535781726.84000057,.
409000438620',2018-01-31,CR801211170302/RMCPL13751/1,,2018-01-31,3000.0,,-535784726.84000057,.
409000438620',2018-01-31,CR801211170298/RMCPL17758/1,,2018-01-31,3000.0,,-535787726.84000057,.
409000438620',2018-01-31,CR801213257033/RMCPL21016/1,,2018-01-31,1000.0,,-535788726.84000057,.
409000438620',2018-01-31,CR801213257036/RMCPL22931/1,,2018-01-31,4000.0,,-535792726.84000057,.
409000438620',2018-01-31,CR801213256727/RMCPL22510/1,,2018-01-31,3000.0,,-535795726.84000057,.
409000438620',2018-01-31,CR801213256898/RMCPL13062/1,,2018-01-31,2000.0,,-535797726.84000057,.
409000438620',2018-01-31,CR801213256973/RMCPL21242/1,,2018-01-31,138.0,,-535797864.84000057,.
409000438620',2018-01-31,CR801212236140/RMCPL15880/1,,2018-01-31,2000.0,,-535799864.84000057,.
409000438620',2018-01-31,CR801213256845/RMCPL15549/1,,2018-01-31,1500.0,,-535801364.84000057,.
409000438620',2018-01-31,CR801213257115/RMCPL22386/1,,2018-01-31,500.0,,-535801864.84000057,.
409000438620',2018-01-31,CR801213256702/RMCPL19942/1,,2018-01-31,1000.0,,-535802864.84000057,.
409000438620',2018-01-31,CR801210137032/RMCPL14707/1,,2018-01-31,2500.0,,-535805364.84000057,.
409000438620',2018-01-31,CR801110509721/RMCPL22129/1,,2018-01-31,4000.0,,-535809364.84000057,.
409000438620',2018-01-31,CR801113641078/RMCPL19840/1,,2018-01-31,500.0,,-535809864.84000057,.
409000438620',2018-01-31,CR801112604850/RMCPL09188/1,,2018-01-31,7000.0,,-535816864.84000057,.
409000438620',2018-01-31,CR801110513591/RMCPL18521/1,,2018-01-31,500.0,,-535817364.84000057,.
409000438620',2018-01-31,CR801110509748/RMCPL17432/1,,2018-01-31,1000.0,,-535818364.84000057,.
409000438620',2018-01-31,CR801110518183/RMCPL19137/1,,2018-01-31,3000.0,,-535821364.84000057,.
409000438620',2018-01-31,CR801112604712/RMCPL16117/1,,2018-01-31,1000.0,,-535822364.84000057,.
409000438620',2018-01-31,CR801113640793/RMCPL13499/1,,2018-01-31,2500.0,,-535824864.84000057,.
409000438620',2018-01-31,CR801112607766/RMCPL22314/1,,2018-01-31,10000.0,,-535834864.84000057,.
409000438620',2018-01-31,CR801110509685/RMCPL18422/1,,2018-01-31,500.0,,-535835364.84000057,.
409000438620',2018-01-31,CR801110518036/RMCPL22068/1,,2018-01-31,2000.0,,-535837364.84000057,.
409000438620',2018-01-31,CR801110513475/RMCPL13088/1,,2018-01-31,1000.0,,-535838364.84000057,.
409000438620',2018-01-31,CR801110518120/RMCPL14211/1,,2018-01-31,1500.0,,-535839864.84000057,.
409000438620',2018-01-31,CR801113644788/RMCPL18637/1,,2018-01-31,1000.0,,-535840864.84000057,.
409000438620',2018-01-31,CR801112604881/RMCPL12818/1,,2018-01-31,2000.0,,-535842864.84000057,.
409000438620',2018-01-31,CR801110509677/RMCPL16865/1,,2018-01-31,500.0,,-535843364.84000057,.
409000438620',2018-01-31,CR801114716330/RMCPL17808/1,,2018-01-31,500.0,,-535843864.84000057,.
409000438620',2018-01-31,CR801110509746/RMCPL21709/1,,2018-01-31,3000.0,,-535846864.84000057,.
409000438620',2018-01-31,CR801110509831/RMCPL18656/1,,2018-01-31,3000.0,,-535849864.84000057,.
409000438620',2018-01-31,CR801113643401/RMCPL19218/1,,2018-01-31,1000.0,,-535850864.84000057,.
409000438620',2018-01-31,CR801113640747/RMCPL22092/1,,2018-01-31,500.0,,-535851364.84000057,.
409000438620',2018-01-31,CR801112607814/RMCPL17641/1,,2018-01-31,510.0,,-535851874.84000057,.
409000438620',2018-01-31,CR801110513406/RMCPL21030/1,,2018-01-31,500.0,,-535852374.84000057,.
409000438620',2018-01-31,CR801112604733/RMCPL18443/1,,2018-01-31,5000.0,,-535857374.84000057,.
409000438620',2018-01-31,CR801110517914/RMCPL13091/1,,2018-01-31,1540.0,,-535858914.84000057,.
409000438620',2018-01-31,CR801110518105/RMCPL21653/1,,2018-01-31,500.0,,-535859414.84000057,.
409000438620',2018-01-31,CR801110513615/RMCPL15079/1,,2018-01-31,10000.0,,-535869414.84000057,.
409000438620',2018-01-31,CR801110517974/RMCPL14977/1,,2018-01-31,2000.0,,-535871414.84000057,.
409000438620',2018-01-31,CR801110513409/RMCPL19979/1,,2018-01-31,5000.0,,-535876414.84000057,.
409000438620',2018-01-31,CR801113644517/RMCPL22007/1,,2018-01-31,1000.0,,-535877414.84000057,.
409000438620',2018-01-31,CR801110509794/RMCPL13639/1,,2018-01-31,2500.0,,-535879914.84000057,.
409000438620',2018-01-31,CR801113645990/RMCPL13859/1,,2018-01-31,1000.0,,-535880914.84000057,.
409000438620',2018-01-31,CR801113650931/RMCPL22042/1,,2018-01-31,500.0,,-535881414.84000057,.
409000438620',2018-01-31,CR801110509650/RMCPL15049/1,,2018-01-31,10000.0,,-535891414.84000057,.
409000438620',2018-01-31,CR801110518050/RMCPL18702/1,,2018-01-31,2000.0,,-535893414.84000057,.
409000438620',2018-01-31,CR801110518248/RMCPL17250/1,,2018-01-31,10000.0,,-535903414.84000057,.
409000438620',2018-01-31,CR801110513745/RMCPL15468/1,,2018-01-31,3000.0,,-535906414.84000057,.
409000438620',2018-01-31,CR801112604861/RMCPL19413/1,,2018-01-31,10000.0,,-535916414.84000057,.
409000438620',2018-01-31,CR801112604895/RMCPL20318/1,,2018-01-31,1000.0,,-535917414.84000057,.
409000438620',2018-01-31,CR801110518042/RMCPL18708/1,,2018-01-31,1000.0,,-535918414.84000057,.
409000438620',2018-01-31,CR801112604590/RMCPL12734/1,,2018-01-31,2500.0,,-535920914.84000057,.
409000438620',2018-01-31,CR801113640734/RMCPL14040/1,,2018-01-31,8000.0,,-535928914.84000057,.
409000438620',2018-01-31,CR801110509608/RMCPL10425/1,,2018-01-31,2000.0,,-535930914.84000057,.
409000438620',2018-01-31,CR801110518014/RMCPL15464/1,,2018-01-31,1000.0,,-535931914.84000057,.
409000438620',2018-01-31,CR801112607896/RMCPL15580/1,,2018-01-31,1500.0,,-535933414.84000057,.
409000438620',2018-01-31,CR801114716334/RMCPL15740/1,,2018-01-31,500.0,,-535933914.84000057,.
409000438620',2018-01-31,CR801113646044/RMCPL22950/1,,2018-01-31,2000.0,,-535935914.84000057,.
409000438620',2018-01-31,CR801110513742/RMCPL21300/1,,2018-01-31,1500.0,,-535937414.84000057,.
409000438620',2018-01-31,CR801112604718/RMCPL14828/1,,2018-01-31,1000.0,,-535938414.84000057,.
409000438620',2018-01-31,CR801112604837/RMCPL09797/1,,2018-01-31,1000.0,,-535939414.84000057,.
409000438620',2018-01-31,CR801112604595/RMCPL20564/1,,2018-01-31,2000.0,,-535941414.84000057,.
409000438620',2018-01-31,CR801110509651/RMCPL13491/1,,2018-01-31,1000.0,,-535942414.84000057,.
409000438620',2018-01-31,CR801110509626/RMCPL21030/1,,2018-01-31,500.0,,-535942914.84000057,.
409000438620',2018-01-31,CR801110513606/RMCPL11504/1,,2018-01-31,3000.0,,-535945914.84000057,.
409000438620',2018-01-31,CR801110518090/RMCPL14967/1,,2018-01-31,1000.0,,-535946914.84000057,.
409000438620',2018-01-31,CR801110513610/RMCPL10689/1,,2018-01-31,10000.0,,-535956914.84000057,.
409000438620',2018-01-31,CR801110513512/RMCPL21933/1,,2018-01-31,500.0,,-535957414.84000057,.
409000438620',2018-01-31,CR801113640995/RMCPL22243/1,,2018-01-31,510.0,,-535957924.84000057,.
409000438620',2018-01-31,CR801113644901/RMCPL14928/1,,2018-01-31,400.0,,-535958324.84000057,.
409000438620',2018-01-31,CR801110509575/RMCPL11999/1,,2018-01-31,500.0,,-535958824.84000057,.
409000438620',2018-01-31,CR801110518001/RMCPL20261/1,,2018-01-31,500.0,,-535959324.84000057,.
409000438620',2018-01-31,CR801113641104/RMCPL09962/1,,2018-01-31,4000.0,,-535963324.84000057,.
409000438620',2018-01-31,CR801008834545/RMCPL14810/1,,2018-01-31,500.0,,-535963824.84000057,.
409000438620',2018-01-31,CR801017190568/RMCPL17123/1,,2018-01-31,700.0,,-535964524.84000057,.
409000438620',2018-01-31,CR801008851402/RMCPL17289/1,,2018-01-31,10000.0,,-535974524.84000057,.
409000438620',2018-01-31,CR801008840745/RMCPL15629/1,,2018-01-31,1000.0,,-535975524.84000057,.
409000438620',2018-01-31,CR801008851437/RMCPL20062/1,,2018-01-31,5000.0,,-535980524.84000057,.
409000438620',2018-01-31,CR801016144401/RMCPL13536/1,,2018-01-31,2000.0,,-535982524.84000057,.
409000438620',2018-01-31,CR801011967300/RMCPL00704/1,,2018-01-31,210.0,,-535982734.84000057,.
409000438620',2018-01-31,CR801008851466/RMCPL16871/1,,2018-01-31,2000.0,,-535984734.84000057,.
409000438620',2018-01-31,CR801008851558/RMCPL20874/1,,2018-01-31,2500.0,,-535987234.84000057,.
409000438620',2018-01-31,CR801008844804/RMCPL03589/1,,2018-01-31,4500.0,,-535991734.84000057,.
409000438620',2018-01-31,CR801017190576/RMCPL21281/1,,2018-01-31,10000.0,,-536001734.84000057,.
409000438620',2018-01-31,CR801017213540/RMCPL17368/1,,2018-01-31,4000.0,,-536005734.84000057,.
409000438620',2018-01-31,CR801016147520/RMCPL13592/1,,2018-01-31,1000.0,,-536006734.84000057,.
409000438620',2018-01-31,CR801016144230/RMCPL09925/1,,2018-01-31,2000.0,,-536008734.84000057,.
409000438620',2018-01-31,CR801008844867/RMCPL18993/1,,2018-01-31,1500.0,,-536010234.84000057,.
409000438620',2018-01-31,CR801008844831/RMCPL17274/1,,2018-01-31,2000.0,,-536012234.84000057,.
409000438620',2018-01-31,CR801018228056/RMCPL22472/1,,2018-01-31,2000.0,,-536014234.84000057,.
409000438620',2018-01-31,CR801008840576/RMCPL11402/1,,2018-01-31,5000.0,,-536019234.84000057,.
409000438620',2018-01-31,CR801018228006/RMCPL21804/1,,2018-01-31,500.0,,-536019734.84000057,.
409000438620',2018-01-31,CR801008844768/RMCPL21872/1,,2018-01-31,1500.0,,-536021234.84000057,.
409000438620',2018-01-31,CR801008851441/RMCPL18587/1,,2018-01-31,500.0,,-536021734.84000057,.
409000438620',2018-01-31,CR801008834564/RMCPL18487/1,,2018-01-31,1350.0,,-536023084.84000057,.
409000438620',2018-01-31,CR801016144359/RMCPL21219/1,,2018-01-31,2000.0,,-536025084.84000057,.
409000438620',2018-01-31,CR801008834438/RMCPL21473/1,,2018-01-31,6000.0,,-536031084.84000057,.
409000438620',2018-01-31,CR801008851457/RMCPL09743/1,,2018-01-31,1000.0,,-536032084.84000057,.
409000438620',2018-01-31,CR801016147810/RMCPL20407/1,,2018-01-31,3000.0,,-536035084.84000057,.
409000438620',2018-01-31,CR801016155536/RMCPL16840/1,,2018-01-31,1010.0,,-536036094.84000057,.
409000438620',2018-01-31,CR801017191769/RMCPL21350/1,,2018-01-31,1000.0,,-536037094.84000057,.
409000438620',2018-01-31,CR801008844718/RMCPL09185/1,,2018-01-31,5500.0,,-536042594.84000057,.
409000438620',2018-01-31,CR801008844791/RMCPL20644/1,,2018-01-31,1500.0,,-536044094.84000057,.
409000438620',2018-01-31,CR801016147683/RMCPL14166/1,,2018-01-31,2220.0,,-536046314.84000057,.
409000438620',2018-01-31,CR801016147500/RMCPL14949/1,,2018-01-31,100.0,,-536046414.84000057,.
409000438620',2018-01-31,CR801017191750/RMCPL12720/1,,2018-01-31,1000.0,,-536047414.84000057,.
409000438620',2018-01-31,CR801008851579/RMCPL09194/1,,2018-01-31,1000.0,,-536048414.84000057,.
409000438620',2018-01-31,CR801008851508/RMCPL14522/1,,2018-01-31,2000.0,,-536050414.84000057,.
409000438620',2018-01-31,CR801008840606/RMCPL15602/1,,2018-01-31,10000.0,,-536060414.84000057,.
409000438620',2018-01-31,CR801008840657/RMCPL15451/1,,2018-01-31,2000.0,,-536062414.84000057,.
409000438620',2018-01-31,CR801017188845/RMCPL16457/1,,2018-01-31,1000.0,,-536063414.84000057,.
409000438620',2018-01-31,CR801017191941/RMCPL17462/1,,2018-01-31,1000.0,,-536064414.84000057,.
409000438620',2018-01-31,CR801016144332/RMCPL19103/1,,2018-01-31,500.0,,-536064914.84000057,.
409000438620',2018-01-31,CR801008844770/RMCPL08013/1,,2018-01-31,5000.0,,-536069914.84000057,.
409000438620',2018-01-31,CR801017190634/RMCPL22549/1,,2018-01-31,3000.0,,-536072914.84000057,.
409000438620',2018-01-31,CR801018228113/RMCPL14487/1,,2018-01-31,3000.0,,-536075914.84000057,.
409000438620',2018-01-31,CR801017190589/RMCPL14710/1,,2018-01-31,500.0,,-536076414.84000057,.
409000438620',2018-01-31,CR801016144360/RMCPL18791/1,,2018-01-31,2000.0,,-536078414.84000057,.
409000438620',2018-01-31,CR801017191947/RMCPL19474/1,,2018-01-31,1000.0,,-536079414.84000057,.
409000438620',2018-01-31,CR801008851635/RMCPL22663/1,,2018-01-31,1000.0,,-536080414.84000057,.
409000438620',2018-01-31,CR801018228170/RMCPL21300/1,,2018-01-31,2000.0,,-536082414.84000057,.
409000438620',2018-01-31,CR801016155526/RMCPL20762/1,,2018-01-31,3000.0,,-536085414.84000057,.
409000438620',2018-01-31,CR801008844849/RMCPL10335/1,,2018-01-31,7000.0,,-536092414.84000057,.
409000438620',2018-01-31,CR801008840482/RMCPL19068/1,,2018-01-31,5000.0,,-536097414.84000057,.
409000438620',2018-01-31,CR801008844885/RMCPL11796/1,,2018-01-31,1000.0,,-536098414.84000057,.
409000438620',2018-01-31,CR801008840788/RMCPL14572/1,,2018-01-31,2000.0,,-536100414.84000057,.
409000438620',2018-01-31,CR801016147848/RMCPL17782/1,,2018-01-31,5000.0,,-536105414.84000057,.
409000438620',2018-01-31,CR801016144189/RMCPL20680/1,,2018-01-31,500.0,,-536105914.84000057,.
409000438620',2018-01-31,CR801008851517/RMCPL22371/1,,2018-01-31,500.0,,-536106414.84000057,.
409000438620',2018-01-31,CR801016155504/RMCPL15491/1,,2018-01-31,3000.0,,-536109414.84000057,.
409000438620',2018-01-31,CR801018228190/RMCPL11402/1,,2018-01-31,1000.0,,-536110414.84000057,.
409000438620',2018-01-31,CR801008851493/RMCPL11752/1,,2018-01-31,800.0,,-536111214.84000057,.
409000438620',2018-01-31,CR801016144375/RMCPL17155/1,,2018-01-31,1000.0,,-536112214.84000057,.
409000438620',2018-01-31,CR801016148645/RMCPL11265/1,,2018-01-31,500.0,,-536112714.84000057,.
409000438620',2018-01-31,CR801016147719/RMCPL17141/1,,2018-01-31,5000.0,,-536117714.84000057,.
409000438620',2018-01-31,AEPS ACQ REP ADJ FEES 300,,2018-01-31,,17.7,-536117697.1400006,.
409000438620',2018-01-31,CR801008851550/RMCPL11241/1,,2018-01-31,6000.0,,-536123697.1400006,.
409000438620',2018-01-31,CR801008840811/RMCPL21797/1,,2018-01-31,3500.0,,-536127197.1400006,.
409000438620',2018-01-31,CR801008840701/RMCPL09932/1,,2018-01-31,3000.0,,-536130197.1400006,.
409000438620',2018-01-31,CR801017191789/RMCPL09788/1,,2018-01-31,10000.0,,-536140197.1400006,.
409000438620',2018-01-31,CR801008840776/RMCPL15649/1,,2018-01-31,2000.0,,-536142197.1400006,.
409000438620',2018-01-31,CR801018228093/RMCPL21079/1,,2018-01-31,3000.0,,-536145197.1400006,.
409000438620',2018-01-31,CR801018228003/RMCPL10418/1,,2018-01-31,1000.0,,-536146197.1400006,.
409000438620',2018-01-31,CR801008844793/RMCPL18020/1,,2018-01-31,500.0,,-536146697.1400006,.
409000438620',2018-01-31,AEPS Indiaforensic INCOME 300118,,2018-01-31,,245798.93,-535900898.2100006,.
409000438620',2018-01-31,AEPS Indiaforensic GST 300118,,2018-01-31,,44243.81,-535856654.4000006,.
409000438620',2018-01-31,TRF TO  Indiaforensic SERVICES I,,2018-01-31,10000000.0,,-545856654.4000006,.
409000438620',2018-02-01,Indiaforensic AEPS NPCI WDL SET,,2018-02-01,,50398191.0,-495458463.4000006,.
409000438620',2018-02-01,Indiaforensic AEPS NPCI DEP SET,,2018-02-01,44036228.0,,-539494691.4000006,.
409000438620',2018-02-01,AEPS ACQUIRING ADJ FEES 3,,2018-02-01,17.7,,-539494709.1000006,.
409000438620',2018-02-01,AEPS ACQ REP ADJ FEES 300,,2018-02-01,,53.1,-539494656.0000006,.
409000438620',2018-02-01,AEPS Indiaforensic INCOME 310118,,2018-02-01,,230421.05,-539264234.9500006,.
409000438620',2018-02-01,AEPS Indiaforensic GST 310118,,2018-02-01,,41475.79,-539222759.1600007,.
409000438620',2018-02-01,TRF TO  Indiaforensic SERVICES I,,2018-02-01,5000000.0,,-544222759.1600007,.
409000438620',2018-02-01,TRF TO  Indiaforensic SERVICES I,,2018-02-01,2000000.0,,-546222759.1600007,.
409000438620',2018-02-02,Indiaforensic AEPS NPCI WDL SET,,2018-02-02,,52178089.0,-494044670.1600007,.
409000438620',2018-02-02,Indiaforensic AEPS NPCI DEP SET,,2018-02-02,30060846.0,,-524105516.1600007,.
409000438620',2018-02-02,AEPS ACQUIRING ADJ FEES 0,,2018-02-02,17.7,,-524105533.86000067,.
409000438620',2018-02-02,AEPS ACQ REP ADJ FEES 010,,2018-02-02,,17.7,-524105516.1600007,.
409000438620',2018-02-02,TRF TO  Indiaforensic SERVICES I,,2018-02-02,15000000.0,,-539105516.1600007,.
409000438620',2018-02-02,TRF TO  Indiaforensic SERVICES I,,2018-02-02,7200000.0,,-546305516.1600007,.
409000438620',2018-02-03,Indiaforensic AEPS NPCI WDL SET,,2018-02-03,,57623175.0,-488682341.1600007,.
409000438620',2018-02-03,Indiaforensic AEPS NPCI DEP SET,,2018-02-03,36407158.0,,-525089499.1600007,.
409000438620',2018-02-03,AEPS ACQUIRING ADJ FEES 0,,2018-02-03,66.08,,-525089565.24000067,.
409000438620',2018-02-03,AEPS ACQ REP ADJ FEES 020,,2018-02-03,,17.7,-525089547.5400007,.
409000438620',2018-02-03,TRF TO  Indiaforensic SERVICES I,,2018-02-03,15000000.0,,-540089547.5400007,.
409000438620',2018-02-03,TRF TO  Indiaforensic SERVICES I,,2018-02-03,3000000.0,,-543089547.5400007,.
409000438620',2018-02-03,TRF TO  Indiaforensic SERVICES I,,2018-02-03,3000000.0,,-546089547.5400007,.
409000438620',2018-02-05,Indiaforensic AEPS NPCI WDL SET,,2018-02-05,,49350092.0,-496739455.5400007,.
409000438620',2018-02-05,Indiaforensic AEPS NPCI WDL SET,,2018-02-05,,31255805.0,-465483650.5400007,.
409000438620',2018-02-05,AEPS ACQUIRING ADJ FEES 0,,2018-02-05,23.6,,-465483674.1400007,.
409000438620',2018-02-05,Indiaforensic AEPS NPCI DEP SET,,2018-02-05,39459689.0,,-504943363.1400007,.
409000438620',2018-02-05,Indiaforensic AEPS NPCI DEP SET,,2018-02-05,27163524.0,,-532106887.1400007,.
409000438620',2018-02-05,TRF TO  Indiaforensic SERVICES I,,2018-02-05,14200000.0,,-546306887.1400007,.
409000438620',2018-02-06,Indiaforensic AEPS NPCI WDL SET,,2018-02-06,,50733603.0,-495573284.1400007,.
409000438620',2018-02-06,AEPS ACQ REP ADJ FEES 050,,2018-02-06,,66.08,-495573218.0600007,.
409000438620',2018-02-06,Indiaforensic AEPS NPCI DEP SET,,2018-02-06,36962313.0,,-532535531.0600007,.
409000438620',2018-02-06,AEPS Indiaforensic INCOME 010218,,2018-02-06,,205553.64,-532329977.42000073,.
409000438620',2018-02-06,AEPS Indiaforensic GST 010218,,2018-02-06,,36999.66,-532292977.7600007,.
409000438620',2018-02-06,AEPS Indiaforensic INCOME 020218,,2018-02-06,,231227.78,-532061749.98000073,.
409000438620',2018-02-06,AEPS Indiaforensic GST 020218,,2018-02-06,,41621.0,-532020128.98000073,.
409000438620',2018-02-06,AEPS Indiaforensic INCOME 030218,,2018-02-06,,216853.19,-531803275.79000074,.
409000438620',2018-02-06,AEPS Indiaforensic GST 030218,,2018-02-06,,39033.57,-531764242.22000074,.
409000438620',2018-02-06,AEPS Indiaforensic INCOME 040218,,2018-02-06,,149285.73,-531614956.4900007,.
409000438620',2018-02-06,AEPS Indiaforensic GST 040218,,2018-02-06,,26871.43,-531588085.0600007,.
409000438620',2018-02-06,AEPS Indiaforensic INCOME 050218,,2018-02-06,,219162.61,-531368922.4500007,.
409000438620',2018-02-06,AEPS Indiaforensic GST 050218,,2018-02-06,,39449.27,-531329473.1800007,.
409000438620',2018-02-06,TRF TO  Indiaforensic SERVICES I,,2018-02-06,14900000.0,,-546229473.1800008,.
409000438620',2018-02-07,Indiaforensic AEPS NPCI WDL SET,,2018-02-07,,51793950.0,-494435523.1800008,.
409000438620',2018-02-07,Indiaforensic AEPS NPCI DEP SET,,2018-02-07,40420893.0,,-534856416.1800008,.
409000438620',2018-02-07,AEPS ACQUIRING ADJ FEES 0,,2018-02-07,2.95,,-534856419.13000077,.
409000438620',2018-02-07,AEPS ACQ REP ADJ FEES 060,,2018-02-07,,23.6,-534856395.53000075,.
409000438620',2018-02-07,AEPS Indiaforensic INCOME 060218,,2018-02-07,,227128.53,-534629267.0000008,.
409000438620',2018-02-07,AEPS Indiaforensic GST 060218,,2018-02-07,,40883.14,-534588383.8600008,.
409000438620',2018-02-07,TRF TO  Indiaforensic SERVICES I,,2018-02-07,11400000.0,,-545988383.8600008,.
409000438620',2018-02-08,Indiaforensic AEPS NPCI WDL SET,,2018-02-08,,49461865.0,-496526518.86000085,.
409000438620',2018-02-08,Indiaforensic AEPS NPCI DEP SET,,2018-02-08,38415053.0,,-534941571.86000085,.
409000438620',2018-02-08,AEPS ACQ CR ADJ FEES 0702,,2018-02-08,82.6,,-534941654.4600009,.
409000438620',2018-02-08,CR802511191966/RMCPL15907/2,,2018-02-08,500.0,,-534942154.4600009,.
409000438620',2018-02-08,CR802511192845/RMCPL21121/2,,2018-02-08,6000.0,,-534948154.4600009,.
409000438620',2018-02-08,CR802511191904/RMCPL22967/2,,2018-02-08,3340.0,,-534951494.4600009,.
409000438620',2018-02-08,CR802512203184/RMCPL17588/2,,2018-02-08,1000.0,,-534952494.4600009,.
409000438620',2018-02-08,CR802512204057/RMCPL20688/2,,2018-02-08,3000.0,,-534955494.4600009,.
409000438620',2018-02-08,CR802512202081/RMCPL18268/2,,2018-02-08,2000.0,,-534957494.4600009,.
409000438620',2018-02-08,CR802912049255/RMCPL12731/2,,2018-02-08,500.0,,-534957994.4600009,.
409000438620',2018-02-08,CR802210587273/RMCPL14560/2,,2018-02-08,1000.0,,-534958994.4600009,.
409000438620',2018-02-08,AEPS Indiaforensic INCOME 070218,,2018-02-08,,216731.0,-534742263.4600009,.
409000438620',2018-02-08,AEPS Indiaforensic GST 070218,,2018-02-08,,39011.58,-534703251.8800009,.
409000438620',2018-02-08,TRF TO  Indiaforensic SERVICES I,,2018-02-08,11300000.0,,-546003251.8800008,.
409000438620',2018-02-09,Indiaforensic AEPS NPCI WDL SET,,2018-02-09,,44810047.0,-501193204.8800008,.
409000438620',2018-02-09,AEPS ACQUIRING ADJ FEES 0,,2018-02-09,17.7,,-501193222.5800008,.
409000438620',2018-02-09,GF734512447618/RMCPL18192/1,,2018-02-09,10000.0,,-501203222.5800008,.
409000438620',2018-02-09,AEPS ACQ GFREP ADJ FEES 0,,2018-02-09,,17.7,-501203204.8800008,.
409000438620',2018-02-09,AEPS Indiaforensic INCOME 080218,,2018-02-09,,190853.81,-501012351.0700008,.
409000438620',2018-02-09,AEPS Indiaforensic GST 080218,,2018-02-09,,34353.69,-500977997.3800008,.
409000438620',2018-02-09,Indiaforensic AEPS NPCI DEP SET,,2018-02-09,34038855.0,,-535016852.3800008,.
409000438620',2018-02-09,TRF TO  Indiaforensic SERVICES I,,2018-02-09,11200000.0,,-546216852.3800008,.
409000438620',2018-02-12,Indiaforensic AEPS NPCI WDL SET,,2018-02-12,,48920526.0,-497296326.3800008,.
409000438620',2018-02-12,Indiaforensic AEPS NPCI WDL SET,,2018-02-12,,43275348.0,-454020978.3800008,.
409000438620',2018-02-12,Indiaforensic AEPS NPCI WDL SET,,2018-02-12,,32702156.0,-421318822.3800008,.
409000438620',2018-02-12,Indiaforensic AEPS NPCI DEP SET,,2018-02-12,35776353.0,,-457095175.3800008,.
409000438620',2018-02-12,Indiaforensic AEPS NPCI DEP SET,,2018-02-12,30073423.0,,-487168598.3800008,.
409000438620',2018-02-12,Indiaforensic AEPS NPCI DEP SET,,2018-02-12,26933315.0,,-514101913.3800008,.
409000438620',2018-02-12,TRF TO  Indiaforensic SERVICES I,,2018-02-12,15000000.0,,-529101913.3800008,.
409000438620',2018-02-12,TRF TO  Indiaforensic SERVICES I,,2018-02-12,15000000.0,,-544101913.3800008,.
409000438620',2018-02-12,AEPS ACQUIRING ADJ FEES 0,,2018-02-12,17.7,,-544101931.0800009,.
409000438620',2018-02-12,REP ADJ FEES 090218,,2018-02-12,,20.65,-544101910.4300009,.
409000438620',2018-02-12,AEPS Indiaforensic INCOME 090218,,2018-02-12,,207166.77,-543894743.6600009,.
409000438620',2018-02-12,AEPS Indiaforensic GST 090218,,2018-02-12,,37290.02,-543857453.6400009,.
409000438620',2018-02-12,AEPS Indiaforensic INCOME 100218,,2018-02-12,,182542.68,-543674910.960001,.
409000438620',2018-02-12,AEPS Indiaforensic GST 100218,,2018-02-12,,32857.68,-543642053.280001,.
409000438620',2018-02-12,AEPS Indiaforensic INCOME 110218,,2018-02-12,,151589.24,-543490464.040001,.
409000438620',2018-02-12,AEPS Indiaforensic GST 110218,,2018-02-12,,27286.06,-543463177.9800011,.
409000438620',2018-02-12,TRF TO  Indiaforensic SERVICES I,,2018-02-12,2800000.0,,-546263177.9800011,.
409000438620',2018-02-14,Indiaforensic AEPS NPCI WDL SET,,2018-02-14,,53385122.0,-492878055.9800011,.
409000438620',2018-02-14,Indiaforensic AEPS NPCI WDL SET,,2018-02-14,,50798694.0,-442079361.9800011,.
409000438620',2018-02-14,Indiaforensic AEPS NPCI DEP SET,,2018-02-14,37658561.0,,-479737922.9800011,.
409000438620',2018-02-14,Indiaforensic AEPS NPCI DEP SET,,2018-02-14,37978669.0,,-517716591.9800011,.
409000438620',2018-02-14,TRF TO  Indiaforensic SERVICES I,,2018-02-14,13500000.0,,-531216591.9800011,.
409000438620',2018-02-14,TRF TO  Indiaforensic SERVICES I,,2018-02-14,15000000.0,,-546216591.9800011,.
409000438620',2018-02-14,AEPS ACQUIRING ADJ FEES 1,,2018-02-14,168.15,,-546216760.1300011,.
409000438620',2018-02-14,AEPS Indiaforensic INCOME 120218,,2018-02-14,,227079.18,-545989680.9500011,.
409000438620',2018-02-14,AEPS Indiaforensic GST 120218,,2018-02-14,,40874.25,-545948806.7000011,.
409000438620',2018-02-14,AEPS Indiaforensic INCOME 130218,,2018-02-14,,218199.08,-545730607.6200011,.
409000438620',2018-02-14,AEPS Indiaforensic GST 130218,,2018-02-14,,39275.83,-545691331.790001,.
409000438620',2018-02-15,Indiaforensic AEPS NPCI WDL SET,,2018-02-15,,43524087.0,-502167244.79000103,.
409000438620',2018-02-15,Indiaforensic AEPS NPCI DEP SET,,2018-02-15,33990380.0,,-536157624.79000103,.
409000438620',2018-02-15,AEPS ACQUIRING ADJ FEES 1,,2018-02-15,23.6,,-536157648.39000106,.
409000438620',2018-02-15,AEPS ACQ REP ADJ FEES 140,,2018-02-15,,17.7,-536157630.6900011,.
409000438620',2018-02-15,AEPS Indiaforensic INCOME 140218,,2018-02-15,,191360.96,-535966269.7300011,.
409000438620',2018-02-15,AEPS Indiaforensic GST 140218,,2018-02-15,,34444.97,-535931824.76000106,.
409000438620',2018-02-15,TRF TO  Indiaforensic SERVICES I,,2018-02-15,10000000.0,,-545931824.7600011,.
409000438620',2018-02-16,Indiaforensic AEPS NPCI WDL SET,,2018-02-16,,57349007.0,-488582817.76000106,.
409000438620',2018-02-16,Indiaforensic AEPS NPCI DEP SET,,2018-02-16,42797380.0,,-531380197.76000106,.
409000438620',2018-02-16,TRF TO  Indiaforensic SERVICES I,,2018-02-16,14700000.0,,-546080197.7600011,.
409000438620',2018-02-16,AEPS ACQ REP ADJ FEES 150,,2018-02-16,,191.75,-546080006.0100011,.
409000438620',2018-02-16,AEPS Indiaforensic INCOME 150218,,2018-02-16,,245906.06,-545834099.9500011,.
409000438620',2018-02-16,AEPS Indiaforensic GST 150218,,2018-02-16,,44263.09,-545789836.8600011,.
409000438620',2018-02-17,Indiaforensic AEPS NPCI WDL SET,,2018-02-17,,61261248.0,-484528588.8600011,.
409000438620',2018-02-17,Indiaforensic AEPS NPCI DEP SET,,2018-02-17,40840714.0,,-525369302.8600011,.
409000438620',2018-02-17,AEPS Indiaforensic INCOME 160218,,2018-02-17,,250378.4,-525118924.4600011,.
409000438620',2018-02-17,AEPS Indiaforensic GST 160218,,2018-02-17,,45068.11,-525073856.3500011,.
409000438620',2018-02-17,TRF TO  Indiaforensic SERVICES I,,2018-02-17,5000000.0,,-530073856.3500011,.
409000438620',2018-02-17,TRF TO  Indiaforensic SERVICES I,,2018-02-17,5000000.0,,-535073856.3500011,.
409000438620',2018-02-17,TRF TO  Indiaforensic SERVICES I,,2018-02-17,5000000.0,,-540073856.3500011,.
409000438620',2018-02-17,TRF TO  Indiaforensic SERVICES I,,2018-02-17,5000000.0,,-545073856.3500011,.
409000438620',2018-02-19,TRF TO  Indiaforensic SERVICES I,,2018-02-19,1200000.0,,-546273856.3500011,.
409000438620',2018-02-20,Indiaforensic AEPS NPCI WDL SET,,2018-02-20,,49158374.0,-497115482.3500011,.
409000438620',2018-02-20,Indiaforensic AEPS NPCI DEP SET,,2018-02-20,33037846.0,,-530153328.3500011,.
409000438620',2018-02-20,TRF TO  Indiaforensic SERVICES I,,2018-02-20,15000000.0,,-545153328.3500011,.
409000438620',2018-02-20,Indiaforensic AEPS NPCI WDL SET,,2018-02-20,,33452643.0,-511700685.3500011,.
409000438620',2018-02-20,Indiaforensic AEPS NPCI DEP SET,,2018-02-20,27186578.0,,-538887263.3500011,.
409000438620',2018-02-20,TRF TO  Indiaforensic SERVICES I,,2018-02-20,7400000.0,,-546287263.3500011,.
409000438620',2018-02-20,AEPS ACQUIRING ADJ FEES 1,,2018-02-20,133.05,,-546287396.400001,.
409000438620',2018-02-20,Indiaforensic AEPS NPCI WDL SET,,2018-02-20,,50181992.0,-496105404.40000105,.
409000438620',2018-02-20,AEPS Indiaforensic INCOME 170218,,2018-02-20,,199759.84,-495905644.5600011,.
409000438620',2018-02-20,AEPS Indiaforensic GST 170218,,2018-02-20,,35956.77,-495869687.7900011,.
409000438620',2018-02-20,AEPS Indiaforensic INCOME 180218,,2018-02-20,,149887.2,-495719800.5900011,.
409000438620',2018-02-20,AEPS Indiaforensic GST 180218,,2018-02-20,,26979.7,-495692820.8900011,.
409000438620',2018-02-20,Indiaforensic AEPS NPCI DEP SET,,2018-02-20,37121166.0,,-532813986.8900011,.
409000438620',2018-02-21,TRF TO  Indiaforensic SERVICES I,,2018-02-21,5000000.0,,-537813986.890001,.
409000438620',2018-02-21,TRF TO  Indiaforensic SERVICES I,,2018-02-21,5000000.0,,-542813986.890001,.
409000438620',2018-02-21,TRF TO  Indiaforensic SERVICES I,,2018-02-21,3000000.0,,-545813986.890001,.
409000438620',2018-02-21,Indiaforensic AEPS NPCI WDL SET,,2018-02-21,,48056598.0,-497757388.89000106,.
409000438620',2018-02-21,Indiaforensic AEPS NPCI DEP SET,,2018-02-21,37828009.0,,-535585397.89000106,.
409000438620',2018-02-21,AEPS Indiaforensic INCOME 200218,,2018-02-21,,211826.95,-535373570.9400011,.
409000438620',2018-02-21,AEPS Indiaforensic GST 200218,,2018-02-21,,38128.85,-535335442.09000105,.
409000438620',2018-02-21,AEPS Indiaforensic INCOME 190218,,2018-02-21,,216469.19,-535118972.90000105,.
409000438620',2018-02-21,AEPS Indiaforensic GST 190218,,2018-02-21,,38964.45,-535080008.45000106,.
409000438620',2018-02-21,TRF TO  Indiaforensic SERVICES I,,2018-02-21,10700000.0,,-545780008.450001,.
409000438620',2018-02-22,Indiaforensic AEPS NPCI WDL SET,,2018-02-22,,46239397.0,-499540611.450001,.
409000438620',2018-02-22,AEPS ACQUIRING ADJ FEES 2,,2018-02-22,244.96,,-499540856.410001,.
409000438620',2018-02-22,AEPS ACQ REP ADJ FEES 210,,2018-02-22,,133.05,-499540723.36000097,.
409000438620',2018-02-22,Indiaforensic AEPS NPCI DEP SET,,2018-02-22,37532448.0,,-537073171.360001,.
409000438620',2018-02-22,AEPS Indiaforensic INCOME 210218,,2018-02-22,,206288.71,-536866882.650001,.
409000438620',2018-02-22,AEPS Indiaforensic GST 210218,,2018-02-22,,37131.97,-536829750.68000096,.
409000438620',2018-02-22,TR TO  Indiaforensic SERVICES IN,,2018-02-22,9200000.0,,-546029750.680001,.
409000438620',2018-02-23,Indiaforensic AEPS NPCI WDL SET,,2018-02-23,,46491287.0,-499538463.680001,.
409000438620',2018-02-23,AEPS ACQUIRING ADJ FEES 2,,2018-02-23,150.44,,-499538614.120001,.
409000438620',2018-02-23,Indiaforensic AEPS NPCI DEP SET,,2018-02-23,37090637.0,,-536629251.120001,.
409000438620',2018-02-23,AEPS Indiaforensic INCOME 220218,,2018-02-23,,205654.51,-536423596.610001,.
409000438620',2018-02-23,AEPS Indiaforensic GST 220218,,2018-02-23,,37017.81,-536386578.800001,.
409000438620',2018-02-23,TRF TO  Indiaforensic SERVICES I,,2018-02-23,9600000.0,,-545986578.800001,.
409000438620',2018-02-23,Indiaforensic AEPS NPCI WDL SET,,2018-02-23,,33600.0,-545952978.800001,.
409000438620',2018-02-23,AEPS Indiaforensic INCOME 190218,,2018-02-23,,91.8,-545952887.0000011,.
409000438620',2018-02-23,AEPS Indiaforensic GST 190218,,2018-02-23,,16.52,-545952870.4800011,.
409000438620',2018-02-26,Indiaforensic AEPS NPCI WDL SET,,2018-02-26,,51133300.0,-494819570.4800011,.
409000438620',2018-02-26,Indiaforensic AEPS NPCI DEP SET,,2018-02-26,37709947.0,,-532529517.4800011,.
409000438620',2018-02-26,Indiaforensic AEPS NPCI WDL SET,,2018-02-26,,44314891.0,-488214626.4800011,.
409000438620',2018-02-26,Indiaforensic AEPS NPCI WDL SET,,2018-02-26,,28735201.0,-459479425.4800011,.
409000438620',2018-02-26,Indiaforensic AEPS NPCI DEP SET,,2018-02-26,32333997.0,,-491813422.4800011,.
409000438620',2018-02-26,Indiaforensic AEPS NPCI DEP SET,,2018-02-26,25789661.0,,-517603083.4800011,.
409000438620',2018-02-26,TRF TO  Indiaforensic SERVICES I,,2018-02-26,15000000.0,,-532603083.4800011,.
409000438620',2018-02-26,TRF TO  Indiaforensic SERVICES I,,2018-02-26,13600000.0,,-546203083.4800011,.
409000438620',2018-02-26,AEPS Indiaforensic INCOME 230218,,2018-02-26,,218536.59,-545984546.890001,.
409000438620',2018-02-26,AEPS Indiaforensic GST 230218,,2018-02-26,,39336.59,-545945210.300001,.
409000438620',2018-02-26,AEPS Indiaforensic INCOME 240218,,2018-02-26,,188726.14,-545756484.160001,.
409000438620',2018-02-26,AEPS Indiaforensic GST 240218,,2018-02-26,,33970.71,-545722513.450001,.
409000438620',2018-02-26,AEPS Indiaforensic INCOME 250218,,2018-02-26,,135083.64,-545587429.810001,.
409000438620',2018-02-26,AEPS Indiaforensic GST 250218,,2018-02-26,,24315.06,-545563114.7500011,.
409000438620',2018-02-27,Indiaforensic AEPS NPCI WDL SET,,2018-02-27,,45133262.0,-500429852.7500011,.
409000438620',2018-02-27,Indiaforensic AEPS NPCI DEP SET,,2018-02-27,35109461.0,,-535539313.7500011,.
409000438620',2018-02-27,AEPS ACQUIRING ADJ FEES 2,,2018-02-27,17.7,,-535539331.45000106,.
409000438620',2018-02-27,AEPS ACQ GF ADJ FEES 2602,,2018-02-27,793.59,,-535540125.04000103,.
409000438620',2018-02-27,CR803311033265/RMCPL19049/2,,2018-02-27,6000.0,,-535546125.04000103,.
409000438620',2018-02-27,CR803417723858/RMCPL13808/3,,2018-02-27,1000.0,,-535547125.04000103,.
409000438620',2018-02-27,CR803417723851/RMCPL23196/3,,2018-02-27,3000.0,,-535550125.04000103,.
409000438620',2018-02-27,CR803417723618/RMCPL13855/3,,2018-02-27,500.0,,-535550625.04000103,.
409000438620',2018-02-27,CR803417723889/RMCPL18884/3,,2018-02-27,500.0,,-535551125.04000103,.
409000438620',2018-02-27,CR803609301933/RMCPL18225/5,,2018-02-27,2000.0,,-535553125.04000103,.
409000438620',2018-02-27,CR804309519361/RMCPL13088/1,,2018-02-27,2000.0,,-535555125.04000103,.
409000438620',2018-02-27,CR804309518934/RMCPL16697/1,,2018-02-27,300.0,,-535555425.04000103,.
409000438620',2018-02-27,CR804509439811/RMCPL22767/1,,2018-02-27,5000.0,,-535560425.04000103,.
409000438620',2018-02-27,CR805013792557/RMCPL14126/1,,2018-02-27,4050.0,,-535564475.04000103,.
409000438620',2018-02-27,CR805014807058/RMCPL12064/1,,2018-02-27,3000.0,,-535567475.04000103,.
409000438620',2018-02-27,CR805013788653/RMCPL13314/1,,2018-02-27,2000.0,,-535569475.04000103,.
409000438620',2018-02-27,CR805013792220/RMCPL18732/1,,2018-02-27,10000.0,,-535579475.04000103,.
409000438620',2018-02-27,CR805014806531/RMCPL22469/1,,2018-02-27,1000.0,,-535580475.04000103,.
409000438620',2018-02-27,CR805013789150/RMCPL15896/1,,2018-02-27,5000.0,,-535585475.04000103,.
409000438620',2018-02-27,CR805013786598/RMCPL23966/1,,2018-02-27,5000.0,,-535590475.04000103,.
409000438620',2018-02-27,CR805013793105/RMCPL22057/1,,2018-02-27,4000.0,,-535594475.04000103,.
409000438620',2018-02-27,CR805013788853/RMCPL19806/1,,2018-02-27,500.0,,-535594975.04000103,.
409000438620',2018-02-27,CR805013792257/RMCPL18313/1,,2018-02-27,500.0,,-535595475.04000103,.
409000438620',2018-02-27,CR805013792201/RMCPL19859/1,,2018-02-27,1000.0,,-535596475.04000103,.
409000438620',2018-02-27,CR805013789851/RMCPL24063/1,,2018-02-27,4000.0,,-535600475.04000103,.
409000438620',2018-02-27,CR805013788311/RMCPL15079/1,,2018-02-27,5000.0,,-535605475.04000103,.
409000438620',2018-02-27,CR805014807063/RMCPL17468/1,,2018-02-27,1000.0,,-535606475.04000103,.
409000438620',2018-02-27,CR805013792177/RMCPL14485/1,,2018-02-27,5000.0,,-535611475.04000103,.
409000438620',2018-02-27,CR805013789181/RMCPL16875/1,,2018-02-27,1500.0,,-535612975.04000103,.
409000438620',2018-02-27,CR805013788873/RMCPL16637/1,,2018-02-27,1000.0,,-535613975.04000103,.
409000438620',2018-02-27,CR805014807094/RMCPL22042/1,,2018-02-27,2500.0,,-535616475.04000103,.
409000438620',2018-02-27,CR805013792068/RMCPL22638/1,,2018-02-27,1000.0,,-535617475.04000103,.
409000438620',2018-02-27,CR805013792116/RMCPL19414/1,,2018-02-27,2000.0,,-535619475.04000103,.
409000438620',2018-02-27,CR805013788132/RMCPL21400/1,,2018-02-27,5000.0,,-535624475.04000103,.
409000438620',2018-02-27,CR805013789339/RMCPL21567/1,,2018-02-27,500.0,,-535624975.04000103,.
409000438620',2018-02-27,CR805013787292/RMCPL17633/1,,2018-02-27,5000.0,,-535629975.04000103,.
409000438620',2018-02-27,CR805013793116/RMCPL13088/1,,2018-02-27,500.0,,-535630475.04000103,.
409000438620',2018-02-27,CR805013792273/RMCPL17049/1,,2018-02-27,1510.0,,-535631985.04000103,.
409000438620',2018-02-27,CR805013792180/RMCPL22353/1,,2018-02-27,500.0,,-535632485.04000103,.
409000438620',2018-02-27,CR805014806527/RMCPL14363/1,,2018-02-27,5000.0,,-535637485.04000103,.
409000438620',2018-02-27,CR805013789288/RMCPL09155/1,,2018-02-27,1000.0,,-535638485.04000103,.
409000438620',2018-02-27,CR805013795576/RMCPL09112/1,,2018-02-27,2010.0,,-535640495.04000103,.
409000438620',2018-02-27,CR805013789117/RMCPL09595/1,,2018-02-27,10000.0,,-535650495.04000103,.
409000438620',2018-02-27,CR805013786930/RMCPL18598/1,,2018-02-27,5000.0,,-535655495.04000103,.
409000438620',2018-02-27,CR805013789030/RMCPL22563/1,,2018-02-27,500.0,,-535655995.04000103,.
409000438620',2018-02-27,CR805013786685/RMCPL15549/1,,2018-02-27,700.0,,-535656695.04000103,.
409000438620',2018-02-27,CR805013788961/RMCPL15491/1,,2018-02-27,5000.0,,-535661695.04000103,.
409000438620',2018-02-27,CR805013792575/RMCPL21961/1,,2018-02-27,1500.0,,-535663195.04000103,.
409000438620',2018-02-27,CR805013787993/RMCPL19012/1,,2018-02-27,2000.0,,-535665195.04000103,.
409000438620',2018-02-27,CR805013788163/RMCPL13803/1,,2018-02-27,1000.0,,-535666195.04000103,.
409000438620',2018-02-27,CR805014806813/RMCPL22266/1,,2018-02-27,1510.0,,-535667705.04000103,.
409000438620',2018-02-27,CR805013788972/RMCPL23459/1,,2018-02-27,1000.0,,-535668705.04000103,.
409000438620',2018-02-27,CR805013788687/RMCPL16467/1,,2018-02-27,10000.0,,-535678705.04000103,.
409000438620',2018-02-27,CR803212579840/RMCPL22822/1,,2018-02-27,3000.0,,-535681705.04000103,.
409000438620',2018-02-27,CR803212579791/RMCPL19800/1,,2018-02-27,710.0,,-535682415.04000103,.
409000438620',2018-02-27,CR803212579767/RMCPL14949/1,,2018-02-27,330.0,,-535682745.04000103,.
409000438620',2018-02-27,CR803517123364/RMCPL18551/4,,2018-02-27,1415.0,,-535684160.04000103,.
409000438620',2018-02-27,CR803517123365/RMCPL21201/4,,2018-02-27,500.0,,-535684660.04000103,.
409000438620',2018-02-27,CR803410491893/RMCPL23233/3,,2018-02-27,4000.0,,-535688660.04000103,.
409000438620',2018-02-27,CR803413589939/RMCPL22602/3,,2018-02-27,1500.0,,-535690160.04000103,.
409000438620',2018-02-27,CR803410491902/RMCPL19701/3,,2018-02-27,1000.0,,-535691160.04000103,.
409000438620',2018-02-27,CR803417723812/RMCPL17123/3,,2018-02-27,2000.0,,-535693160.04000103,.
409000438620',2018-02-27,CR803417723693/RMCPL18667/3,,2018-02-27,10000.0,,-535703160.04000103,.
409000438620',2018-02-27,CR803417723816/RMCPL18116/3,,2018-02-27,500.0,,-535703660.04000103,.
409000438620',2018-02-27,CR803410491924/RMCPL21784/3,,2018-02-27,2000.0,,-535705660.04000103,.
409000438620',2018-02-27,CR803417723818/RMCPL14838/3,,2018-02-27,500.0,,-535706160.04000103,.
409000438620',2018-02-27,CR803417723731/RMCPL03220/3,,2018-02-27,500.0,,-535706660.04000103,.
409000438620',2018-02-27,CR803613441410/RMCPL14220/5,,2018-02-27,500.0,,-535707160.04000103,.
409000438620',2018-02-27,CR803613441400/RMCPL14710/5,,2018-02-27,4000.0,,-535711160.04000103,.
409000438620',2018-02-27,CR803613441432/RMCPL23472/5,,2018-02-27,1000.0,,-535712160.04000103,.
409000438620',2018-02-27,CR803613441445/RMCPL22482/5,,2018-02-27,2000.0,,-535714160.04000103,.
409000438620',2018-02-27,CR804416214273/RMCPL20863/1,,2018-02-27,500.0,,-535714660.04000103,.
409000438620',2018-02-27,CR804410995930/RMCPL13980/1,,2018-02-27,6000.0,,-535720660.04000103,.
409000438620',2018-02-27,CR805012771691/RMCPL24063/1,,2018-02-27,4000.0,,-535724660.04000103,.
409000438620',2018-02-27,CR805012771658/RMCPL21490/1,,2018-02-27,2000.0,,-535726660.04000103,.
409000438620',2018-02-27,CR805012771680/RMCPL17641/1,,2018-02-27,2020.0,,-535728680.04000103,.
409000438620',2018-02-27,CR805012771575/RMCPL15709/1,,2018-02-27,2000.0,,-535730680.04000103,.
409000438620',2018-02-27,CR805012771702/RMCPL19509/1,,2018-02-27,8000.0,,-535738680.04000103,.
409000438620',2018-02-27,CR805012771672/RMCPL16290/1,,2018-02-27,1000.0,,-535739680.04000103,.
409000438620',2018-02-27,AEPS ACQ REP ADJ FEES 260,,2018-02-27,,79.65,-535739600.39000106,.
409000438620',2018-02-27,AEPS Indiaforensic INCOME 260218,,2018-02-27,,195171.68,-535544428.71000105,.
409000438620',2018-02-27,AEPS Indiaforensic GST 260218,,2018-02-27,,35130.9,-535509297.8100011,.
409000438620',2018-02-27,TRF TO  Indiaforensic SERVICES I,,2018-02-27,10700000.0,,-546209297.8100011,.
409000438620',2018-02-28,Indiaforensic AEPS NPCI WDL SET,,2018-02-28,,50159903.0,-496049394.81000113,.
409000438620',2018-02-28,Indiaforensic AEPS NPCI DEP SET,,2018-02-28,36864001.0,,-532913395.81000113,.
409000438620',2018-02-28,CB805013792329/RMCPL22875/1,,2018-02-28,4000.0,,-532917395.81000113,.
409000438620',2018-02-28,CB805013792756/RMCPL20049/1,,2018-02-28,1500.0,,-532918895.81000113,.
409000438620',2018-02-28,CB805013792838/RMCPL18013/1,,2018-02-28,1000.0,,-532919895.81000113,.
409000438620',2018-02-28,CB805013792856/RMCPL22316/1,,2018-02-28,4000.0,,-532923895.81000113,.
409000438620',2018-02-28,CB805013793071/RMCPL14536/1,,2018-02-28,1000.0,,-532924895.81000113,.
409000438620',2018-02-28,CB805014806556/RMCPL16840/1,,2018-02-28,2020.0,,-532926915.81000113,.
409000438620',2018-02-28,CB805014806568/RMCPL18141/1,,2018-02-28,1000.0,,-532927915.81000113,.
409000438620',2018-02-28,CB805014806738/RMCPL13078/1,,2018-02-28,1000.0,,-532928915.81000113,.
409000438620',2018-02-28,CB805014806792/RMCPL23126/1,,2018-02-28,500.0,,-532929415.81000113,.
409000438620',2018-02-28,CB805014806796/RMCPL12946/1,,2018-02-28,10000.0,,-532939415.81000113,.
409000438620',2018-02-28,CB805014806871/RMCPL18093/1,,2018-02-28,5000.0,,-532944415.81000113,.
409000438620',2018-02-28,CB805014807056/RMCPL14712/1,,2018-02-28,10000.0,,-532954415.81000113,.
409000438620',2018-02-28,CB805014807178/RMCPL23380/1,,2018-02-28,3000.0,,-532957415.81000113,.
409000438620',2018-02-28,CB805013786938/RMCPL22051/1,,2018-02-28,10000.0,,-532967415.81000113,.
409000438620',2018-02-28,CB805013787091/RMCPL22560/1,,2018-02-28,8500.0,,-532975915.81000113,.
409000438620',2018-02-28,CB805013788040/RMCPL18488/1,,2018-02-28,1000.0,,-532976915.81000113,.
409000438620',2018-02-28,CB805013788140/RMCPL23986/1,,2018-02-28,1000.0,,-532977915.81000113,.
409000438620',2018-02-28,CB805013788951/RMCPL21223/1,,2018-02-28,2500.0,,-532980415.81000113,.
409000438620',2018-02-28,CB805013788992/RMCPL12832/1,,2018-02-28,2000.0,,-532982415.81000113,.
409000438620',2018-02-28,CB805013789250/RMCPL20457/1,,2018-02-28,5000.0,,-532987415.81000113,.
409000438620',2018-02-28,CB805013784433/RMCPL17634/1,,2018-02-28,6000.0,,-532993415.81000113,.
409000438620',2018-02-28,CB805013784511/RMCPL15834/1,,2018-02-28,3000.0,,-532996415.81000113,.
409000438620',2018-02-28,CB805013784513/RMCPL12946/1,,2018-02-28,3000.0,,-532999415.81000113,.
409000438620',2018-02-28,CB805013784524/RMCPL13111/1,,2018-02-28,2000.0,,-533001415.81000113,.
409000438620',2018-02-28,CB805013784525/RMCPL23967/1,,2018-02-28,1000.0,,-533002415.81000113,.
409000438620',2018-02-28,TRF TO  Indiaforensic SERVICES I,,2018-02-28,13300000.0,,-546302415.8100011,.
409000438620',2018-02-28,AEPS Indiaforensic INCOME 270218,,2018-02-28,,211209.92,-546091205.8900012,.
409000438620',2018-02-28,AEPS Indiaforensic GST 270218,,2018-02-28,,38017.79,-546053188.1000012,.
409000438620',2018-03-01,Indiaforensic AEPS NPCI WDL SET,,2018-03-01,,55082193.0,-490970995.1000012,.
409000438620',2018-03-01,Indiaforensic AEPS NPCI DEP SET,,2018-03-01,42051154.0,,-533022149.1000012,.
409000438620',2018-03-01,TRF TO  Indiaforensic SERVICES I,,2018-03-01,13200000.0,,-546222149.1000012,.
409000438620',2018-03-01,AEPS ACQUIRING ADJ FEES 2,,2018-03-01,91.45,,-546222240.5500013,.
409000438620',2018-03-01,AEPS ACQREP ADJ FEES 2802,,2018-03-01,,17.7,-546222222.8500012,.
409000438620',2018-03-01,AEPS Indiaforensic INCOME 280218,,2018-03-01,,234235.7,-545987987.1500012,.
409000438620',2018-03-01,AEPS Indiaforensic GST 280218,,2018-03-01,,42162.43,-545945824.7200012,.
409000438620',2018-03-03,Indiaforensic AEPS NPCI WDL SET,,2018-03-03,,51740260.0,-494205564.7200012,.
409000438620',2018-03-03,Indiaforensic AEPS NPCI WDL SET,,2018-03-03,,15529786.0,-478675778.7200012,.
409000438620',2018-03-03,Indiaforensic AEPS NPCI DEP SET,,2018-03-03,38188836.0,,-516864614.7200012,.
409000438620',2018-03-03,Indiaforensic AEPS NPCI DEP SET,,2018-03-03,19234605.0,,-536099219.7200012,.
409000438620',2018-03-03,TRF TO  Indiaforensic SERVICES I,,2018-03-03,5000000.0,,-541099219.7200012,.
409000438620',2018-03-03,TRF TO  Indiaforensic SERVICES I,,2018-03-03,2000000.0,,-543099219.7200012,.
409000438620',2018-03-03,TRF TO  Indiaforensic SERVICES I,,2018-03-03,3000000.0,,-546099219.7200012,.
409000438620',2018-03-03,AEPS ACQUIRING ADJ FEES 0,,2018-03-03,17.7,,-546099237.4200013,.
409000438620',2018-03-03,AEPS ACQ GF ADJ FEES 0103,,2018-03-03,17.7,,-546099255.1200013,.
409000438620',2018-03-03,AEPS Indiaforensic INCOME 010318,,2018-03-03,,218918.18,-545880336.9400014,.
409000438620',2018-03-03,AEPS Indiaforensic GST 010318,,2018-03-03,,39405.27,-545840931.6700014,.
409000438620',2018-03-03,AEPS Indiaforensic INCOME 020318,,2018-03-03,,84161.57,-545756770.1000013,.
409000438620',2018-03-03,AEPS Indiaforensic GST 020318,,2018-03-03,,15149.08,-545741621.0200013,.
409000438620',2018-03-05,Indiaforensic AEPS NPCI WDL SET,,2018-03-05,,34865811.0,-510875810.0200013,.
409000438620',2018-03-05,Indiaforensic AEPS NPCI WDL SET,,2018-03-05,,29068134.0,-481807676.0200013,.
409000438620',2018-03-05,Indiaforensic AEPS NPCI DEP SET,,2018-03-05,31982928.0,,-513790604.0200013,.
409000438620',2018-03-05,Indiaforensic AEPS NPCI DEP SET,,2018-03-05,24739883.0,,-538530487.0200013,.
409000438620',2018-03-05,TRF TO  Indiaforensic SERVICES I,,2018-03-05,7700000.0,,-546230487.0200013,.
409000438620',2018-03-05,AEPS Indiaforensic INCOME 030318,,2018-03-05,,161748.59,-546068738.4300013,.
409000438620',2018-03-05,AEPS Indiaforensic GST 030318,,2018-03-05,,29114.75,-546039623.6800013,.
409000438620',2018-03-05,AEPS Indiaforensic INCOME 040318,,2018-03-05,,134285.23,-545905338.4500012,.
409000438620',2018-03-05,AEPS Indiaforensic GST 040318,,2018-03-05,,24171.34,-545881167.1100012,.
409000438620',2018-03-06,Indiaforensic AEPS NPCI WDL SET,,2018-03-06,,37731963.0,-508149204.1100012,.
409000438620',2018-03-06,Indiaforensic AEPS NPCI DEP SET,,2018-03-06,29069155.0,,-537218359.1100012,.
409000438620',2018-03-06,TRF TO  Indiaforensic SERVICES I,,2018-03-06,9000000.0,,-546218359.1100012,.
409000438620',2018-03-06,AEPS Indiaforensic INCOME 050318,,2018-03-06,,160951.67,-546057407.4400012,.
409000438620',2018-03-06,AEPS Indiaforensic GST 050318,,2018-03-06,,28971.3,-546028436.1400013,.
409000438620',2018-03-07,Indiaforensic AEPS NPCI WDL SET,,2018-03-07,,47868779.0,-498159657.1400013,.
409000438620',2018-03-07,Indiaforensic AEPS NPCI DEP SET,,2018-03-07,38500521.0,,-536660178.1400013,.
409000438620',2018-03-07,TRF TO  Indiaforensic SERVICES I,,2018-03-07,9600000.0,,-546260178.1400013,.
409000438620',2018-03-07,AEPS ACQREP ADJ FEES 0603,,2018-03-07,,17.7,-546260160.4400012,.
409000438620',2018-03-07,AEPS Indiaforensic INCOME 060318,,2018-03-07,,204621.76,-546055538.6800013,.
409000438620',2018-03-07,AEPS Indiaforensic GST 060318,,2018-03-07,,36831.92,-546018706.7600013,.
409000438620',2018-03-08,Indiaforensic AEPS NPCI WDL SET,,2018-03-08,,41676252.0,-504342454.7600013,.
409000438620',2018-03-08,CB805703035238/RPT05230/2,,2018-03-08,10000.0,,-504352454.7600013,.
409000438620',2018-03-08,CB805703035238/RPT05230/2,,2018-03-08,2500.0,,-504354954.7600013,.
409000438620',2018-03-08,CB805703035238/RPT05230/2,,2018-03-08,5000.0,,-504359954.7600013,.
409000438620',2018-03-08,CB805703035238/RPT05230/2,,2018-03-08,500.0,,-504360454.7600013,.
409000438620',2018-03-08,CB805703035238/RPT05230/2,,2018-03-08,1500.0,,-504361954.7600013,.
409000438620',2018-03-08,CB805703035238/RPT05230/2,,2018-03-08,500.0,,-504362454.7600013,.
409000438620',2018-03-08,CB805703035238/RPT05230/2,,2018-03-08,500.0,,-504362954.7600013,.
409000438620',2018-03-08,CB805703035238/RPT05230/2,,2018-03-08,2000.0,,-504364954.7600013,.
409000438620',2018-03-08,CB805703035238/RPT05230/2,,2018-03-08,500.0,,-504365454.7600013,.
409000438620',2018-03-08,CB805703035238/RPT05230/2,,2018-03-08,500.0,,-504365954.7600013,.
409000438620',2018-03-08,CB805703035238/RPT05230/2,,2018-03-08,1000.0,,-504366954.7600013,.
409000438620',2018-03-08,Indiaforensic AEPS NPCI DEP SET,,2018-03-08,36972568.0,,-541339522.7600013,.
409000438620',2018-03-08,TRF TO  Indiaforensic SERVICES I,,2018-03-08,4900000.0,,-546239522.7600013,.
409000438620',2018-03-08,AEPS ACQUIRING ADJ FEES 0,,2018-03-08,35.4,,-546239558.1600013,.
409000438620',2018-03-08,AEPS Indiaforensic INCOME 070318,,2018-03-08,,185323.02,-546054235.1400013,.
409000438620',2018-03-08,AEPS Indiaforensic GST 070318,,2018-03-08,,33358.14,-546020877.0000013,.
409000438620',2018-03-09,Indiaforensic AEPS NPCI WDL SET,,2018-03-09,,43617351.0,-502403526.0000013,.
409000438620',2018-03-09,Indiaforensic AEPS NPCI DEP SET,,2018-03-09,37204424.0,,-539607950.0000013,.
409000438620',2018-03-09,TRF TO  Indiaforensic SERVICES I,,2018-03-09,6700000.0,,-546307950.0000013,.
409000438620',2018-03-09,AEPS ACQUIRING ADJ FEES 0,,2018-03-09,17.7,,-546307967.7000014,.
409000438620',2018-03-09,AEPS ACQREP ADJ FEES 0803,,2018-03-09,,35.4,-546307932.3000014,.
409000438620',2018-03-09,AEPS Indiaforensic INCOME 080318,,2018-03-09,,192106.94,-546115825.3600013,.
409000438620',2018-03-09,AEPS Indiaforensic GST 080318,,2018-03-09,,34579.25,-546081246.1100013,.
409000438620',2018-03-12,Indiaforensic AEPS NPCI WDL SET,,2018-03-12,,45067199.0,-501014047.1100013,.
409000438620',2018-03-12,Indiaforensic AEPS NPCI DEP SET,,2018-03-12,37286440.0,,-538300487.1100013,.
409000438620',2018-03-12,Indiaforensic AEPS NPCI WDL SET,,2018-03-12,,40399392.0,-497901095.1100013,.
409000438620',2018-03-12,Indiaforensic AEPS NPCI WDL SET,,2018-03-12,,28450812.0,-469450283.1100013,.
409000438620',2018-03-12,Indiaforensic AEPS NPCI DEP SET,,2018-03-12,31029586.0,,-500479869.1100013,.
409000438620',2018-03-12,Indiaforensic AEPS NPCI DEP SET,,2018-03-12,26658561.0,,-527138430.1100013,.
409000438620',2018-03-12,TRF TO  Indiaforensic SERVICES I,,2018-03-12,15000000.0,,-542138430.1100013,.
409000438620',2018-03-12,TRF TO  Indiaforensic SERVICES I,,2018-03-12,4000000.0,,-546138430.1100013,.
409000438620',2018-03-12,AEPS Indiaforensic INCOME 090318,,2018-03-12,,197281.76,-545941148.3500013,.
409000438620',2018-03-12,AEPS Indiaforensic GST 090318,,2018-03-12,,35510.72,-545905637.6300013,.
409000438620',2018-03-13,Indiaforensic AEPS NPCI WDL SET,,2018-03-13,,43179311.0,-502726326.6300013,.
409000438620',2018-03-13,Indiaforensic AEPS NPCI DEP SET,,2018-03-13,32297603.0,,-535023929.6300013,.
409000438620',2018-03-13,TRF TO  Indiaforensic SERVICES I,,2018-03-13,11200000.0,,-546223929.6300013,.
409000438620',2018-03-13,AEPS ACQ REP ADJ FEES 120,,2018-03-13,,17.7,-546223911.9300013,.
409000438620',2018-03-13,AEPS Indiaforensic INCOME 120318,,2018-03-13,,181794.98,-546042116.9500012,.
409000438620',2018-03-13,AEPS Indiaforensic GST 120318,,2018-03-13,,32723.1,-546009393.8500012,.
409000438620',2018-03-14,Indiaforensic AEPS NPCI WDL SET,,2018-03-14,,37372930.0,-508636463.8500012,.
409000438620',2018-03-14,Indiaforensic AEPS NPCI DEP SET,,2018-03-14,30070521.0,,-538706984.8500012,.
409000438620',2018-03-14,AEPS Indiaforensic INCOME 100318,,2018-03-14,,173095.79,-538533889.0600013,.
409000438620',2018-03-14,AEPS Indiaforensic GST 100318,,2018-03-14,,31157.24,-538502731.8200012,.
409000438620',2018-03-14,AEPS Indiaforensic INCOME 110318,,2018-03-14,,134579.7,-538368152.1200012,.
409000438620',2018-03-14,AEPS Indiaforensic GST 110318,,2018-03-14,,24224.35,-538343927.7700012,.
409000438620',2018-03-14,TRF TO  Indiaforensic SERVICES I,,2018-03-14,7600000.0,,-545943927.7700012,.
409000438620',2018-03-14,AEPS ACQUIRING ADJ FEES 1,,2018-03-14,88.5,,-545944016.2700012,.
409000438620',2018-03-14,AEPS Indiaforensic INCOME 130318,,2018-03-14,,158094.7,-545785921.5700011,.
409000438620',2018-03-14,AEPS Indiaforensic GST 130318,,2018-03-14,,28457.05,-545757464.5200012,.
409000438620',2018-03-15,Indiaforensic AEPS NPCI WDL SET,,2018-03-15,,46709286.0,-499048178.5200012,.
409000438620',2018-03-15,Indiaforensic AEPS NPCI DEP SET,,2018-03-15,39549547.0,,-538597725.5200012,.
409000438620',2018-03-15,TRF TO  Indiaforensic SERVICES I,,2018-03-15,7700000.0,,-546297725.5200012,.
409000438620',2018-03-15,AEPS Indiaforensic INCOME 140318,,2018-03-15,,202910.0,-546094815.5200012,.
409000438620',2018-03-15,AEPS Indiaforensic GST 140318,,2018-03-15,,36523.8,-546058291.7200012,.
409000438620',2018-03-15,AEPS ACQUIRING ADJ FEES 1,,2018-03-15,17.71,,-546058309.4300013,.
409000438620',2018-03-16,Indiaforensic AEPS NPCI WDL SET,,2018-03-16,,41581722.0,-504476587.43000126,.
409000438620',2018-03-16,Indiaforensic AEPS NPCI DEP SET,,2018-03-16,36058966.0,,-540535553.4300013,.
409000438620',2018-03-16,TRF TO  Indiaforensic SERVICES I,,2018-03-16,5700000.0,,-546235553.4300013,.
409000438620',2018-03-16,AEPS ACQUIRING ADJ FEES 1,,2018-03-16,53.09,,-546235606.5200013,.
409000438620',2018-03-16,AEPS ACQ GF ADJ FEES 1503,,2018-03-16,17.7,,-546235624.2200013,.
409000438620',2018-03-16,GF732317971954/RMCPL16584/1,,2018-03-16,10000.0,,-546245624.2200013,.
409000438620',2018-03-16,AEPS ACQ REP ADJ FEES 150,,2018-03-16,,106.2,-546245518.0200013,.
409000438620',2018-03-16,AEPS Indiaforensic INCOME 150318,,2018-03-16,,182929.57,-546062588.4500012,.
409000438620',2018-03-16,AEPS Indiaforensic GST 150318,,2018-03-16,,32927.32,-546029661.1300012,.
409000438620',2018-03-17,Indiaforensic AEPS NPCI WDL SET,,2018-03-17,,42154001.0,-503875660.1300012,.
409000438620',2018-03-17,Indiaforensic AEPS NPCI DEP SET,,2018-03-17,36956367.0,,-540832027.1300012,.
409000438620',2018-03-17,TRF TO  Indiaforensic SERVICES I,,2018-03-17,5000000.0,,-545832027.1300012,.
409000438620',2018-03-17,AEPS ACQ REP ADJ FEES 140,,2018-03-17,,35.4,-545831991.7300012,.
409000438620',2018-03-17,AEPS Indiaforensic INCOME 160318,,2018-03-17,,183299.59,-545648692.1400012,.
409000438620',2018-03-17,AEPS Indiaforensic GST 160318,,2018-03-17,,32993.93,-545615698.2100012,.
409000438620',2018-03-19,Indiaforensic AEPS NPCI WDL SET,,2018-03-19,,39474500.0,-506141198.21000123,.
409000438620',2018-03-19,Indiaforensic AEPS NPCI WDL SET,,2018-03-19,,26672000.0,-479469198.21000123,.
409000438620',2018-03-19,Indiaforensic AEPS NPCI DEP SET,,2018-03-19,34373112.0,,-513842310.21000123,.
409000438620',2018-03-19,Indiaforensic AEPS NPCI DEP SET,,2018-03-19,24167001.0,,-538009311.2100012,.
409000438620',2018-03-19,TRF TO  Indiaforensic SERVICES I,,2018-03-19,4000000.0,,-542009311.2100012,.
409000438620',2018-03-19,TRF TO  Indiaforensic SERVICES I,,2018-03-19,4000000.0,,-546009311.2100012,.
409000438620',2018-03-19,6070940290159779840,,2018-03-19,11.8,,-546009323.0100012,.
409000438620',2018-03-19,AEPS Indiaforensic INCOME 170318,,2018-03-19,,176395.75,-545832927.2600012,.
409000438620',2018-03-19,AEPS Indiaforensic GST 170318,,2018-03-19,,31751.24,-545801176.0200012,.
409000438620',2018-03-19,AEPS Indiaforensic INCOME 180318,,2018-03-19,,125271.67,-545675904.3500012,.
409000438620',2018-03-19,AEPS Indiaforensic GST 180318,,2018-03-19,,22548.9,-545653355.4500012,.
409000438620',2018-03-20,Indiaforensic AEPS NPCI WDL SET,,2018-03-20,,44626000.0,-501027355.45000124,.
409000438620',2018-03-20,Indiaforensic AEPS NPCI DEP SET,,2018-03-20,33290496.0,,-534317851.45000124,.
409000438620',2018-03-20,TRF TO  Indiaforensic SERVICES I,,2018-03-20,11900000.0,,-546217851.4500012,.
409000438620',2018-03-20,AEPS ACQUIRING ADJ FEES 1,,2018-03-20,47.2,,-546217898.6500013,.
409000438620',2018-03-20,AEPS Indiaforensic INCOME 190318,,2018-03-20,,188170.13,-546029728.5200013,.
409000438620',2018-03-20,AEPS Indiaforensic GST 190318,,2018-03-20,,33870.62,-545995857.9000013,.
409000438620',2018-03-21,Indiaforensic AEPS NPCI WDL SET,,2018-03-21,,41395000.0,-504600857.9000013,.
409000438620',2018-03-21,Indiaforensic AEPS NPCI DEP SET,,2018-03-21,36515472.0,,-541116329.9000013,.
409000438620',2018-03-21,TRF TO  Indiaforensic SERVICES I,,2018-03-21,5100000.0,,-546216329.9000013,.
409000438620',2018-03-21,AEPS Indiaforensic INCOME 200318,,2018-03-21,,186017.44,-546030312.4600012,.
409000438620',2018-03-21,AEPS Indiaforensic GST 200318,,2018-03-21,,33483.14,-545996829.3200012,.
409000438620',2018-03-21,AEPS ACQUIRING ADJ FEES 2,,2018-03-21,11.8,,-545996841.1200012,.
409000438620',2018-03-21,AEPS ACQ REP ADJ FEES 200,,2018-03-21,,29.5,-545996811.6200012,.
409000438620',2018-03-22,Indiaforensic AEPS NPCI WDL SET,,2018-03-22,,41773000.0,-504223811.6200012,.
409000438620',2018-03-22,Indiaforensic AEPS NPCI DEP SET,,2018-03-22,34898540.0,,-539122351.6200012,.
409000438620',2018-03-22,TRF TO  Indiaforensic SERVICES I,,2018-03-22,7100000.0,,-546222351.6200012,.
409000438620',2018-03-22,AEPS ACQ REP ADJ FEES 210,,2018-03-22,,23.6,-546222328.0200012,.
409000438620',2018-03-22,AEPS Indiaforensic INCOME 210318,,2018-03-22,,184420.93,-546037907.0900012,.
409000438620',2018-03-22,AEPS Indiaforensic GST 210318,,2018-03-22,,33195.77,-546004711.3200012,.
409000438620',2018-03-23,Indiaforensic AEPS NPCI WDL SET,,2018-03-23,,40965000.0,-505039711.32000124,.
409000438620',2018-03-23,Indiaforensic AEPS NPCI DEP SET,,2018-03-23,35420578.0,,-540460289.3200012,.
409000438620',2018-03-23,TRF TO  Indiaforensic SERVICES I,,2018-03-23,5800000.0,,-546260289.3200012,.
409000438620',2018-03-23,AEPS Indiaforensic INCOME 220318,,2018-03-23,,184768.61,-546075520.7100012,.
409000438620',2018-03-23,AEPS Indiaforensic GST 220318,,2018-03-23,,33258.35,-546042262.3600012,.
409000438620',2018-03-23,AEPS ACQUIRING ADJ FEES 2,,2018-03-23,115.05,,-546042377.4100012,.
409000438620',2018-03-26,Indiaforensic AEPS NPCI WDL SET,,2018-03-26,,40808000.0,-505234377.41000116,.
409000438620',2018-03-26,Indiaforensic AEPS NPCI WDL SET,,2018-03-26,,32745500.0,-472488877.41000116,.
409000438620',2018-03-26,Indiaforensic AEPS NPCI WDL SET,,2018-03-26,,14313500.0,-458175377.41000116,.
409000438620',2018-03-26,Indiaforensic AEPS NPCI DEP SET,,2018-03-26,34056659.0,,-492232036.41000116,.
409000438620',2018-03-26,CR806210611253/RMCPL14786/0,,2018-03-26,500.0,,-492232536.41000116,.
409000438620',2018-03-26,CR806210611259/RMCPL16428/0,,2018-03-26,10000.0,,-492242536.41000116,.
409000438620',2018-03-26,CR806210611236/RMCPL17307/0,,2018-03-26,5000.0,,-492247536.41000116,.
409000438620',2018-03-26,CR806210611243/RMCPL18908/0,,2018-03-26,500.0,,-492248036.41000116,.
409000438620',2018-03-26,CR806210611244/RMCPL22613/0,,2018-03-26,2600.0,,-492250636.41000116,.
409000438620',2018-03-26,CR806611158438/RMCPL23196/0,,2018-03-26,2500.0,,-492253136.41000116,.
409000438620',2018-03-26,CR806611158484/RMCPL16118/0,,2018-03-26,1000.0,,-492254136.41000116,.
409000438620',2018-03-26,CR806708460925/RMCPL17674/0,,2018-03-26,2000.0,,-492256136.41000116,.
409000438620',2018-03-26,CR806708460927/RMCPL23806/0,,2018-03-26,10000.0,,-492266136.41000116,.
409000438620',2018-03-26,CR806011889745/RMCPL00125/0,,2018-03-26,4000.0,,-492270136.41000116,.
409000438620',2018-03-26,CR806011889721/RMCPL13972/0,,2018-03-26,3000.0,,-492273136.41000116,.
409000438620',2018-03-26,CR806011889722/RMCPL21897/0,,2018-03-26,4000.0,,-492277136.41000116,.
409000438620',2018-03-26,CR806011889716/RMCPL16185/0,,2018-03-26,5000.0,,-492282136.41000116,.
409000438620',2018-03-26,CR806011889723/RMCPL16858/0,,2018-03-26,500.0,,-492282636.41000116,.
409000438620',2018-03-26,CR805013784370/RMCPL21191/1,,2018-03-26,5000.0,,-492287636.41000116,.
409000438620',2018-03-26,CR805013784690/RMCPL22173/1,,2018-03-26,500.0,,-492288136.41000116,.
409000438620',2018-03-26,CR805013784468/RMCPL20001/1,,2018-03-26,2500.0,,-492290636.41000116,.
409000438620',2018-03-26,CR805013784324/RMCPL20956/1,,2018-03-26,10000.0,,-492300636.41000116,.
409000438620',2018-03-26,CR805013784373/RMCPL20326/1,,2018-03-26,500.0,,-492301136.41000116,.
409000438620',2018-03-26,CR805013784355/RMCPL15917/1,,2018-03-26,100.0,,-492301236.41000116,.
409000438620',2018-03-26,CR807119192029/RMCPL19783/1,,2018-03-26,1000.0,,-492302236.41000116,.
409000438620',2018-03-26,CR807119191914/RMCPL11480/1,,2018-03-26,1000.0,,-492303236.41000116,.
409000438620',2018-03-26,CR807116126055/RMCPL13100/1,,2018-03-26,1500.0,,-492304736.41000116,.
409000438620',2018-03-26,CR807116126028/RMCPL23885/1,,2018-03-26,5000.0,,-492309736.41000116,.
409000438620',2018-03-26,CR807109945500/RMCPL12121/1,,2018-03-26,1000.0,,-492310736.41000116,.
409000438620',2018-03-26,CR807111994177/RMCPL20403/1,,2018-03-26,2000.0,,-492312736.41000116,.
409000438620',2018-03-26,CR807116126045/RMCPL23091/1,,2018-03-26,3000.0,,-492315736.41000116,.
409000438620',2018-03-26,CR807109945759/RMCPL18525/1,,2018-03-26,1000.0,,-492316736.41000116,.
409000438620',2018-03-26,CR807110974536/RMCPL00190/1,,2018-03-26,500.0,,-492317236.41000116,.
409000438620',2018-03-26,CR807109947030/RMCPL13750/1,,2018-03-26,500.0,,-492317736.41000116,.
409000438620',2018-03-26,CR807116126025/RMCPL18012/1,,2018-03-26,500.0,,-492318236.41000116,.
409000438620',2018-03-26,CR807109946608/RMCPL17823/1,,2018-03-26,1500.0,,-492319736.41000116,.
409000438620',2018-03-26,CR807119192009/RMCPL15431/1,,2018-03-26,1000.0,,-492320736.41000116,.
409000438620',2018-03-26,CR807109945692/RMCPL21735/1,,2018-03-26,1000.0,,-492321736.41000116,.
409000438620',2018-03-26,CR807214452509/RMCPL14751/1,,2018-03-26,2000.0,,-492323736.41000116,.
409000438620',2018-03-26,CR807214452552/RMCPL15459/1,,2018-03-26,3000.0,,-492326736.41000116,.
409000438620',2018-03-26,CR807214452502/RMCPL22469/1,,2018-03-26,1000.0,,-492327736.41000116,.
409000438620',2018-03-26,CR807211392934/RMCPL19017/1,,2018-03-26,3000.0,,-492330736.41000116,.
409000438620',2018-03-26,CR807214452553/RMCPL23878/1,,2018-03-26,1600.0,,-492332336.41000116,.
409000438620',2018-03-26,CR807216506754/RMCPL21107/1,,2018-03-26,500.0,,-492332836.41000116,.
409000438620',2018-03-26,CR807211392940/RMCPL23283/1,,2018-03-26,500.0,,-492333336.41000116,.
409000438620',2018-03-26,CR807213433369/RMCPL09584/1,,2018-03-26,10000.0,,-492343336.41000116,.
409000438620',2018-03-26,CR807213433385/RMCPL15602/1,,2018-03-26,1000.0,,-492344336.41000116,.
409000438620',2018-03-26,CR807214452576/RMCPL19319/1,,2018-03-26,1010.0,,-492345346.41000116,.
409000438620',2018-03-26,CR807216506727/RMCPL21320/1,,2018-03-26,2000.0,,-492347346.41000116,.
409000438620',2018-03-26,CR807211392907/RMCPL19766/1,,2018-03-26,2000.0,,-492349346.41000116,.
409000438620',2018-03-26,CR807216506713/RMCPL14133/1,,2018-03-26,305.0,,-492349651.41000116,.
409000438620',2018-03-26,CR807309712873/RMCPL19696/1,,2018-03-26,1000.0,,-492350651.41000116,.
409000438620',2018-03-26,CR807311768944/RMCPL11087/1,,2018-03-26,1000.0,,-492351651.41000116,.
409000438620',2018-03-26,CR807309712851/RMCPL18701/1,,2018-03-26,500.0,,-492352151.41000116,.
409000438620',2018-03-26,CR807309712861/RMCPL19904/1,,2018-03-26,510.0,,-492352661.41000116,.
409000438620',2018-03-26,CR807311768953/RMCPL20016/1,,2018-03-26,2500.0,,-492355161.41000116,.
409000438620',2018-03-26,CR807313804462/RMCPL24082/1,,2018-03-26,1000.0,,-492356161.41000116,.
409000438620',2018-03-26,CR807311752234/RMCPL19103/1,,2018-03-26,500.0,,-492356661.41000116,.
409000438620',2018-03-26,CR807311752237/RMCPL13039/1,,2018-03-26,9000.0,,-492365661.41000116,.
409000438620',2018-03-26,CR807309712840/RMCPL24395/1,,2018-03-26,2000.0,,-492367661.41000116,.
409000438620',2018-03-26,CR807311752242/RMCPL23609/1,,2018-03-26,5000.0,,-492372661.41000116,.
409000438620',2018-03-26,CR807413186354/RMCPL11361/1,,2018-03-26,2000.0,,-492374661.41000116,.
409000438620',2018-03-26,CR807412166738/RMCPL22644/1,,2018-03-26,5000.0,,-492379661.41000116,.
409000438620',2018-03-26,CR807415227290/RMCPL20759/1,,2018-03-26,1500.0,,-492381161.41000116,.
409000438620',2018-03-26,CR807415227326/RMCPL17121/1,,2018-03-26,9000.0,,-492390161.41000116,.
409000438620',2018-03-26,CR807413186356/RMCPL20613/1,,2018-03-26,1000.0,,-492391161.41000116,.
409000438620',2018-03-26,CR807415227301/RMCPL14380/1,,2018-03-26,3000.0,,-492394161.41000116,.
409000438620',2018-03-26,CR807413186368/RMCPL22022/1,,2018-03-26,500.0,,-492394661.41000116,.
409000438620',2018-03-26,CR807413186341/RMCPL21736/1,,2018-03-26,500.0,,-492395161.41000116,.
409000438620',2018-03-26,CR807413186350/RMCPL15035/1,,2018-03-26,3000.0,,-492398161.41000116,.
409000438620',2018-03-26,CR807413186340/RMCPL24303/1,,2018-03-26,1000.0,,-492399161.41000116,.
409000438620',2018-03-26,CR807413186370/RMCPL18180/1,,2018-03-26,3000.0,,-492402161.41000116,.
409000438620',2018-03-26,CR807413186364/RMCPL09580/1,,2018-03-26,5000.0,,-492407161.41000116,.
409000438620',2018-03-26,CR807413186346/RMCPL23704/1,,2018-03-26,2000.0,,-492409161.41000116,.
409000438620',2018-03-26,CR807415227302/RMCPL20001/1,,2018-03-26,1500.0,,-492410661.41000116,.
409000438620',2018-03-26,CR807410111110/RMCPL12049/1,,2018-03-26,1000.0,,-492411661.41000116,.
409000438620',2018-03-26,CR807415227327/RMCPL20741/1,,2018-03-26,3000.0,,-492414661.41000116,.
409000438620',2018-03-26,CR807410111103/RMCPL21667/1,,2018-03-26,2000.0,,-492416661.41000116,.
409000438620',2018-03-26,CR807512532324/RMCPL23421/1,,2018-03-26,10000.0,,-492426661.41000116,.
409000438620',2018-03-26,CR807512532330/RMCPL19173/1,,2018-03-26,3000.0,,-492429661.41000116,.
409000438620',2018-03-26,CR807617018294/RMCPL00154/1,,2018-03-26,500.0,,-492430161.41000116,.
409000438620',2018-03-26,CR807612914711/RMCPL23885/1,,2018-03-26,5000.0,,-492435161.41000116,.
409000438620',2018-03-26,CR807610858193/RMCPL23283/1,,2018-03-26,10000.0,,-492445161.41000116,.
409000438620',2018-03-26,CR807610858186/RMCPL23230/1,,2018-03-26,500.0,,-492445661.41000116,.
409000438620',2018-03-26,CR807612895432/RMCPL23894/1,,2018-03-26,1000.0,,-492446661.41000116,.
409000438620',2018-03-26,CR807612895471/RMCPL13062/1,,2018-03-26,9500.0,,-492456161.41000116,.
409000438620',2018-03-26,CR807611877597/RMCPL19095/1,,2018-03-26,500.0,,-492456661.41000116,.
409000438620',2018-03-26,CR807610858194/RMCPL22560/1,,2018-03-26,2000.0,,-492458661.41000116,.
409000438620',2018-03-26,CR807612895494/RMCPL12563/1,,2018-03-26,1000.0,,-492459661.41000116,.
409000438620',2018-03-26,CR807612895451/RMCPL21641/1,,2018-03-26,2000.0,,-492461661.41000116,.
409000438620',2018-03-26,CR807612914691/RMCPL20898/1,,2018-03-26,5000.0,,-492466661.41000116,.
409000438620',2018-03-26,CR807612914698/RMCPL23224/1,,2018-03-26,4000.0,,-492470661.41000116,.
409000438620',2018-03-26,CR807612914693/RMCPL13062/1,,2018-03-26,500.0,,-492471161.41000116,.
409000438620',2018-03-26,CR807810459599/RMCPL19265/1,,2018-03-26,3000.0,,-492474161.41000116,.
409000438620',2018-03-26,CR807811476510/RMCPL20241/1,,2018-03-26,3000.0,,-492477161.41000116,.
409000438620',2018-03-26,CR807809430417/RMCPL19763/1,,2018-03-26,1500.0,,-492478661.41000116,.
409000438620',2018-03-26,CR807809430619/RMCPL23539/1,,2018-03-26,10000.0,,-492488661.41000116,.
409000438620',2018-03-26,CR807811476549/RMCPL21850/1,,2018-03-26,2500.0,,-492491161.41000116,.
409000438620',2018-03-26,CR807810459603/RMCPL21498/1,,2018-03-26,2500.0,,-492493661.41000116,.
409000438620',2018-03-26,CR807809430013/RMCPL16993/1,,2018-03-26,4000.0,,-492497661.41000116,.
409000438620',2018-03-26,TRF TO  Indiaforensic SERVICES I,,2018-03-26,10000000.0,,-502497661.41000116,.
409000438620',2018-03-26,TRF TO  Indiaforensic SERVICES I,,2018-03-26,13800000.0,,-516297661.41000116,.
409000438620',2018-03-26,TRF TO  Indiaforensic SERVICES I,,2018-03-26,15000000.0,,-531297661.41000116,.
409000438620',2018-03-26,TRF TO  Indiaforensic SERVICES I,,2018-03-26,15000000.0,,-546297661.4100012,.
409000438620',2018-03-26,AEPS ACQUIRING ADJ FEES 2,,2018-03-26,35.4,,-546297696.8100011,.
409000438620',2018-03-26,AEPS ACQ CR ADJ FEES 2303,,2018-03-26,1053.86,,-546298750.6700011,.
409000438620',2018-03-26,AEPS ACQ REP ADJ FEES 230,,2018-03-26,,97.35,-546298653.3200011,.
409000438620',2018-03-26,AEPS ACQ GF REP ADJ FEE 2,,2018-03-26,,91.45,-546298561.8700011,.
409000438620',2018-03-26,GF804612994123/RMCPL22935/1,,2018-03-26,,10000.0,-546288561.8700011,.
409000438620',2018-03-26,GF804616087179/RMCPL23260/1,,2018-03-26,,2500.0,-546286061.8700011,.
409000438620',2018-03-26,GF803415672053/RMCPL23260/0,,2018-03-26,,5000.0,-546281061.8700011,.
409000438620',2018-03-26,GF803811313864/RMCPL21556/0,,2018-03-26,,500.0,-546280561.8700011,.
409000438620',2018-03-26,GF803914904688/RMCPL00150/0,,2018-03-26,,1500.0,-546279061.8700011,.
409000438620',2018-03-26,GF805011726109/RMCPL24063/1,,2018-03-26,,500.0,-546278561.8700011,.
409000438620',2018-03-26,GF804413124755/RMCPL20069/1,,2018-03-26,,500.0,-546278061.8700011,.
409000438620',2018-03-26,GF804410003855/RMCPL12343/1,,2018-03-26,,2000.0,-546276061.8700011,.
409000438620',2018-03-26,GF804619198621/RMCPL08688/1,,2018-03-26,,500.0,-546275561.8700011,.
409000438620',2018-03-26,GF804412092303/RMCPL17789/1,,2018-03-26,,500.0,-546275061.8700011,.
409000438620',2018-03-26,GF804521780434/RMCPL19703/1,,2018-03-26,,1000.0,-546274061.8700011,.
409000438620',2018-03-26,AEPS Indiaforensic INCOME 230318,,2018-03-26,,180069.5,-546093992.3700011,.
409000438620',2018-03-26,AEPS Indiaforensic GST 230318,,2018-03-26,,32412.51,-546061579.8600011,.
409000438620',2018-03-26,AEPS Indiaforensic INCOME 240318,,2018-03-26,,88386.65,-545973193.2100011,.
409000438620',2018-03-26,AEPS Indiaforensic GST 240318,,2018-03-26,,15909.6,-545957283.6100011,.
409000438620',2018-03-26,AEPS Indiaforensic INCOME 250318,,2018-03-26,,38628.85,-545918654.7600011,.
409000438620',2018-03-26,AEPS Indiaforensic GST 250318,,2018-03-26,,6953.19,-545911701.570001,.
409000438620',2018-03-27,Indiaforensic AEPS NPCI WDL SET,,2018-03-27,,21974500.0,-523937201.570001,.
409000438620',2018-03-27,TRF TO  Indiaforensic SERVICES I,,2018-03-27,15000000.0,,-538937201.570001,.
409000438620',2018-03-27,TRF TO  Indiaforensic SERVICES I,,2018-03-27,7000000.0,,-545937201.570001,.
409000438620',2018-03-27,AEPS Indiaforensic INCOME 260318,,2018-03-27,,59507.15,-545877694.420001,.
409000438620',2018-03-27,AEPS Indiaforensic GST 260318,,2018-03-27,,10711.29,-545866983.1300011,.
409000438620',2018-03-28,Indiaforensic AEPS NPCI WDL SET,,2018-03-28,,22461500.0,-523405483.13000107,.
409000438620',2018-03-28,CB806714622893/RMCPL24447/0,,2018-03-28,10000.0,,-523415483.13000107,.
409000438620',2018-03-28,CB807111994180/RMCPL22691/1,,2018-03-28,5000.0,,-523420483.13000107,.
409000438620',2018-03-28,CB807413186348/RMCPL12580/1,,2018-03-28,7500.0,,-523427983.13000107,.
409000438620',2018-03-28,TRF TO  Indiaforensic SERVICES I,,2018-03-28,15000000.0,,-538427983.1300011,.
409000438620',2018-03-28,TRF TO  Indiaforensic SERVICES I,,2018-03-28,7500000.0,,-545927983.1300011,.
409000438620',2018-03-28,MAW/5029649809678170/NAGA,,2018-03-28,,500.0,-545927483.1300011,.
409000438620',2018-03-28,AEPS Indiaforensic INCOME 270318,,2018-03-28,,60742.75,-545866740.3800011,.
409000438620',2018-03-28,AEPS Indiaforensic GST 270318,,2018-03-28,,10933.7,-545855806.680001,.
409000438620',2018-03-28,AEPS ACQUIRING ADJ FEES 2,,2018-03-28,20.63,,-545855827.310001,.
409000438620',2018-03-28,AEPS ACQ REP ADJ FEES 270,,2018-03-28,,35.4,-545855791.910001,.
409000438620',2018-03-29,Indiaforensic AEPS NPCI WDL SET,,2018-03-29,,22042500.0,-523813291.91000104,.
409000438620',2018-03-29,AEPS Indiaforensic INCOME 280318,,2018-03-29,,58842.25,-523754449.66000104,.
409000438620',2018-03-29,AEPS Indiaforensic GST 280318,,2018-03-29,,10591.61,-523743858.050001,.
409000438620',2018-03-30,FUND TRF TO  Indiaforensic SERVI,,2018-03-30,15000000.0,,-538743858.050001,.
409000438620',2018-03-30,FUND TRF TO  Indiaforensic SERVI,,2018-03-30,5000000.0,,-543743858.050001,.
409000438620',2018-03-30,FUND TRF TO  Indiaforensic SERVI,,2018-03-30,2500000.0,,-546243858.050001,.
409000438620',2018-03-31,Indiaforensic AEPS NPCI WDL SET,,2018-03-31,,19777500.0,-526466358.050001,.
409000438620',2018-03-31,Indiaforensic AEPS NPCI WDL SET,,2018-03-31,,20281000.0,-506185358.050001,.
409000438620',2018-03-31,TRF TO Indiaforensic SERVICES IN,,2018-03-31,15000000.0,,-521185358.050001,.
409000438620',2018-03-31,TRF TO Indiaforensic SERVICES IN,,2018-03-31,15000000.0,,-536185358.050001,.
409000438620',2018-03-31,TRF TO Indiaforensic SERVICES IN,,2018-03-31,10000000.0,,-546185358.050001,.
409000438620',2018-03-31,AEPS ACQUIRING ADJ FEES 2,,2018-03-31,79.65,,-546185437.700001,.
409000438620',2018-03-31,AEPS ACQ REP ADJ FEES 290,,2018-03-31,,20.65,-546185417.050001,.
409000438620',2018-03-31,AEPS Indiaforensic INCOME 290318,,2018-03-31,,50625.45,-546134791.600001,.
409000438620',2018-03-31,AEPS Indiaforensic GST 290318,,2018-03-31,,9112.58,-546125679.0200009,.
409000438620',2018-03-31,AEPS Indiaforensic INCOME 300318,,2018-03-31,,52140.15,-546073538.870001,.
409000438620',2018-03-31,AEPS Indiaforensic GST 300318,,2018-03-31,,9385.23,-546064153.6400009,.
409000438620',2018-04-03,Indiaforensic AEPS NPCI WDL SET,,2018-04-03,,15327000.0,-530737153.64000094,.
409000438620',2018-04-03,NPCI NON RD CHG_AUG17 TO,,2018-04-03,671091.96,,-531408245.6000009,.
409000438620',2018-04-03,NPCI NON RD CHG_AUG17 TO,,2018-04-03,27.02,,-531408272.6200009,.
409000438620',2018-04-03,Indiaforensic AEPS NPCI WDL SET,,2018-04-03,,3425000.0,-527983272.6200009,.
409000438620',2018-04-03,Indiaforensic AEPS NPCI WDL SET,,2018-04-03,,17674000.0,-510309272.6200009,.
409000438620',2018-04-03,TRF TO  Indiaforensic SERVICES I,,2018-04-03,15000000.0,,-525309272.6200009,.
409000438620',2018-04-03,TRF TO  Indiaforensic SERVICES I,,2018-04-03,15000000.0,,-540309272.6200008,.
409000438620',2018-04-03,TRF TO  Indiaforensic SERVICES I,,2018-04-03,6000000.0,,-546309272.6200008,.
409000438620',2018-04-03,AEPS ACQUIRING ADJ FEES 0,,2018-04-03,35.4,,-546309308.0200008,.
409000438620',2018-04-03,AEPS ACQUIRING ADJ FEES 3,,2018-04-03,70.8,,-546309378.8200008,.
409000438620',2018-04-03,AEPS ACQ CR ADJ FEES 3103,,2018-04-03,607.7,,-546309986.5200008,.
409000438620',2018-04-03,AEPS ACQ REP ADJ FEES 020,,2018-04-03,,17.7,-546309968.8200008,.
409000438620',2018-04-03,AEPS ACQ REP ADJ FEES 310,,2018-04-03,,32.45,-546309936.3700007,.
409000438620',2018-04-03,AEPS Indiaforensic INCOME 310318,,2018-04-03,,41860.2,-546268076.1700007,.
409000438620',2018-04-03,AEPS Indiaforensic GST 310318,,2018-04-03,,7534.84,-546260541.3300006,.
409000438620',2018-04-03,AEPS Indiaforensic INCOME 010418,,2018-04-03,,9559.3,-546250982.0300007,.
409000438620',2018-04-03,AEPS Indiaforensic GST 010418,,2018-04-03,,1720.67,-546249261.3600007,.
409000438620',2018-04-03,AEPS Indiaforensic INCOME 020418,,2018-04-03,,45153.55,-546204107.8100008,.
409000438620',2018-04-03,AEPS Indiaforensic GST 020418,,2018-04-03,,8127.64,-546195980.1700008,.
409000438620',2018-04-04,MAW/5029649803446863/Akol,,2018-04-04,,5000.0,-546190980.1700008,.
409000438620',2018-04-04,Indiaforensic AEPS NPCI WDL SET,,2018-04-04,,26856000.0,-519334980.1700008,.
409000438620',2018-04-04,CR807907754349/RMCPL17457/2,,2018-04-04,2000.0,,-519336980.1700008,.
409000438620',2018-04-04,CR807907754341/RMCPL23284/2,,2018-04-04,2000.0,,-519338980.1700008,.
409000438620',2018-04-04,CR807910808825/RMCPL16254/2,,2018-04-04,3000.0,,-519341980.1700008,.
409000438620',2018-04-04,CR807910807697/RMCPL12815/2,,2018-04-04,2500.0,,-519344480.1700008,.
409000438620',2018-04-04,CR807912856826/RMCPL14017/2,,2018-04-04,2000.0,,-519346480.1700008,.
409000438620',2018-04-04,CR807909790932/RMCPL24499/2,,2018-04-04,6000.0,,-519352480.1700008,.
409000438620',2018-04-04,CR807910807693/RMCPL22373/2,,2018-04-04,1500.0,,-519353980.1700008,.
409000438620',2018-04-04,CR807910807645/RMCPL16561/2,,2018-04-04,10000.0,,-519363980.1700008,.
409000438620',2018-04-04,CR807910807640/RMCPL22746/2,,2018-04-04,1000.0,,-519364980.1700008,.
409000438620',2018-04-04,CR807910807639/RMCPL23650/2,,2018-04-04,1000.0,,-519365980.1700008,.
409000438620',2018-04-04,CR807907754359/RMCPL18140/2,,2018-04-04,500.0,,-519366480.1700008,.
409000438620',2018-04-04,CR807907754361/RMCPL21477/2,,2018-04-04,1500.0,,-519367980.1700008,.
409000438620',2018-04-04,CR807910807671/RMCPL22518/2,,2018-04-04,10000.0,,-519377980.1700008,.
409000438620',2018-04-04,CR807910808823/RMCPL17432/2,,2018-04-04,2000.0,,-519379980.1700008,.
409000438620',2018-04-04,CR807917963697/RMCPL21759/2,,2018-04-04,1000.0,,-519380980.1700008,.
409000438620',2018-04-04,CR808010151652/RMCPL17491/2,,2018-04-04,1000.0,,-519381980.1700008,.
409000438620',2018-04-04,CR808012214507/RMCPL16659/2,,2018-04-04,1000.0,,-519382980.1700008,.
409000438620',2018-04-04,CR808012214489/RMCPL12832/2,,2018-04-04,1000.0,,-519383980.1700008,.
409000438620',2018-04-04,CR808010151633/RMCPL19798/2,,2018-04-04,3000.0,,-519386980.1700008,.
409000438620',2018-04-04,CR808012214506/RMCPL14754/2,,2018-04-04,5000.0,,-519391980.1700008,.
409000438620',2018-04-04,CR808012214503/RMCPL13317/2,,2018-04-04,500.0,,-519392480.1700008,.
409000438620',2018-04-04,CR808111503580/RMCPL23929/2,,2018-04-04,6000.0,,-519398480.1700008,.
409000438620',2018-04-04,CR808112535248/RMCPL20906/2,,2018-04-04,10000.0,,-519408480.1700008,.
409000438620',2018-04-04,CR808112535320/RMCPL22564/2,,2018-04-04,1000.0,,-519409480.1700008,.
409000438620',2018-04-04,CR808112535290/RMCPL20881/2,,2018-04-04,5000.0,,-519414480.1700008,.
409000438620',2018-04-04,CR808310149875/RMCPL12312/2,,2018-04-04,1000.0,,-519415480.1700008,.
409000438620',2018-04-04,CR808312182983/RMCPL19752/2,,2018-04-04,10000.0,,-519425480.1700008,.
409000438620',2018-04-04,CR808312182971/RMCPL12312/2,,2018-04-04,1000.0,,-519426480.1700008,.
409000438620',2018-04-04,CR808312183001/RMCPL15535/2,,2018-04-04,1000.0,,-519427480.1700008,.
409000438620',2018-04-04,CR808310149888/RMCPL16723/2,,2018-04-04,500.0,,-519427980.1700008,.
409000438620',2018-04-04,CR808312182997/RMCPL17670/2,,2018-04-04,2000.0,,-519429980.1700008,.
409000438620',2018-04-04,CR808310149857/RMCPL23412/2,,2018-04-04,5500.0,,-519435480.1700008,.
409000438620',2018-04-04,CR808310149872/RMCPL23263/2,,2018-04-04,4500.0,,-519439980.1700008,.
409000438620',2018-04-04,CR808311166486/RMCPL11355/2,,2018-04-04,5000.0,,-519444980.1700008,.
409000438620',2018-04-04,CR808312182996/RMCPL11618/2,,2018-04-04,1000.0,,-519445980.1700008,.
409000438620',2018-04-04,CR808215933338/RMCPL13756/2,,2018-04-04,3000.0,,-519448980.1700008,.
409000438620',2018-04-04,CR808211842720/RMCPL17559/2,,2018-04-04,4000.0,,-519452980.1700008,.
409000438620',2018-04-04,CR808211842699/RMCPL19956/2,,2018-04-04,500.0,,-519453480.1700008,.
409000438620',2018-04-04,CR808213895589/RMCPL15326/2,,2018-04-04,500.0,,-519453980.1700008,.
409000438620',2018-04-04,CR808214915487/RMCPL18124/2,,2018-04-04,500.0,,-519454480.1700008,.
409000438620',2018-04-04,CR808211859848/RMCPL22037/2,,2018-04-04,1000.0,,-519455480.1700008,.
409000438620',2018-04-04,CR808212876772/RMCPL19415/2,,2018-04-04,8000.0,,-519463480.1700008,.
409000438620',2018-04-04,CR808213895578/RMCPL18179/2,,2018-04-04,2000.0,,-519465480.1700008,.
409000438620',2018-04-04,CR808211859831/RMCPL22777/2,,2018-04-04,6000.0,,-519471480.1700008,.
409000438620',2018-04-04,CR808215933339/RMCPL21104/2,,2018-04-04,2000.0,,-519473480.1700008,.
409000438620',2018-04-04,CR808211842716/RMCPL16185/2,,2018-04-04,500.0,,-519473980.1700008,.
409000438620',2018-04-04,CR808212876775/RMCPL24654/2,,2018-04-04,1000.0,,-519474980.1700008,.
409000438620',2018-04-04,CR808511672459/RMCPL21174/2,,2018-04-04,2000.0,,-519476980.1700008,.
409000438620',2018-04-04,CR808509637410/RMCPL22781/2,,2018-04-04,500.0,,-519477480.1700008,.
409000438620',2018-04-04,CR808610977804/RMCPL23751/2,,2018-04-04,2000.0,,-519479480.1700008,.
409000438620',2018-04-04,CR808610959068/RMCPL17538/2,,2018-04-04,5000.0,,-519484480.1700008,.
409000438620',2018-04-04,CR808610959092/RMCPL18325/2,,2018-04-04,1500.0,,-519485980.1700008,.
409000438620',2018-04-04,CR808618148412/RMCPL17292/2,,2018-04-04,1000.0,,-519486980.1700008,.
409000438620',2018-04-04,CR808610959065/RMCPL22308/2,,2018-04-04,500.0,,-519487480.1700008,.
409000438620',2018-04-04,CR808711326096/RMCPL24082/2,,2018-04-04,1000.0,,-519488480.1700008,.
409000438620',2018-04-04,CR808711326093/RMCPL18175/2,,2018-04-04,4500.0,,-519492980.1700008,.
409000438620',2018-04-04,CR808711326109/RMCPL18940/2,,2018-04-04,1500.0,,-519494480.1700008,.
409000438620',2018-04-04,TRF TO  Indiaforensic SERVICES I,,2018-04-04,15000000.0,,-534494480.1700008,.
409000438620',2018-04-04,TRF TO  Indiaforensic SERVICES I,,2018-04-04,11800000.0,,-546294480.1700008,.
409000438620',2018-04-04,CB808112535313/RMCPL16998/2,,2018-04-04,10000.0,,-546304480.1700008,.
409000438620',2018-04-04,CB807907754337/RMCPL11735/2,,2018-04-04,5000.0,,-546309480.1700008,.
409000438620',2018-04-04,MAW/5029649806318192/DAMO,,2018-04-04,,500.0,-546308980.1700008,.
409000438620',2018-04-04,MAW/5029649801376989/GUNA,,2018-04-04,,2000.0,-546306980.1700008,.
409000438620',2018-04-04,MAW/5029649801376955/GUNA,,2018-04-04,,500.0,-546306480.1700008,.
409000438620',2018-04-04,AEPS Indiaforensic INCOME 030418,,2018-04-04,,69176.0,-546237304.1700008,.
409000438620',2018-04-04,AEPS Indiaforensic GST 030418,,2018-04-04,,12451.68,-546224852.4900008,.
409000438620',2018-04-05,Indiaforensic AEPS NPCI WDL SET,,2018-04-05,,28451000.0,-517773852.49000084,.
409000438620',2018-04-05,TRF TO Indiaforensic SERVICES IN,,2018-04-05,13500000.0,,-531273852.49000084,.
409000438620',2018-04-05,TRF TO Indiaforensic SERVICES IN,,2018-04-05,15000000.0,,-546273852.4900008,.
409000438620',2018-04-05,AEPS ACQ CR ADJ FEES 0404,,2018-04-05,38.35,,-546273890.8400009,.
409000438620',2018-04-05,CR809213951460/RMCPL22950/2,,2018-04-05,500.0,,-546274390.8400009,.
409000438620',2018-04-05,CR809012362267/RMCPL15896/3,,2018-04-05,2500.0,,-546276890.8400009,.
409000438620',2018-04-05,CR809018460466/RMCPL24506/3,,2018-04-05,500.0,,-546277390.8400009,.
409000438620',2018-04-05,CR808810664451/RMCPL11888/2,,2018-04-05,4500.0,,-546281890.8400009,.
409000438620',2018-04-05,AEPS ACQ REP ADJ FEES 040,,2018-04-05,,88.5,-546281802.3400009,.
409000438620',2018-04-05,AEPS Indiaforensic INCOME 040418,,2018-04-05,,74051.6,-546207750.7400008,.
409000438620',2018-04-05,AEPS Indiaforensic GST 040418,,2018-04-05,,13329.29,-546194421.4500009,.
409000438620',2018-04-05,CB807910807688/RMCPL13546/2,,2018-04-05,,1000.0,-546193421.4500009,.
409000438620',2018-04-05,CB807910807642/RMCPL21160/2,,2018-04-05,,1000.0,-546192421.4500009,.
409000438620',2018-04-06,Indiaforensic AEPS NPCI WDL SET,,2018-04-06,,27538000.0,-518654421.4500009,.
409000438620',2018-04-06,TRF TO  Indiaforensic SERVICES I,,2018-04-06,15000000.0,,-533654421.4500009,.
409000438620',2018-04-06,TRF TO  Indiaforensic SERVICES I,,2018-04-06,12600000.0,,-546254421.4500009,.
409000438620',2018-04-06,MAW/5029649805706785/Akol,,2018-04-06,,1500.0,-546252921.4500009,.
409000438620',2018-04-06,AEPS ACQUIRING ADJ FEES 0,,2018-04-06,17.7,,-546252939.1500009,.
409000438620',2018-04-06,AEPS Indiaforensic INCOME 050418,,2018-04-06,,71532.9,-546181406.250001,.
409000438620',2018-04-06,AEPS Indiaforensic GST 050418,,2018-04-06,,12875.92,-546168530.330001,.
409000438620',2018-04-07,Indiaforensic AEPS NPCI WDL SET,,2018-04-07,,24265500.0,-521903030.330001,.
409000438620',2018-04-07,MAW/5029649805974573/Akol,,2018-04-07,,4500.0,-521898530.330001,.
409000438620',2018-04-07,TRF TO Indiaforensic SERVICES IN,,2018-04-07,15000000.0,,-536898530.330001,.
409000438620',2018-04-07,TRF TO Indiaforensic SERVICES IN,,2018-04-07,5000000.0,,-541898530.330001,.
409000438620',2018-04-07,TRF TO Indiaforensic SERVICES IN,,2018-04-07,4000000.0,,-545898530.330001,.
409000438620',2018-04-07,AEPS ACQ CR ADJ FEES 0604,,2018-04-07,165.18,,-545898695.510001,.
409000438620',2018-04-07,CR809311202673/RMCPL09155/0,,2018-04-07,1000.0,,-545899695.510001,.
409000438620',2018-04-07,CR809313250897/RMCPL23878/0,,2018-04-07,1000.0,,-545900695.510001,.
409000438620',2018-04-07,CR809313250881/RMCPL24438/0,,2018-04-07,2000.0,,-545902695.510001,.
409000438620',2018-04-07,CR809310190188/RMCPL21854/0,,2018-04-07,10000.0,,-545912695.510001,.
409000438620',2018-04-07,CR809310190176/RMCPL20244/0,,2018-04-07,3000.0,,-545915695.510001,.
409000438620',2018-04-07,CR809310190194/RMCPL09591/0,,2018-04-07,10000.0,,-545925695.510001,.
409000438620',2018-04-07,CR809408467144/RMCPL18750/0,,2018-04-07,3000.0,,-545928695.510001,.
409000438620',2018-04-07,CR809409483175/RMCPL24040/0,,2018-04-07,500.0,,-545929195.510001,.
409000438620',2018-04-07,CR809411532113/RMCPL11794/0,,2018-04-07,500.0,,-545929695.510001,.
409000438620',2018-04-07,CR809410496540/RMCPL16457/0,,2018-04-07,1500.0,,-545931195.510001,.
409000438620',2018-04-07,CR809409483205/RMCPL16427/0,,2018-04-07,10000.0,,-545941195.510001,.
409000438620',2018-04-07,CR809410509699/RMCPL20331/0,,2018-04-07,4000.0,,-545945195.510001,.
409000438620',2018-04-07,CR809409483184/RMCPL14454/0,,2018-04-07,5000.0,,-545950195.510001,.
409000438620',2018-04-07,CR809310190203/RMCPL24086/0,,2018-04-07,500.0,,-545950695.510001,.
409000438620',2018-04-07,AEPS Indiaforensic INCOME 060418,,2018-04-07,,62385.4,-545888310.110001,.
409000438620',2018-04-07,AEPS Indiaforensic GST 060418,,2018-04-07,,11229.37,-545877080.740001,.
409000438620',2018-04-09,Indiaforensic AEPS NPCI WDL SET,,2018-04-09,,25527000.0,-520350080.74000096,.
409000438620',2018-04-09,Indiaforensic AEPS NPCI WDL SET,,2018-04-09,,17816500.0,-502533580.74000096,.
409000438620',2018-04-09,TRF TO  Indiaforensic SERVICES I,,2018-04-09,15000000.0,,-517533580.74000096,.
409000438620',2018-04-09,TRF TO  Indiaforensic SERVICES I,,2018-04-09,15000000.0,,-532533580.74000096,.
409000438620',2018-04-09,TRF TO  Indiaforensic SERVICES I,,2018-04-09,13700000.0,,-546233580.740001,.
409000438620',2018-04-09,AEPS ACQ CR ADJ FEES 0704,,2018-04-09,70.8,,-546233651.5400009,.
409000438620',2018-04-09,CR809513933643/RMCPL19636/0,,2018-04-09,1500.0,,-546235151.5400009,.
409000438620',2018-04-09,CR809513933653/RMCPL22469/0,,2018-04-09,3000.0,,-546238151.5400009,.
409000438620',2018-04-09,CR809512903457/RMCPL20943/0,,2018-04-09,500.0,,-546238651.5400009,.
409000438620',2018-04-09,CR809511890847/RMCPL16630/0,,2018-04-09,10000.0,,-546248651.5400009,.
409000438620',2018-04-09,CR809511890832/RMCPL01864/0,,2018-04-09,10000.0,,-546258651.5400009,.
409000438620',2018-04-09,CR809512903440/RMCPL15901/0,,2018-04-09,500.0,,-546259151.5400009,.
409000438620',2018-04-09,CR809511890843/RMCPL14428/0,,2018-04-09,500.0,,-546259651.5400009,.
409000438620',2018-04-09,AEPS Indiaforensic INCOME 070418,,2018-04-09,,67076.4,-546192575.1400009,.
409000438620',2018-04-09,AEPS Indiaforensic GST 070418,,2018-04-09,,12073.75,-546180501.3900009,.
409000438620',2018-04-09,AEPS Indiaforensic INCOME 080418,,2018-04-09,,48032.95,-546132468.4400009,.
409000438620',2018-04-09,AEPS Indiaforensic GST 080418,,2018-04-09,,8645.93,-546123822.510001,.
409000438620',2018-04-10,AEPS ACQUIRING ADJ FEES 0,,2018-04-10,53.1,,-546123875.610001,.
409000438620',2018-04-10,AEPS ACQ REP ADJ FEES 090,,2018-04-10,,17.7,-546123857.9100009,.
409000438620',2018-04-10,Indiaforensic AEPS NPCI WDL SET,,2018-04-10,,26619000.0,-519504857.9100009,.
409000438620',2018-04-11,TRF TO  Indiaforensic SERVICES I,,2018-04-11,15000000.0,,-534504857.9100009,.
409000438620',2018-04-11,TRF TO  Indiaforensic SERVICES I,,2018-04-11,10000000.0,,-544504857.9100009,.
409000438620',2018-04-11,TRF TO  Indiaforensic SERVICES I,,2018-04-11,1000000.0,,-545504857.9100009,.
409000438620',2018-04-11,TRRF TO  Indiaforensic SERVICES,,2018-04-11,500000.0,,-546004857.9100009,.
409000438620',2018-04-11,Indiaforensic AEPS NPCI WDL SET,,2018-04-11,,28279000.0,-517725857.9100009,.
409000438620',2018-04-11,TRF TO  Indiaforensic SERVICES I,,2018-04-11,15000000.0,,-532725857.9100009,.
409000438620',2018-04-11,TRF TO  Indiaforensic SERVICES I,,2018-04-11,13500000.0,,-546225857.9100009,.
409000438620',2018-04-11,AEPS Indiaforensic INCOME 090418,,2018-04-11,,70462.3,-546155395.610001,.
409000438620',2018-04-11,AEPS Indiaforensic GST 090418,,2018-04-11,,12683.21,-546142712.4000009,.
409000438620',2018-04-11,AEPS Indiaforensic INCOME 100418,,2018-04-11,,33019.53,-546109692.870001,.
409000438620',2018-04-11,AEPS Indiaforensic GST 100418,,2018-04-11,,73816.15,-546035876.720001,.
409000438620',2018-04-12,Indiaforensic AEPS NPCI WDL SET,,2018-04-12,,25751000.0,-520284876.720001,.
409000438620',2018-04-12,TRF TO  Indiaforensic SERVICES I,,2018-04-12,15000000.0,,-535284876.720001,.
409000438620',2018-04-12,TRF TO  Indiaforensic SERVICES I,,2018-04-12,11000000.0,,-546284876.720001,.
409000438620',2018-04-12,AEPS ACQUIRING ADJ FEES 1,,2018-04-12,29.5,,-546284906.220001,.
409000438620',2018-04-12,AEPS ACQ CR ADJ FEES 1104,,2018-04-12,79.65,,-546284985.870001,.
409000438620',2018-04-12,CR809815923816/RMCPL19374/0,,2018-04-12,500.0,,-546285485.870001,.
409000438620',2018-04-12,CR809711534674/RMCPL23499/0,,2018-04-12,1500.0,,-546286985.870001,.
409000438620',2018-04-12,CR809709501201/RMCPL10677/0,,2018-04-12,10000.0,,-546296985.870001,.
409000438620',2018-04-12,CR809709500981/RMCPL23268/0,,2018-04-12,6000.0,,-546302985.870001,.
409000438620',2018-04-12,CR809710506676/RMCPL21966/0,,2018-04-12,1000.0,,-546303985.870001,.
409000438620',2018-04-12,CR809711534665/RMCPL23878/0,,2018-04-12,1000.0,,-546304985.870001,.
409000438620',2018-04-12,CR809616306546/RMCPL16346/0,,2018-04-12,3000.0,,-546307985.870001,.
409000438620',2018-04-12,CR809616306542/RMCPL23821/0,,2018-04-12,500.0,,-546308485.870001,.
409000438620',2018-04-12,AEPS Indiaforensic INCOME 110418,,2018-04-12,,67246.9,-546241238.970001,.
409000438620',2018-04-12,AEPS Indiaforensic GST 110418,,2018-04-12,,12104.44,-546229134.5300009,.
409000438620',2018-04-13,Indiaforensic AEPS NPCI WDL SET,,2018-04-13,,25977500.0,-520251634.5300009,.
409000438620',2018-04-13,REV AEPS Indiaforensic INCOME 10,,2018-04-13,33019.53,,-520284654.0600009,.
409000438620',2018-04-13,REV AEPS Indiaforensic GST 10041,,2018-04-13,73816.15,,-520358470.2100009,.
409000438620',2018-04-13,AEPS Indiaforensic INCOME 100418,,2018-04-13,,73816.16,-520284654.05000085,.
409000438620',2018-04-13,AEPS Indiaforensic GST 100418,,2018-04-13,,13286.91,-520271367.1400008,.
409000438620',2018-04-13,TRF TO  Indiaforensic SERVICES I,,2018-04-13,15000000.0,,-535271367.1400008,.
409000438620',2018-04-13,TRF TO  Indiaforensic SERVICES I,,2018-04-13,11000000.0,,-546271367.1400008,.
409000438620',2018-04-13,AEPS Indiaforensic INCOME 120418,,2018-04-13,,66900.1,-546204467.0400008,.
409000438620',2018-04-13,AEPS Indiaforensic GST 120418,,2018-04-13,,12042.02,-546192425.0200008,.
409000438620',2018-04-16,Indiaforensic AEPS NPCI WDL SET,,2018-04-16,,31464000.0,-514728425.0200008,.
409000438620',2018-04-16,Indiaforensic AEPS NPCI WDL SET,,2018-04-16,,25383000.0,-489345425.0200008,.
409000438620',2018-04-16,Indiaforensic AEPS NPCI WDL SET,,2018-04-16,,10377000.0,-478968425.0200008,.
409000438620',2018-04-16,TRF TO  Indiaforensic SERVICES I,,2018-04-16,15000000.0,,-493968425.0200008,.
409000438620',2018-04-16,TRF TO  Indiaforensic SERVICES I,,2018-04-16,15000000.0,,-508968425.0200008,.
409000438620',2018-04-16,TRF TO  Indiaforensic SERVICES I,,2018-04-16,15000000.0,,-523968425.0200008,.
409000438620',2018-04-16,TRF TO  Indiaforensic SERVICES I,,2018-04-16,15000000.0,,-538968425.0200008,.
409000438620',2018-04-16,TRF TO  Indiaforensic SERVICES I,,2018-04-16,7300000.0,,-546268425.0200008,.
409000438620',2018-04-16,AEPS Indiaforensic INCOME 130418,,2018-04-16,,82174.4,-546186250.6200008,.
409000438620',2018-04-16,AEPS Indiaforensic GST 130418,,2018-04-16,,14791.39,-546171459.2300009,.
409000438620',2018-04-16,AEPS Indiaforensic INCOME 140418,,2018-04-16,,66684.4,-546104774.8300009,.
409000438620',2018-04-16,AEPS Indiaforensic GST 140418,,2018-04-16,,12003.19,-546092771.6400008,.
409000438620',2018-04-16,AEPS Indiaforensic INCOME 150418,,2018-04-16,,28683.75,-546064087.8900008,.
409000438620',2018-04-16,AEPS Indiaforensic GST 150418,,2018-04-16,,5163.08,-546058924.8100008,.
409000438620',2018-04-16,AEPS ACQCR ADJ FEES 13041,,2018-04-16,525.1,,-546059449.9100008,.
409000438620',2018-04-16,CR809909106807/RMCPL21389/0,,2018-04-16,3000.0,,-546062449.9100008,.
409000438620',2018-04-16,CR809909106746/RMCPL24712/0,,2018-04-16,6000.0,,-546068449.9100008,.
409000438620',2018-04-16,CR809910122577/RMCPL18122/0,,2018-04-16,1000.0,,-546069449.9100008,.
409000438620',2018-04-16,CR809910122600/RMCPL18701/0,,2018-04-16,5000.0,,-546074449.9100008,.
409000438620',2018-04-16,CR809910122599/RMCPL17634/0,,2018-04-16,1000.0,,-546075449.9100008,.
409000438620',2018-04-16,CR809910122582/RMCPL21457/0,,2018-04-16,500.0,,-546075949.9100008,.
409000438620',2018-04-16,CR809910128488/RMCPL19118/0,,2018-04-16,2000.0,,-546077949.9100008,.
409000438620',2018-04-16,CR809910128148/RMCPL23963/0,,2018-04-16,2500.0,,-546080449.9100008,.
409000438620',2018-04-16,CR809910128230/RMCPL13963/0,,2018-04-16,2000.0,,-546082449.9100008,.
409000438620',2018-04-16,CR809910128405/RMCPL24871/0,,2018-04-16,1000.0,,-546083449.9100008,.
409000438620',2018-04-16,CR809910128221/RMCPL20329/0,,2018-04-16,2000.0,,-546085449.9100008,.
409000438620',2018-04-16,CR809910128137/RMCPL23669/0,,2018-04-16,1500.0,,-546086949.9100008,.
409000438620',2018-04-16,CR809910134390/RMCPL21515/0,,2018-04-16,2000.0,,-546088949.9100008,.
409000438620',2018-04-16,CR809911139397/RMCPL19904/0,,2018-04-16,5000.0,,-546093949.9100008,.
409000438620',2018-04-16,CR809911146611/RMCPL19949/0,,2018-04-16,1000.0,,-546094949.9100008,.
409000438620',2018-04-16,CR809911153811/RMCPL13526/0,,2018-04-16,500.0,,-546095449.9100008,.
409000438620',2018-04-16,CR809911153894/RMCPL16946/0,,2018-04-16,10000.0,,-546105449.9100008,.
409000438620',2018-04-16,CR809911151696/RMCPL20899/0,,2018-04-16,1000.0,,-546106449.9100008,.
409000438620',2018-04-16,CR809911153865/RMCPL11889/0,,2018-04-16,10000.0,,-546116449.9100008,.
409000438620',2018-04-16,CR809911153869/RMCPL23425/0,,2018-04-16,1000.0,,-546117449.9100008,.
409000438620',2018-04-16,CR809911153899/RMCPL09497/0,,2018-04-16,3000.0,,-546120449.9100008,.
409000438620',2018-04-16,CR809911153898/RMCPL03659/0,,2018-04-16,2500.0,,-546122949.9100008,.
409000438620',2018-04-16,CR809911159372/RMCPL12334/0,,2018-04-16,500.0,,-546123449.9100008,.
409000438620',2018-04-16,CR809911158375/RMCPL24812/0,,2018-04-16,10000.0,,-546133449.9100008,.
409000438620',2018-04-16,CR809911159397/RMCPL18403/0,,2018-04-16,500.0,,-546133949.9100008,.
409000438620',2018-04-16,CR809911160241/RMCPL19587/0,,2018-04-16,500.0,,-546134449.9100008,.
409000438620',2018-04-16,CR809911159415/RMCPL17486/0,,2018-04-16,4500.0,,-546138949.9100008,.
409000438620',2018-04-16,CR809911159265/RMCPL24866/0,,2018-04-16,5000.0,,-546143949.9100008,.
409000438620',2018-04-16,CR809911159773/RMCPL14060/0,,2018-04-16,500.0,,-546144449.9100008,.
409000438620',2018-04-16,CR809911159266/RMCPL21775/0,,2018-04-16,1500.0,,-546145949.9100008,.
409000438620',2018-04-16,CR809911159398/RMCPL21715/0,,2018-04-16,2000.0,,-546147949.9100008,.
409000438620',2018-04-16,CR809911160670/RMCPL14060/0,,2018-04-16,10000.0,,-546157949.9100008,.
409000438620',2018-04-16,CR809912160684/RMCPL19219/0,,2018-04-16,5000.0,,-546162949.9100008,.
409000438620',2018-04-16,CR809911159382/RMCPL20248/0,,2018-04-16,1000.0,,-546163949.9100008,.
409000438620',2018-04-16,CR809911160280/RMCPL23072/0,,2018-04-16,7000.0,,-546170949.9100008,.
409000438620',2018-04-16,CR809911160256/RMCPL14360/0,,2018-04-16,500.0,,-546171449.9100008,.
409000438620',2018-04-16,CR809914210228/RMCPL00198/0,,2018-04-16,500.0,,-546171949.9100008,.
409000438620',2018-04-16,CR809914211599/RMCPL23046/0,,2018-04-16,1500.0,,-546173449.9100008,.
409000438620',2018-04-16,CR809914210720/RMCPL13065/0,,2018-04-16,1000.0,,-546174449.9100008,.
409000438620',2018-04-16,CR809914211608/RMCPL20049/0,,2018-04-16,1000.0,,-546175449.9100008,.
409000438620',2018-04-16,CR809914211289/RMCPL09726/0,,2018-04-16,10000.0,,-546185449.9100008,.
409000438620',2018-04-16,CR809914211605/RMCPL19017/0,,2018-04-16,2000.0,,-546187449.9100008,.
409000438620',2018-04-16,CR809914211610/RMCPL00198/0,,2018-04-16,5000.0,,-546192449.9100008,.
409000438620',2018-04-16,CR809916253237/RMCPL22216/0,,2018-04-16,5000.0,,-546197449.9100008,.
409000438620',2018-04-16,CR810011494131/RMCPL09169/1,,2018-04-16,1500.0,,-546198949.9100008,.
409000438620',2018-04-16,CR810014547657/RMCPL21218/1,,2018-04-16,1000.0,,-546199949.9100008,.
409000438620',2018-04-16,CR810017599824/RMCPL19554/1,,2018-04-16,2000.0,,-546201949.9100008,.
409000438620',2018-04-16,CR810011494143/RMCPL20307/1,,2018-04-16,1500.0,,-546203449.9100008,.
409000438620',2018-04-16,CR810014548085/RMCPL20332/1,,2018-04-16,500.0,,-546203949.9100008,.
409000438620',2018-04-16,AEPS ACQREP ADJ FEES 1304,,2018-04-16,,53.1,-546203896.8100008,.
409000438620',2018-04-17,Indiaforensic AEPS NPCI WDL SET,,2018-04-17,,28248500.0,-517955396.8100008,.
409000438620',2018-04-17,TRF TO  Indiaforensic SERVICES I,,2018-04-17,15000000.0,,-532955396.8100008,.
409000438620',2018-04-17,TRF TO  Indiaforensic SERVICES I,,2018-04-17,13300000.0,,-546255396.8100008,.
409000438620',2018-04-17,AEPS ACQ REP ADJ FEES 160,,2018-04-17,,29.5,-546255367.3100008,.
409000438620',2018-04-17,AEPS Indiaforensic INCOME 160418,,2018-04-17,,75657.6,-546179709.7100008,.
409000438620',2018-04-17,AEPS Indiaforensic GST 160418,,2018-04-17,,13618.37,-546166091.3400007,.
409000438620',2018-04-18,Indiaforensic AEPS NPCI WDL SET,,2018-04-18,,27638000.0,-518528091.34000075,.
409000438620',2018-04-18,CR810111819036/RMCPL18175/1,,2018-04-18,10000.0,,-518538091.34000075,.
409000438620',2018-04-18,CR810110781887/RMCPL15556/1,,2018-04-18,1000.0,,-518539091.34000075,.
409000438620',2018-04-18,CR810112844687/RMCPL16727/1,,2018-04-18,2500.0,,-518541591.34000075,.
409000438620',2018-04-18,CR810213189711/RMCPL19331/1,,2018-04-18,1000.0,,-518542591.34000075,.
409000438620',2018-04-18,CR810210124776/RMCPL19766/1,,2018-04-18,3500.0,,-518546091.34000075,.
409000438620',2018-04-18,CR810210124641/RMCPL13299/1,,2018-04-18,3000.0,,-518549091.34000075,.
409000438620',2018-04-18,CR810214216611/RMCPL18165/1,,2018-04-18,500.0,,-518549591.34000075,.
409000438620',2018-04-18,CR810214216859/RMCPL22502/1,,2018-04-18,2000.0,,-518551591.34000075,.
409000438620',2018-04-18,CR810216244741/RMCPL21855/1,,2018-04-18,1000.0,,-518552591.34000075,.
409000438620',2018-04-18,CR810210124448/RMCPL23993/1,,2018-04-18,7000.0,,-518559591.34000075,.
409000438620',2018-04-18,CR810210124784/RMCPL12563/1,,2018-04-18,10000.0,,-518569591.34000075,.
409000438620',2018-04-18,CR810210124782/RMCPL10752/1,,2018-04-18,500.0,,-518570091.34000075,.
409000438620',2018-04-18,CR810210121557/RMCPL07044/1,,2018-04-18,500.0,,-518570591.34000075,.
409000438620',2018-04-18,CR810213197769/RMCPL09982/1,,2018-04-18,500.0,,-518571091.34000075,.
409000438620',2018-04-18,CR810214216073/RMCPL24602/1,,2018-04-18,10000.0,,-518581091.34000075,.
409000438620',2018-04-18,CR810213189712/RMCPL17553/1,,2018-04-18,2000.0,,-518583091.34000075,.
409000438620',2018-04-18,CR810212164237/RMCPL20998/1,,2018-04-18,3000.0,,-518586091.34000075,.
409000438620',2018-04-18,TRF TO  Indiaforensic SERVICES I,,2018-04-18,15000000.0,,-533586091.34000075,.
409000438620',2018-04-18,TRF TO  Indiaforensic SERVICES I,,2018-04-18,12700000.0,,-546286091.3400007,.
409000438620',2018-04-18,AEPS ACQ CR ADJ FEES 1704,,2018-04-18,191.75,,-546286283.0900007,.
409000438620',2018-04-18,AEPS Indiaforensic INCOME 170418,,2018-04-18,,73782.75,-546212500.3400007,.
409000438620',2018-04-18,AEPS Indiaforensic GST 170418,,2018-04-18,,13280.9,-546199219.4400008,.
409000438620',2018-04-19,Indiaforensic AEPS NPCI WDL SET,,2018-04-19,,37473500.0,-508725719.4400008,.
409000438620',2018-04-19,TRF TO  Indiaforensic SERVICES I,,2018-04-19,500000.0,,-509225719.4400008,.
409000438620',2018-04-19,TRF TO  Indiaforensic SERVICES I,,2018-04-19,2000000.0,,-511225719.4400008,.
409000438620',2018-04-19,TRF TO  Indiaforensic SERVICES I,,2018-04-19,5000000.0,,-516225719.4400008,.
409000438620',2018-04-19,TRF TO  Indiaforensic SERVICES I,,2018-04-19,15000000.0,,-531225719.4400008,.
409000438620',2018-04-19,TRF TO  Indiaforensic SERVICES I,,2018-04-19,15000000.0,,-546225719.4400008,.
409000438620',2018-04-19,AEPS Indiaforensic INCOME 180418,,2018-04-19,,99353.73,-546126365.7100008,.
409000438620',2018-04-19,AEPS Indiaforensic GST 180418,,2018-04-19,,17883.67,-546108482.0400008,.
409000438620',2018-04-20,Indiaforensic AEPS NPCI WDL SET,,2018-04-20,,33964500.0,-512143982.0400008,.
409000438620',2018-04-20,TRF TO  Indiaforensic SERVICES I,,2018-04-20,15000000.0,,-527143982.0400008,.
409000438620',2018-04-20,TRF TO  Indiaforensic SERVICES I,,2018-04-20,15000000.0,,-542143982.0400008,.
409000438620',2018-04-20,TRF TO  Indiaforensic SERVICES I,,2018-04-20,4000000.0,,-546143982.0400008,.
409000438620',2018-04-20,AEPS Indiaforensic INCOME 190418,,2018-04-20,,91050.84,-546052931.2000008,.
409000438620',2018-04-20,AEPS Indiaforensic GST 190418,,2018-04-20,,16389.15,-546036542.0500008,.
409000438620',2018-04-20,AEPS ACQ CR ADJ FEES 1904,,2018-04-20,542.8,,-546037084.8500007,.
409000438620',2018-04-20,CR810410756238/RMCPL17909/1,,2018-04-20,9000.0,,-546046084.8500007,.
409000438620',2018-04-20,CR810410741727/RMCPL18349/1,,2018-04-20,1000.0,,-546047084.8500007,.
409000438620',2018-04-20,CR810410741728/RMCPL24016/1,,2018-04-20,10000.0,,-546057084.8500007,.
409000438620',2018-04-20,CR810410741726/RMCPL22690/1,,2018-04-20,500.0,,-546057584.8500007,.
409000438620',2018-04-20,CR810410756293/RMCPL18701/1,,2018-04-20,1000.0,,-546058584.8500007,.
409000438620',2018-04-20,CR810411765285/RMCPL18859/1,,2018-04-20,4000.0,,-546062584.8500007,.
409000438620',2018-04-20,CR810409726175/RMCPL11405/1,,2018-04-20,500.0,,-546063084.8500007,.
409000438620',2018-04-20,CR810407694679/RMCPL15602/1,,2018-04-20,2000.0,,-546065084.8500007,.
409000438620',2018-04-20,CR810310432980/RMCPL18872/1,,2018-04-20,500.0,,-546065584.8500007,.
409000438620',2018-04-20,CR810316556537/RMCPL20795/1,,2018-04-20,6500.0,,-546072084.8500007,.
409000438620',2018-04-20,CR810316556565/RMCPL23049/1,,2018-04-20,500.0,,-546072584.8500007,.
409000438620',2018-04-20,CR810314516672/RMCPL19130/1,,2018-04-20,500.0,,-546073084.8500007,.
409000438620',2018-04-20,CR810314516685/RMCPL17852/1,,2018-04-20,1500.0,,-546074584.8500007,.
409000438620',2018-04-20,CR810314516687/RMCPL15112/1,,2018-04-20,1000.0,,-546075584.8500007,.
409000438620',2018-04-20,CR810311468471/RMCPL14954/1,,2018-04-20,1000.0,,-546076584.8500007,.
409000438620',2018-04-20,CR810709532225/RMCPL23592/1,,2018-04-20,5000.0,,-546081584.8500007,.
409000438620',2018-04-20,CR810712594483/RMCPL20185/1,,2018-04-20,1000.0,,-546082584.8500007,.
409000438620',2018-04-20,CR810712594493/RMCPL16105/1,,2018-04-20,2000.0,,-546084584.8500007,.
409000438620',2018-04-20,CR810712594484/RMCPL16529/1,,2018-04-20,500.0,,-546085084.8500007,.
409000438620',2018-04-20,CR810711569193/RMCPL23561/1,,2018-04-20,3000.0,,-546088084.8500007,.
409000438620',2018-04-20,CR810709532218/RMCPL22429/1,,2018-04-20,1000.0,,-546089084.8500007,.
409000438620',2018-04-20,CR810712607580/RMCPL18231/1,,2018-04-20,10000.0,,-546099084.8500007,.
409000438620',2018-04-20,CR810710546195/RMCPL22580/1,,2018-04-20,3000.0,,-546102084.8500007,.
409000438620',2018-04-20,CR810712594479/RMCPL18244/1,,2018-04-20,500.0,,-546102584.8500007,.
409000438620',2018-04-20,CR810709532224/RMCPL21130/1,,2018-04-20,5000.0,,-546107584.8500007,.
409000438620',2018-04-20,CR810711569215/RMCPL11784/1,,2018-04-20,2000.0,,-546109584.8500007,.
409000438620',2018-04-20,CR810712594480/RMCPL22610/1,,2018-04-20,2000.0,,-546111584.8500007,.
409000438620',2018-04-20,CR810712594485/RMCPL13859/1,,2018-04-20,1500.0,,-546113084.8500007,.
409000438620',2018-04-20,CR810710546183/RMCPL24551/1,,2018-04-20,4000.0,,-546117084.8500007,.
409000438620',2018-04-20,CR810714633840/RMCPL20307/1,,2018-04-20,1000.0,,-546118084.8500007,.
409000438620',2018-04-20,CR810714632158/RMCPL20284/1,,2018-04-20,500.0,,-546118584.8500007,.
409000438620',2018-04-20,CR810711582116/RMCPL21675/1,,2018-04-20,4000.0,,-546122584.8500007,.
409000438620',2018-04-20,CR810711582121/RMCPL18254/1,,2018-04-20,1000.0,,-546123584.8500007,.
409000438620',2018-04-20,CR810712607578/RMCPL18486/1,,2018-04-20,4500.0,,-546128084.8500007,.
409000438620',2018-04-20,CR810713621405/RMCPL11793/1,,2018-04-20,4000.0,,-546132084.8500007,.
409000438620',2018-04-20,CR810711569206/RMCPL22950/1,,2018-04-20,500.0,,-546132584.8500007,.
409000438620',2018-04-20,CR810711582125/RMCPL23269/1,,2018-04-20,2000.0,,-546134584.8500007,.
409000438620',2018-04-20,CR810613320438/RMCPL09726/1,,2018-04-20,1000.0,,-546135584.8500007,.
409000438620',2018-04-20,CR810610263609/RMCPL14558/1,,2018-04-20,1000.0,,-546136584.8500007,.
409000438620',2018-04-20,CR810610251307/RMCPL19701/1,,2018-04-20,2000.0,,-546138584.8500007,.
409000438620',2018-04-20,CR810609232148/RMCPL24928/1,,2018-04-20,1000.0,,-546139584.8500007,.
409000438620',2018-04-20,CR810616359876/RMCPL20427/1,,2018-04-20,1000.0,,-546140584.8500007,.
409000438620',2018-04-20,CR810610251306/RMCPL20358/1,,2018-04-20,500.0,,-546141084.8500007,.
409000438620',2018-04-20,CR810610251355/RMCPL20913/1,,2018-04-20,2000.0,,-546143084.8500007,.
409000438620',2018-04-20,CR810610263554/RMCPL12838/1,,2018-04-20,4500.0,,-546147584.8500007,.
409000438620',2018-04-20,CR810611287694/RMCPL22799/1,,2018-04-20,5000.0,,-546152584.8500007,.
409000438620',2018-04-20,CR810616372180/RMCPL15209/1,,2018-04-20,500.0,,-546153084.8500007,.
409000438620',2018-04-20,CR810609232811/RMCPL24472/1,,2018-04-20,500.0,,-546153584.8500007,.
409000438620',2018-04-20,CR810609232091/RMCPL17352/1,,2018-04-20,10000.0,,-546163584.8500007,.
409000438620',2018-04-20,CR810613308069/RMCPL16151/1,,2018-04-20,500.0,,-546164084.8500007,.
409000438620',2018-04-20,CR810616372174/RMCPL17678/1,,2018-04-20,500.0,,-546164584.8500007,.
409000438620',2018-04-20,CR810609231682/RMCPL10689/1,,2018-04-20,3000.0,,-546167584.8500007,.
409000438620',2018-04-20,CR810609232324/RMCPL23829/1,,2018-04-20,2000.0,,-546169584.8500007,.
409000438620',2018-04-20,CR810613308064/RMCPL10937/1,,2018-04-20,4000.0,,-546173584.8500007,.
409000438620',2018-04-21,Indiaforensic AEPS NPCI WDL SET,,2018-04-21,,25689200.0,-520484384.85000074,.
409000438620',2018-04-21,Indiaforensic NON RD CHG OCT17TO,,2018-04-21,1480210.6,,-521964595.45000076,.
409000438620',2018-04-21,Indfor-IFC NONRD CHG OCT17TO,,2018-04-21,46.0,,-521964641.45000076,.
409000438620',2018-04-21,Indiaforensic NON RD GST OCT17TO,,2018-04-21,266437.91,,-522231079.3600008,.
409000438620',2018-04-21,Indfor-IFC NONRD GST OCT17TO,,2018-04-21,8.28,,-522231087.64000076,.
409000438620',2018-04-21,TRF TO  Indiaforensic SERVICES I,,2018-04-21,15000000.0,,-537231087.6400008,.
409000438620',2018-04-21,TRF TO  Indiaforensic SERVICES I,,2018-04-21,5000000.0,,-542231087.6400008,.
409000438620',2018-04-21,TRF TO  Indiaforensic SERVICES I,,2018-04-21,4000000.0,,-546231087.6400008,.
409000438620',2018-04-21,AEPS ACQ CR ADJ FEES 2004,,2018-04-21,70.8,,-546231158.4400008,.
409000438620',2018-04-21,CR810809860497/RMCPL12343/1,,2018-04-21,1000.0,,-546232158.4400008,.
409000438620',2018-04-21,CR810809860519/RMCPL11566/1,,2018-04-21,1000.0,,-546233158.4400008,.
409000438620',2018-04-21,CR810810874422/RMCPL18381/1,,2018-04-21,5000.0,,-546238158.4400008,.
409000438620',2018-04-21,CR810810874437/RMCPL12343/1,,2018-04-21,5000.0,,-546243158.4400008,.
409000438620',2018-04-21,CR810810874457/RMCPL25168/1,,2018-04-21,1000.0,,-546244158.4400008,.
409000438620',2018-04-21,CR810812914748/RMCPL14698/1,,2018-04-21,5500.0,,-546249658.4400008,.
409000438620',2018-04-21,AEPS Indiaforensic INCOME 200418,,2018-04-21,,68405.55,-546181252.8900008,.
409000438620',2018-04-21,AEPS Indiaforensic GST 200418,,2018-04-21,,12313.0,-546168939.8900008,.
409000438620',2018-04-23,Indiaforensic AEPS NPCI WDL SET,,2018-04-23,,25149900.0,-521019039.8900008,.
409000438620',2018-04-23,Indiaforensic AEPS NPCI WDL SET,,2018-04-23,,18170800.0,-502848239.8900008,.
409000438620',2018-04-23,TRF TO  Indiaforensic SERVICES I,,2018-04-23,15000000.0,,-517848239.8900008,.
409000438620',2018-04-23,TRF TO  Indiaforensic SERVICES I,,2018-04-23,15000000.0,,-532848239.8900008,.
409000438620',2018-04-23,TRF TO  Indiaforensic SERVICES I,,2018-04-23,10000000.0,,-542848239.8900008,.
409000438620',2018-04-23,TRF TO  Indiaforensic SERVICES I,,2018-04-23,3000000.0,,-545848239.8900008,.
409000438620',2018-04-23,AEPS Indiaforensic INCOME 210418,,2018-04-23,,67816.39,-545780423.5000008,.
409000438620',2018-04-23,AEPS Indiaforensic GST 210418,,2018-04-23,,12206.95,-545768216.5500008,.
409000438620',2018-04-23,AEPS Indiaforensic INCOME 220418,,2018-04-23,,49907.98,-545718308.5700008,.
409000438620',2018-04-23,AEPS Indiaforensic GST 220418,,2018-04-23,,8983.44,-545709325.1300007,.
409000438620',2018-04-23,AEPS ACQUIRING ADJ FEES 2,,2018-04-23,73.75,,-545709398.8800007,.
409000438620',2018-04-23,AEPS ACQ CR ADJ FEES 2104,,2018-04-23,191.75,,-545709590.6300007,.
409000438620',2018-04-23,CR810912229860/RMCPL24995/1,,2018-04-23,500.0,,-545710090.6300007,.
409000438620',2018-04-23,CR810911197212/RMCPL20185/1,,2018-04-23,2000.0,,-545712090.6300007,.
409000438620',2018-04-23,CR810912229875/RMCPL21532/1,,2018-04-23,1500.0,,-545713590.6300007,.
409000438620',2018-04-23,CR810912229861/RMCPL13859/1,,2018-04-23,2000.0,,-545715590.6300007,.
409000438620',2018-04-23,CR810912220583/RMCPL12563/1,,2018-04-23,10000.0,,-545725590.6300007,.
409000438620',2018-04-23,CR810910173136/RMCPL17167/1,,2018-04-23,2000.0,,-545727590.6300007,.
409000438620',2018-04-23,CR810912229843/RMCPL22607/1,,2018-04-23,1000.0,,-545728590.6300007,.
409000438620',2018-04-23,CR810912229867/RMCPL16427/1,,2018-04-23,1000.0,,-545729590.6300007,.
409000438620',2018-04-23,CR810912229862/RMCPL12794/1,,2018-04-23,2000.0,,-545731590.6300007,.
409000438620',2018-04-23,CR810912220565/RMCPL12343/1,,2018-04-23,1000.0,,-545732590.6300007,.
409000438620',2018-04-23,CR810917297684/RMCPL20241/1,,2018-04-23,2500.0,,-545735090.6300007,.
409000438620',2018-04-23,CR810911197226/RMCPL11827/1,,2018-04-23,10000.0,,-545745090.6300007,.
409000438620',2018-04-23,CR810912229863/RMCPL20434/1,,2018-04-23,1500.0,,-545746590.6300007,.
409000438620',2018-04-23,CR810910173141/RMCPL17468/1,,2018-04-23,4000.0,,-545750590.6300007,.
409000438620',2018-04-23,CR810912229841/RMCPL23228/1,,2018-04-23,1500.0,,-545752090.6300007,.
409000438620',2018-04-23,CR810912220563/RMCPL21906/1,,2018-04-23,3500.0,,-545755590.6300007,.
409000438620',2018-04-23,CR810912229842/RMCPL14405/1,,2018-04-23,2000.0,,-545757590.6300007,.
409000438620',2018-04-24,Indiaforensic AEPS NPCI WDL SET,,2018-04-24,,31002300.0,-514755290.6300007,.
409000438620',2018-04-24,TRF TO  Indiaforensic SERVICES I,,2018-04-24,15000000.0,,-529755290.6300007,.
409000438620',2018-04-24,TRF TO  Indiaforensic SERVICES I,,2018-04-24,15000000.0,,-544755290.6300007,.
409000438620',2018-04-24,TRF TO  Indiaforensic SERVICES I,,2018-04-24,1000000.0,,-545755290.6300007,.
409000438620',2018-04-24,TRF TO  Indiaforensic SERVICES I,,2018-04-24,500000.0,,-546255290.6300007,.
409000438620',2018-04-24,AEPS ACQUIRING ADJ FEES 2,,2018-04-24,2.95,,-546255293.5800008,.
409000438620',2018-04-24,AEPS Indiaforensic INCOME 230418,,2018-04-24,,83504.22,-546171789.3600007,.
409000438620',2018-04-24,AEPS Indiaforensic GST 230418,,2018-04-24,,15030.76,-546156758.6000007,.
409000438620',2018-04-25,Indiaforensic AEPS NPCI WDL SET,,2018-04-25,,28689300.0,-517467458.60000074,.
409000438620',2018-04-25,TRF TO  Indiaforensic SERVICES I,,2018-04-25,15000000.0,,-532467458.60000074,.
409000438620',2018-04-25,TRF TO  Indiaforensic SERVICES I,,2018-04-25,13800000.0,,-546267458.6000007,.
409000438620',2018-04-25,AEPS Indiaforensic INCOME 240418,,2018-04-25,,78195.81,-546189262.7900008,.
409000438620',2018-04-25,AEPS Indiaforensic GST 240418,,2018-04-25,,14075.25,-546175187.5400008,.
409000438620',2018-04-25,AEPS ACQ REP ADJ FEES 240,,2018-04-25,,76.7,-546175110.8400007,.
409000438620',2018-04-26,Indiaforensic AEPS NPCI WDL SET,,2018-04-26,,27061600.0,-519113510.84000075,.
409000438620',2018-04-26,TRF TO  Indiaforensic SERVICES I,,2018-04-26,12200000.0,,-531313510.84000075,.
409000438620',2018-04-26,TRF TO  Indiaforensic SERVICES I,,2018-04-26,15000000.0,,-546313510.8400007,.
409000438620',2018-04-26,AEPS Indiaforensic INCOME 250418,,2018-04-26,,72475.22,-546241035.6200007,.
409000438620',2018-04-26,AEPS Indiaforensic GST 250418,,2018-04-26,,13045.54,-546227990.0800008,.
409000438620',2018-04-26,AEPS ACQUIRING ADJ FEES 2,,2018-04-26,17.7,,-546228007.7800008,.
409000438620',2018-04-27,CR811311334831/RMCPL19730/2,,2018-04-27,1000.0,,-546229007.7800008,.
409000438620',2018-04-27,CR811316443434/RMCPL15112/2,,2018-04-27,1000.0,,-546230007.7800008,.
409000438620',2018-04-27,CR811317460579/RMCPL23035/2,,2018-04-27,1500.0,,-546231507.7800008,.
409000438620',2018-04-27,CR811317460597/RMCPL13376/2,,2018-04-27,500.0,,-546232007.7800008,.
409000438620',2018-04-27,CR811312356000/RMCPL24759/2,,2018-04-27,3000.0,,-546235007.7800008,.
409000438620',2018-04-27,CR811311334841/RMCPL23398/2,,2018-04-27,500.0,,-546235507.7800008,.
409000438620',2018-04-27,CR811311334832/RMCPL20827/2,,2018-04-27,7000.0,,-546242507.7800008,.
409000438620',2018-04-27,CR811311334836/RMCPL18189/2,,2018-04-27,2000.0,,-546244507.7800008,.
409000438620',2018-04-27,CR811312367814/RMCPL18061/2,,2018-04-27,2000.0,,-546246507.7800008,.
409000438620',2018-04-27,CR811309298733/RMCPL22246/2,,2018-04-27,3000.0,,-546249507.7800008,.
409000438620',2018-04-27,CR811316443395/RMCPL24836/2,,2018-04-27,3000.0,,-546252507.7800008,.
409000438620',2018-04-27,CR811317460571/RMCPL22523/2,,2018-04-27,5000.0,,-546257507.7800008,.
409000438620',2018-04-27,CR811111787813/RMCPL16727/2,,2018-04-27,1000.0,,-546258507.7800008,.
409000438620',2018-04-27,CR811111787824/RMCPL16736/2,,2018-04-27,3000.0,,-546261507.7800008,.
409000438620',2018-04-27,CR811110774799/RMCPL24926/2,,2018-04-27,2100.0,,-546263607.7800008,.
409000438620',2018-04-27,CR811113822338/RMCPL11784/2,,2018-04-27,500.0,,-546264107.7800008,.
409000438620',2018-04-27,CR811113822370/RMCPL21107/2,,2018-04-27,1500.0,,-546265607.7800008,.
409000438620',2018-04-27,CR811110774831/RMCPL13859/2,,2018-04-27,2500.0,,-546268107.7800008,.
409000438620',2018-04-27,CR811113822367/RMCPL13124/2,,2018-04-27,600.0,,-546268707.7800008,.
409000438620',2018-04-27,CR811009460540/RMCPL15764/2,,2018-04-27,500.0,,-546269207.7800008,.
409000438620',2018-04-27,CR811009460543/RMCPL19297/2,,2018-04-27,1000.0,,-546270207.7800008,.
409000438620',2018-04-27,CR811009456459/RMCPL18217/2,,2018-04-27,6000.0,,-546276207.7800008,.
409000438620',2018-04-27,CR811011490074/RMCPL23898/2,,2018-04-27,10000.0,,-546286207.7800008,.
409000438620',2018-04-27,CR811013531324/RMCPL07629/2,,2018-04-27,2500.0,,-546288707.7800008,.
409000438620',2018-04-27,CR811011490072/RMCPL18042/2,,2018-04-27,10000.0,,-546298707.7800008,.
409000438620',2018-04-27,CR811016588106/RMCPL25199/2,,2018-04-27,500.0,,-546299207.7800008,.
409000438620',2018-04-27,CR811015560945/RMCPL12343/2,,2018-04-27,500.0,,-546299707.7800008,.
409000438620',2018-04-27,CR811011496631/RMCPL18408/2,,2018-04-27,5000.0,,-546304707.7800008,.
409000438620',2018-04-27,CR811016588099/RMCPL22063/2,,2018-04-27,2500.0,,-546307207.7800008,.
409000438620',2018-04-27,Indiaforensic AEPS NPCI WDL SET,,2018-04-27,,28401000.0,-517906207.7800008,.
409000438620',2018-04-27,TRF TO  Indiaforensic SERVICES I,,2018-04-27,15000000.0,,-532906207.7800008,.
409000438620',2018-04-27,TRF TO  Indiaforensic SERVICES I,,2018-04-27,13400000.0,,-546306207.7800008,.
409000438620',2018-04-27,AEPS ACQUIRING CR ADJ FEE,,2018-04-27,319.78,,-546306527.5600008,.
409000438620',2018-04-27,AEPS ACQUIRING REP ADJ FE,,2018-04-27,,5.9,-546306521.6600008,.
409000438620',2018-04-27,AEPS Indiaforensic INCOME 260418,,2018-04-27,,76940.71,-546229580.9500008,.
409000438620',2018-04-27,AEPS Indiaforensic GST 260418,,2018-04-27,,13849.33,-546215731.6200007,.
409000438620',2018-04-30,Indiaforensic AEPS NPCI WDL SET,,2018-04-30,,28639700.0,-517576031.6200007,.
409000438620',2018-04-30,Indiaforensic AEPS NPCI WDL SET,,2018-04-30,,24446700.0,-493129331.6200007,.
409000438620',2018-04-30,Indiaforensic AEPS NPCI WDL SET,,2018-04-30,,12961800.0,-480167531.6200007,.
409000438620',2018-04-30,AEPS Indiaforensic INCOME 270418,,2018-04-30,,76524.24,-480091007.3800007,.
409000438620',2018-04-30,AEPS Indiaforensic GST 270418,,2018-04-30,,13774.36,-480077233.0200007,.
409000438620',2018-04-30,AEPS Indiaforensic INCOME 280418,,2018-04-30,,64691.31,-480012541.7100007,.
409000438620',2018-04-30,AEPS Indiaforensic GST 280418,,2018-04-30,,11644.44,-480000897.2700007,.
409000438620',2018-04-30,AEPS Indiaforensic INCOME 290418,,2018-04-30,,36150.66,-479964746.61000067,.
409000438620',2018-04-30,AEPS Indiaforensic GST 290418,,2018-04-30,,6507.12,-479958239.49000067,.
409000438620',2018-04-30,AEPS ACQUIRING ADJ FEES 2,,2018-04-30,17.7,,-479958257.19000065,.
409000438620',2018-04-30,AEPS ACQ CR ADJ FEES 2704,,2018-04-30,144.55,,-479958401.74000067,.
409000438620',2018-04-30,CR811511963467/RMCPL10677/2,,2018-04-30,5000.0,,-479963401.74000067,.
409000438620',2018-04-30,CR811510953138/RMCPL22919/2,,2018-04-30,500.0,,-479963901.74000067,.
409000438620',2018-04-30,CR811512989522/RMCPL20772/2,,2018-04-30,500.0,,-479964401.74000067,.
409000438620',2018-04-30,CR811511975295/RMCPL18215/2,,2018-04-30,10000.0,,-479974401.74000067,.
409000438620',2018-04-30,CR811512989506/RMCPL23152/2,,2018-04-30,1000.0,,-479975401.74000067,.
409000438620',2018-04-30,CR811512989515/RMCPL09897/2,,2018-04-30,1500.0,,-479976901.74000067,.
409000438620',2018-04-30,CR811510953150/RMCPL17403/2,,2018-04-30,5500.0,,-479982401.74000067,.
409000438620',2018-04-30,CR811510940598/RMCPL15377/2,,2018-04-30,5000.0,,-479987401.74000067,.
409000438620',2018-04-30,CR811511975301/RMCPL20510/2,,2018-04-30,3000.0,,-479990401.74000067,.
409000438620',2018-04-30,CR811511963466/RMCPL22837/2,,2018-04-30,10000.0,,-480000401.74000067,.
409000438620',2018-04-30,CR811517068859/RMCPL18011/2,,2018-04-30,8000.0,,-480008401.74000067,.
409000438620',2018-04-30,AEPS ACQ REP ADJ FEES 270,,2018-04-30,,17.7,-480008384.0400007,.
409000438620',2018-05-01,Indiaforensic AEPS NPCI WDL SET,,2018-05-01,,19262800.0,-460745584.0400007,.
409000438620',2018-05-01,TRF TO  Indiaforensic SERVICES I,,2018-05-01,15000000.0,,-475745584.0400007,.
409000438620',2018-05-01,TRF TO  Indiaforensic SERVICES I,,2018-05-01,15000000.0,,-490745584.0400007,.
409000438620',2018-05-01,TRF TO  Indiaforensic SERVICES I,,2018-05-01,15000000.0,,-505745584.0400007,.
409000438620',2018-05-01,TRF TO  Indiaforensic SERVICES I,,2018-05-01,10000000.0,,-515745584.0400007,.
409000438620',2018-05-01,TRF TO  Indiaforensic SERVICES I,,2018-05-01,10000000.0,,-525745584.0400007,.
409000438620',2018-05-01,AEPS ACQUIRING ADJ FEES 3,,2018-05-01,17.7,,-525745601.74000067,.
409000438620',2018-05-01,AEPS Indiaforensic INCOME 300418,,2018-05-01,,51608.43,-525693993.31000066,.
409000438620',2018-05-01,AEPS Indiaforensic GST 300418,,2018-05-01,,9289.52,-525684703.7900007,.
409000438620',2018-05-01,TRF TO  Indiaforensic SERVICES I,,2018-05-01,5500000.0,,-531184703.7900007,.
409000438620',2018-05-01,TRF TO  Indiaforensic SERVICES I,,2018-05-01,15000000.0,,-546184703.7900007,.
409000438620',2018-05-02,Indiaforensic AEPS NPCI WDL SET,,2018-05-02,,24817400.0,-521367303.7900007,.
409000438620',2018-05-02,TRF TO  Indiaforensic SERVICES I,,2018-05-02,15000000.0,,-536367303.7900007,.
409000438620',2018-05-02,TRF TO  Indiaforensic SERVICES I,,2018-05-02,9900000.0,,-546267303.7900007,.
409000438620',2018-05-02,AEPS ACQ REP ADJ FEES 010,,2018-05-02,,17.7,-546267286.0900006,.
409000438620',2018-05-03,Indiaforensic AEPS NPCI WDL SET,,2018-05-03,,27620500.0,-518646786.0900006,.
409000438620',2018-05-03,CR811812844473/RMCPL12334/2,,2018-05-03,1000.0,,-518647786.0900006,.
409000438620',2018-05-03,CR811812844469/RMCPL22724/2,,2018-05-03,2400.0,,-518650186.0900006,.
409000438620',2018-05-03,CR811812844480/RMCPL25136/2,,2018-05-03,500.0,,-518650686.0900006,.
409000438620',2018-05-03,CR811812844481/RMCPL19554/2,,2018-05-03,500.0,,-518651186.0900006,.
409000438620',2018-05-03,CR811711555043/RMCPL12832/2,,2018-05-03,2500.0,,-518653686.0900006,.
409000438620',2018-05-03,CR811711555032/RMCPL22583/2,,2018-05-03,5000.0,,-518658686.0900006,.
409000438620',2018-05-03,CR811709527835/RMCPL19910/2,,2018-05-03,2500.0,,-518661186.0900006,.
409000438620',2018-05-03,CR811709527839/RMCPL18508/2,,2018-05-03,2000.0,,-518663186.0900006,.
409000438620',2018-05-03,CR811709527858/RMCPL18236/2,,2018-05-03,4000.0,,-518667186.0900006,.
409000438620',2018-05-03,CR811710542711/RMCPL23088/2,,2018-05-03,2000.0,,-518669186.0900006,.
409000438620',2018-05-03,CR811712574047/RMCPL23958/2,,2018-05-03,1000.0,,-518670186.0900006,.
409000438620',2018-05-03,CR811712574062/RMCPL24219/2,,2018-05-03,2000.0,,-518672186.0900006,.
409000438620',2018-05-03,CR811710542704/RMCPL17468/2,,2018-05-03,10000.0,,-518682186.0900006,.
409000438620',2018-05-03,CR811711567977/RMCPL13859/2,,2018-05-03,600.0,,-518682786.0900006,.
409000438620',2018-05-03,CR812016407412/RMCPL25621/3,,2018-05-03,1000.0,,-518683786.0900006,.
409000438620',2018-05-03,CR812013359147/RMCPL24103/3,,2018-05-03,10000.0,,-518693786.0900006,.
409000438620',2018-05-03,CR811611275502/RMCPL25418/2,,2018-05-03,3000.0,,-518696786.0900006,.
409000438620',2018-05-03,CR811613307254/RMCPL16402/2,,2018-05-03,1000.0,,-518697786.0900006,.
409000438620',2018-05-03,CR811611275525/RMCPL18236/2,,2018-05-03,500.0,,-518698286.0900006,.
409000438620',2018-05-03,CR811611275540/RMCPL15794/2,,2018-05-03,5600.0,,-518703886.0900006,.
409000438620',2018-05-03,CR811609221222/RMCPL24928/2,,2018-05-03,500.0,,-518704386.0900006,.
409000438620',2018-05-03,CR811611275539/RMCPL25362/2,,2018-05-03,500.0,,-518704886.0900006,.
409000438620',2018-05-03,CR811612297279/RMCPL14683/2,,2018-05-03,500.0,,-518705386.0900006,.
409000438620',2018-05-03,CR811613307262/RMCPL19390/2,,2018-05-03,4000.0,,-518709386.0900006,.
409000438620',2018-05-03,CR811611275536/RMCPL24897/2,,2018-05-03,500.0,,-518709886.0900006,.
409000438620',2018-05-03,CR811609221195/RMCPL13859/2,,2018-05-03,1000.0,,-518710886.0900006,.
409000438620',2018-05-03,CR811609210928/RMCPL15154/2,,2018-05-03,9000.0,,-518719886.0900006,.
409000438620',2018-05-03,TRF TO  Indiaforensic SERVICES I,,2018-05-03,15000000.0,,-533719886.0900006,.
409000438620',2018-05-03,TRF TO  Indiaforensic SERVICES I,,2018-05-03,12500000.0,,-546219886.0900006,.
409000438620',2018-05-03,AEPS ACQUIRING ADJ FEES 0,,2018-05-03,26.55,,-546219912.6400006,.
409000438620',2018-05-03,AEPS ACQ CR ADJ FEES 0205,,2018-05-03,274.35,,-546220186.9900006,.
409000438620',2018-05-03,AEPS ACQ REP ADJ FEES 020,,2018-05-03,,17.7,-546220169.2900006,.
409000438620',2018-05-04,Indiaforensic AEPS NPCI WDL SET,,2018-05-04,,30402600.0,-515817569.29000056,.
409000438620',2018-05-04,TRF TO  Indiaforensic SERVICES I,,2018-05-04,15000000.0,,-530817569.29000056,.
409000438620',2018-05-04,TRF TO  Indiaforensic SERVICES I,,2018-05-04,15000000.0,,-545817569.2900006,.
409000438620',2018-05-04,TRF TO  Indiaforensic SERVICES I,,2018-05-04,300000.0,,-546117569.2900006,.
409000438620',2018-05-04,AEPS ACQUIRING ADJ FEES 0,,2018-05-04,8.85,,-546117578.1400006,.
409000438620',2018-05-04,AEPS ACQ CR ADJ FEES 0305,,2018-05-04,64.9,,-546117643.0400006,.
409000438620',2018-05-04,CR812112628693/RMCPL11120/0,,2018-05-04,500.0,,-546118143.0400006,.
409000438620',2018-05-04,CR812112628699/RMCPL17645/0,,2018-05-04,10000.0,,-546128143.0400006,.
409000438620',2018-05-04,CR812112628668/RMCPL21583/0,,2018-05-04,6500.0,,-546134643.0400006,.
409000438620',2018-05-04,CR812112628679/RMCPL10401/0,,2018-05-04,10000.0,,-546144643.0400006,.
409000438620',2018-05-04,CR812110591999/RMCPL18488/0,,2018-05-04,1500.0,,-546146143.0400006,.
409000438620',2018-05-04,AEPS INCOME DT 01-05-2018,,2018-05-04,,58698.25,-546087444.7900006,.
409000438620',2018-05-04,AEPS GST INC DT 01-05-201,,2018-05-04,,11739.65,-546075705.1400006,.
409000438620',2018-05-04,AEPS INCOME DT 02-05-2018,,2018-05-04,,65328.7,-546010376.4400005,.
409000438620',2018-05-04,AEPS GST INC DT 02-05-201,,2018-05-04,,13065.74,-545997310.7000005,.
409000438620',2018-05-04,AEPS INCOME DT 03-05-2018,,2018-05-04,,71483.62,-545925827.0800005,.
409000438620',2018-05-04,AEPS GST INC DT 03-05-201,,2018-05-04,,14296.72,-545911530.3600005,.
409000438620',2018-05-05,Indiaforensic AEPS NPCI WDL SET,,2018-05-05,,29166700.0,-516744830.3600005,.
409000438620',2018-05-05,NEFT/000037499765/ICICI B,,2018-05-05,2000.0,,-516746830.3600005,.
409000438620',2018-05-05,TRF TO  Indiaforensic SERVICES I,,2018-05-05,10000000.0,,-526746830.3600005,.
409000438620',2018-05-05,TRF TO  Indiaforensic SERVICES I,,2018-05-05,5000000.0,,-531746830.3600005,.
409000438620',2018-05-05,TRF TO  Indiaforensic SERVICES I,,2018-05-05,4000000.0,,-535746830.3600005,.
409000438620',2018-05-05,TRF TO  Indiaforensic SERVICES I,,2018-05-05,500000.0,,-536246830.3600005,.
409000438620',2018-05-05,TRF TO  Indiaforensic SERVICES I,,2018-05-05,10000000.0,,-546246830.3600005,.
409000438620',2018-05-05,AEPS INCOME DT 05-04-2018,,2018-05-05,,69188.98,-546177641.3800005,.
409000438620',2018-05-05,AEPS GST INC DT 05-04-201,,2018-05-05,,13837.8,-546163803.5800005,.
409000438620',2018-05-05,AEPS ACQUIRING ADJ FEES 0,,2018-05-05,256.65,,-546164060.2300005,.
409000438620',2018-05-05,CB811412695732/RMCPL15589/2,,2018-05-05,1500.0,,-546165560.2300005,.
409000438620',2018-05-07,Indiaforensic AEPS NPCI WDL SET,,2018-05-07,,26882600.0,-519282960.2300005,.
409000438620',2018-05-07,Indiaforensic AEPS NPCI WDL SET,,2018-05-07,,15156200.0,-504126760.2300005,.
409000438620',2018-05-07,TRF TO  Indiaforensic SERVICES I,,2018-05-07,12100000.0,,-516226760.2300005,.
409000438620',2018-05-07,TRF TO  Indiaforensic SERVICES I,,2018-05-07,15000000.0,,-531226760.2300005,.
409000438620',2018-05-07,TRF TO  Indiaforensic SERVICES I,,2018-05-07,15000000.0,,-546226760.2300005,.
409000438620',2018-05-07,AEPS INCOME DT 05-05-2018,,2018-05-07,,65486.93,-546161273.3000005,.
409000438620',2018-05-07,AEPS GST INC DT 05-05-201,,2018-05-07,,13097.39,-546148175.9100006,.
409000438620',2018-05-07,AEPS INCOME DT 06-05-2018,,2018-05-07,,37279.9,-546110896.0100006,.
409000438620',2018-05-07,AEPS GST INC DT 06-05-201,,2018-05-07,,7455.98,-546103440.0300006,.
409000438620',2018-05-07,AEPS ACQUIRING ADJ FEES 0,,2018-05-07,35.4,,-546103475.4300005,.
409000438620',2018-05-07,AEPS ACQ REP ADJ FEES 050,,2018-05-07,,17.7,-546103457.7300005,.
409000438620',2018-05-08,Indiaforensic AEPS NPCI WDL SET,,2018-05-08,,26789800.0,-519313657.7300005,.
409000438620',2018-05-08,TRF TO  Indiaforensic SERVICES I,,2018-05-08,15000000.0,,-534313657.7300005,.
409000438620',2018-05-08,TRF TO  Indiaforensic SERVICES I,,2018-05-08,7000000.0,,-541313657.7300005,.
409000438620',2018-05-08,TRF TO  Indiaforensic SERVICES I,,2018-05-08,5000000.0,,-546313657.7300005,.
409000438620',2018-05-08,AEPS INCOME DT 05-07-2018,,2018-05-08,,65100.9,-546248556.8300005,.
409000438620',2018-05-08,AEPS GST INC DT 05-07-201,,2018-05-08,,13020.18,-546235536.6500006,.
409000438620',2018-05-08,AEPS ACQ REP ADJ FEES 070,,2018-05-08,,265.5,-546235271.1500006,.
409000438620',2018-05-09,Indiaforensic AEPS NPCI WDL SET,,2018-05-09,,29566900.0,-516668371.1500006,.
409000438620',2018-05-09,TRF TO  Indiaforensic SERVICES I,,2018-05-09,15000000.0,,-531668371.1500006,.
409000438620',2018-05-09,TRF TO  Indiaforensic SERVICES I,,2018-05-09,14600000.0,,-546268371.1500006,.
409000438620',2018-05-09,AEPS INCOME DT 08-05-2018,,2018-05-09,,70114.29,-546198256.8600006,.
409000438620',2018-05-09,AEPS GST INC DT 08-05-201,,2018-05-09,,14022.86,-546184234.0000006,.
409000438620',2018-05-09,AEPS ACQUIRING ADJ FEES 0,,2018-05-09,17.7,,-546184251.7000006,.
409000438620',2018-05-09,AEPS ACQ CR ADJ FEES 0805,,2018-05-09,359.9,,-546184611.6000006,.
409000438620',2018-05-09,CR812216005080/RMCPL21314/0,,2018-05-09,500.0,,-546185111.6000006,.
409000438620',2018-05-09,CR812210883124/RMCPL12342/0,,2018-05-09,2500.0,,-546187611.6000006,.
409000438620',2018-05-09,CR812217016801/RMCPL11247/0,,2018-05-09,10000.0,,-546197611.6000006,.
409000438620',2018-05-09,CR812216005078/RMCPL22420/0,,2018-05-09,2000.0,,-546199611.6000006,.
409000438620',2018-05-09,CR812212936149/RMCPL11951/0,,2018-05-09,3000.0,,-546202611.6000006,.
409000438620',2018-05-09,CR812212936154/RMCPL23808/0,,2018-05-09,500.0,,-546203111.6000006,.
409000438620',2018-05-09,CR812213950234/RMCPL25279/0,,2018-05-09,3000.0,,-546206111.6000006,.
409000438620',2018-05-09,CR812211910411/RMCPL17696/0,,2018-05-09,1000.0,,-546207111.6000006,.
409000438620',2018-05-09,CR812216005085/RMCPL14160/0,,2018-05-09,1000.0,,-546208111.6000006,.
409000438620',2018-05-09,CR812311200773/RMCPL18191/0,,2018-05-09,3000.0,,-546211111.6000006,.
409000438620',2018-05-09,CR812312237492/RMCPL25283/0,,2018-05-09,1000.0,,-546212111.6000006,.
409000438620',2018-05-09,CR812311213880/RMCPL15556/0,,2018-05-09,10000.0,,-546222111.6000006,.
409000438620',2018-05-09,CR812312225964/RMCPL12343/0,,2018-05-09,2000.0,,-546224111.6000006,.
409000438620',2018-05-09,CR812315276358/RMCPL13026/0,,2018-05-09,500.0,,-546224611.6000006,.
409000438620',2018-05-09,CR812311213873/RMCPL11618/0,,2018-05-09,1000.0,,-546225611.6000006,.
409000438620',2018-05-09,CR812312237485/RMCPL22799/0,,2018-05-09,1000.0,,-546226611.6000006,.
409000438620',2018-05-09,CR812310188123/RMCPL18662/0,,2018-05-09,500.0,,-546227111.6000006,.
409000438620',2018-05-09,CR812315276373/RMCPL22898/0,,2018-05-09,5000.0,,-546232111.6000006,.
409000438620',2018-05-09,CR812311213858/RMCPL21825/0,,2018-05-09,500.0,,-546232611.6000006,.
409000438620',2018-05-09,CR812311213862/RMCPL17115/0,,2018-05-09,3000.0,,-546235611.6000006,.
409000438620',2018-05-09,CR812311200794/RMCPL13078/0,,2018-05-09,10000.0,,-546245611.6000006,.
409000438620',2018-05-09,CR812411490695/RMCPL22237/0,,2018-05-09,6000.0,,-546251611.6000006,.
409000438620',2018-05-09,CR812412502519/RMCPL16204/0,,2018-05-09,5000.0,,-546256611.6000006,.
409000438620',2018-05-09,CR812412502530/RMCPL18577/0,,2018-05-09,6000.0,,-546262611.6000006,.
409000438620',2018-05-09,CR812412502505/RMCPL15786/0,,2018-05-09,5000.0,,-546267611.6000006,.
409000438620',2018-05-09,CR812411490705/RMCPL23086/0,,2018-05-09,2000.0,,-546269611.6000006,.
409000438620',2018-05-09,CR812411490687/RMCPL22777/0,,2018-05-09,4000.0,,-546273611.6000006,.
409000438620',2018-05-09,CR812512785361/RMCPL23894/0,,2018-05-09,5000.0,,-546278611.6000006,.
409000438620',2018-05-09,CR812509730306/RMCPL25099/0,,2018-05-09,5000.0,,-546283611.6000006,.
409000438620',2018-05-09,AEPS ACQ REP ADJ FEES 080,,2018-05-09,,35.4,-546283576.2000006,.
409000438620',2018-05-10,Indiaforensic AEPS NPCI WDL SET,,2018-05-10,,27216700.0,-519066876.20000064,.
409000438620',2018-05-10,TRF TO  Indiaforensic SERVICES I,,2018-05-10,15000000.0,,-534066876.20000064,.
409000438620',2018-05-10,TRF TO  Indiaforensic SERVICES I,,2018-05-10,12200000.0,,-546266876.2000006,.
409000438620',2018-05-10,AEPS INCOME DT 09-05-2018,,2018-05-10,,65719.43,-546201156.7700007,.
409000438620',2018-05-10,AEPS GST INC DT 09-05-201,,2018-05-10,,13143.89,-546188012.8800007,.
409000438620',2018-05-10,AEPS ACQUIRING ADJ FEES 0,,2018-05-10,29.5,,-546188042.3800007,.
409000438620',2018-05-10,AEPS ACQ REP ADJ FEES 080,,2018-05-10,,17.7,-546188024.6800007,.
409000438620',2018-05-11,Indiaforensic AEPS NPCI WDL SET,,2018-05-11,,25588400.0,-520599624.68000066,.
409000438620',2018-05-11,TRF TO  Indiaforensic SERVICES I,,2018-05-11,15000000.0,,-535599624.68000066,.
409000438620',2018-05-11,TRF TO  Indiaforensic SERVICES I,,2018-05-11,10700000.0,,-546299624.6800007,.
409000438620',2018-05-11,AEPS INCOME DT 10-05-2018,,2018-05-11,,61415.14,-546238209.5400007,.
409000438620',2018-05-11,AEPS GST INC DT 10-05-201,,2018-05-11,,12283.03,-546225926.5100007,.
409000438620',2018-05-11,AEPS ACQ CR ADJ FEES 1005,,2018-05-11,249.57,,-546226176.0800008,.
409000438620',2018-05-11,CR812711265403/RMCPL18417/0,,2018-05-11,4000.0,,-546230176.0800008,.
409000438620',2018-05-11,CR812711277017/RMCPL23346/0,,2018-05-11,1000.0,,-546231176.0800008,.
409000438620',2018-05-11,CR812712288788/RMCPL18125/0,,2018-05-11,1000.0,,-546232176.0800008,.
409000438620',2018-05-11,CR812713301552/RMCPL21311/0,,2018-05-11,700.0,,-546232876.0800008,.
409000438620',2018-05-11,CR812710257764/RMCPL17648/0,,2018-05-11,10000.0,,-546242876.0800008,.
409000438620',2018-05-11,CR812712288750/RMCPL20136/0,,2018-05-11,2400.0,,-546245276.0800008,.
409000438620',2018-05-11,CR812711265425/RMCPL24667/0,,2018-05-11,500.0,,-546245776.0800008,.
409000438620',2018-05-11,CR812716358074/RMCPL20396/0,,2018-05-11,3000.0,,-546248776.0800008,.
409000438620',2018-05-11,CR812715345810/RMCPL22341/0,,2018-05-11,10000.0,,-546258776.0800008,.
409000438620',2018-05-11,CR812711277028/RMCPL14523/0,,2018-05-11,2000.0,,-546260776.0800008,.
409000438620',2018-05-11,CR812816610471/RMCPL17468/0,,2018-05-11,9000.0,,-546269776.0800008,.
409000438620',2018-05-11,CR812816621117/RMCPL22490/0,,2018-05-11,5000.0,,-546274776.0800008,.
409000438620',2018-05-11,CR812810517978/RMCPL21984/0,,2018-05-11,1700.0,,-546276476.0800008,.
409000438620',2018-05-11,CR812810527755/RMCPL12626/0,,2018-05-11,6000.0,,-546282476.0800008,.
409000438620',2018-05-11,CR812817643120/RMCPL22098/0,,2018-05-11,5000.0,,-546287476.0800008,.
409000438620',2018-05-11,CR812811547460/RMCPL00472/0,,2018-05-11,5000.0,,-546292476.0800008,.
409000438620',2018-05-11,CR812816610498/RMCPL20319/0,,2018-05-11,10000.0,,-546302476.0800008,.
409000438620',2018-05-11,CR812817643125/RMCPL20899/0,,2018-05-11,3500.0,,-546305976.0800008,.
409000438620',2018-05-11,AEPS ACQ REP ADJ FEES 100,,2018-05-11,,29.5,-546305946.5800008,.
409000438620',2018-05-14,Indiaforensic AEPS NPCI WDL SET,,2018-05-14,,24988000.0,-521317946.58000076,.
409000438620',2018-05-14,Indiaforensic AEPS NPCI WDL SET,,2018-05-14,,22863500.0,-498454446.58000076,.
409000438620',2018-05-14,Indiaforensic AEPS NPCI WDL SET,,2018-05-14,,12178400.0,-486276046.58000076,.
409000438620',2018-05-14,TRF TO  Indiaforensic SERVICES I,,2018-05-14,15000000.0,,-501276046.58000076,.
409000438620',2018-05-14,TRF TO  Indiaforensic SERVICES I,,2018-05-14,15000000.0,,-516276046.58000076,.
409000438620',2018-05-14,TRF TO  Indiaforensic SERVICES I,,2018-05-14,15000000.0,,-531276046.58000076,.
409000438620',2018-05-14,TRF TO  Indiaforensic SERVICES I,,2018-05-14,15000000.0,,-546276046.5800008,.
409000438620',2018-05-14,AEPS ACQUIRING ADJ FEES 1,,2018-05-14,23.6,,-546276070.1800008,.
409000438620',2018-05-14,AEPS ACQ CR ADJ FEES 1105,,2018-05-14,47.2,,-546276117.3800008,.
409000438620',2018-05-14,CR812911810893/RMCPL25418/0,,2018-05-14,1000.0,,-546277117.3800008,.
409000438620',2018-05-14,CR812911810891/RMCPL16314/0,,2018-05-14,1000.0,,-546278117.3800008,.
409000438620',2018-05-14,CR812911822799/RMCPL19555/0,,2018-05-14,500.0,,-546278617.3800008,.
409000438620',2018-05-14,CR812917912910/RMCPL23858/0,,2018-05-14,10000.0,,-546288617.3800008,.
409000438620',2018-05-14,CR812916900810/RMCPL20328/0,,2018-05-14,1500.0,,-546290117.3800008,.
409000438620',2018-05-14,CR812916900807/RMCPL16293/0,,2018-05-14,1000.0,,-546291117.3800008,.
409000438620',2018-05-14,AEPS INCOME DT 11-05-2018,,2018-05-14,,60025.45,-546231091.9300008,.
409000438620',2018-05-14,AEPS GST INC DT 11-05-201,,2018-05-14,,12005.09,-546219086.8400007,.
409000438620',2018-05-14,AEPS INCOME DT 12-05-2018,,2018-05-14,,55138.28,-546163948.5600008,.
409000438620',2018-05-14,AEPS GST INC DT 12-05-201,,2018-05-14,,11027.66,-546152920.9000008,.
409000438620',2018-05-14,AEPS INCOME DT 13-05-2018,,2018-05-14,,30276.59,-546122644.3100008,.
409000438620',2018-05-14,AEPS GST INC DT 13-05-201,,2018-05-14,,6055.32,-546116588.9900007,.
409000438620',2018-05-15,Indiaforensic AEPS NPCI WDL SET,,2018-05-15,,22762100.0,-523354488.9900007,.
409000438620',2018-05-15,TRF TO  Indiaforensic SERVICES I,,2018-05-15,15000000.0,,-538354488.9900007,.
409000438620',2018-05-15,TRF TO  Indiaforensic SERVICES I,,2018-05-15,7900000.0,,-546254488.9900007,.
409000438620',2018-05-15,AEPS INCOME DT 14-05-2018,,2018-05-15,,55161.44,-546199327.5500007,.
409000438620',2018-05-15,AEPS GST INC DT 14-05-201,,2018-05-15,,11032.29,-546188295.2600007,.
409000438620',2018-05-15,AEPS ACQUIRING ADJ FEES 1,,2018-05-15,20.65,,-546188315.9100007,.
409000438620',2018-05-15,AEPS ACQ CR ADJ FEES 1405,,2018-05-15,269.04,,-546188584.9500006,.
409000438620',2018-05-15,CR811410642644/RMCPL25522/2,,2018-05-15,1000.0,,-546189584.9500006,.
409000438620',2018-05-15,CR811412681159/RMCPL17890/2,,2018-05-15,7000.0,,-546196584.9500006,.
409000438620',2018-05-15,CR811416762463/RMCPL22341/2,,2018-05-15,1700.0,,-546198284.9500006,.
409000438620',2018-05-15,CR811416762476/RMCPL21054/2,,2018-05-15,3000.0,,-546201284.9500006,.
409000438620',2018-05-15,CR811416762488/RMCPL16727/2,,2018-05-15,4000.0,,-546205284.9500006,.
409000438620',2018-05-15,CR811411668097/RMCPL24928/2,,2018-05-15,7000.0,,-546212284.9500006,.
409000438620',2018-05-15,CR811409614800/RMCPL16899/2,,2018-05-15,5000.0,,-546217284.9500006,.
409000438620',2018-05-15,CR811412695728/RMCPL18165/2,,2018-05-15,500.0,,-546217784.9500006,.
409000438620',2018-05-15,CR811410642654/RMCPL11966/2,,2018-05-15,1000.0,,-546218784.9500006,.
409000438620',2018-05-15,CR811412681032/RMCPL18460/2,,2018-05-15,3000.0,,-546221784.9500006,.
409000438620',2018-05-15,CR813010074710/RMCPL24694/1,,2018-05-15,1000.0,,-546222784.9500006,.
409000438620',2018-05-15,CR813011086738/RMCPL20680/1,,2018-05-15,600.0,,-546223384.9500006,.
409000438620',2018-05-15,CR813011086720/RMCPL21336/1,,2018-05-15,500.0,,-546223884.9500006,.
409000438620',2018-05-15,CR813011086722/RMCPL21675/1,,2018-05-15,10000.0,,-546233884.9500006,.
409000438620',2018-05-15,CR813010074717/RMCPL17349/1,,2018-05-15,5000.0,,-546238884.9500006,.
409000438620',2018-05-15,CR813013127548/RMCPL14558/1,,2018-05-15,800.0,,-546239684.9500006,.
409000438620',2018-05-15,CR813013127536/RMCPL22799/1,,2018-05-15,5000.0,,-546244684.9500006,.
409000438620',2018-05-15,CR813012108864/RMCPL18236/1,,2018-05-15,2000.0,,-546246684.9500006,.
409000438620',2018-05-15,CR813010074713/RMCPL24787/1,,2018-05-15,5000.0,,-546251684.9500006,.
409000438620',2018-05-15,CR813010074712/RMCPL19668/1,,2018-05-15,5000.0,,-546256684.9500006,.
409000438620',2018-05-15,CR813010074725/RMCPL19237/1,,2018-05-15,3000.0,,-546259684.9500006,.
409000438620',2018-05-15,CR813011086743/RMCPL16831/1,,2018-05-15,500.0,,-546260184.9500006,.
409000438620',2018-05-16,Indiaforensic AEPS NPCI WDL SET,,2018-05-16,,25537700.0,-520722484.95000064,.
409000438620',2018-05-16,CR813207567302RMCPL16658120,,2018-05-16,2000.0,,-520724484.95000064,.
409000438620',2018-05-16,CR813207567316RMCPL16251120,,2018-05-16,1400.0,,-520725884.95000064,.
409000438620',2018-05-16,CR813117458047RMCPL16197110,,2018-05-16,1000.0,,-520726884.95000064,.
409000438620',2018-05-16,CR813110340799RMCPL22847110,,2018-05-16,500.0,,-520727384.95000064,.
409000438620',2018-05-16,CR813110340820RMCPL20319110,,2018-05-16,2000.0,,-520729384.95000064,.
409000438620',2018-05-16,CR813110340802RMCPL22522110,,2018-05-16,2500.0,,-520731884.95000064,.
409000438620',2018-05-16,CR813110340810RMCPL14097110,,2018-05-16,500.0,,-520732384.95000064,.
409000438620',2018-05-16,CR813110340828RMCPL25985110,,2018-05-16,4500.0,,-520736884.95000064,.
409000438620',2018-05-16,CR813110340818RMCPL18859110,,2018-05-16,10000.0,,-520746884.95000064,.
409000438620',2018-05-16,CR813117458061RMCPL18799110,,2018-05-16,1000.0,,-520747884.95000064,.
409000438620',2018-05-16,CR813117458082RMCPL18320110,,2018-05-16,2000.0,,-520749884.95000064,.
409000438620',2018-05-16,TRF TO  Indiaforensic SERVICES I,,2018-05-16,15000000.0,,-535749884.95000064,.
409000438620',2018-05-16,TRF TO  Indiaforensic SERVICES I,,2018-05-16,10500000.0,,-546249884.9500006,.
409000438620',2018-05-16,AEPS ACQ CR ADJ FEES 1505,,2018-05-16,111.5,,-546249996.4500006,.
409000438620',2018-05-16,AEPS ACQ REP ADJ FEES 150,,2018-05-16,,44.25,-546249952.2000006,.
409000438620',2018-05-16,AEPS INCOME DT 15-05-2018,,2018-05-16,,60150.07,-546189802.1300006,.
409000438620',2018-05-16,AEPS GST INC DT 15-05-201,,2018-05-16,,12030.01,-546177772.1200006,.
409000438620',2018-05-17,Indiaforensic AEPS NPCI WDL SET,,2018-05-17,,24547800.0,-521629972.1200006,.
409000438620',2018-05-17,TRF TO  Indiaforensic SERVICES I,,2018-05-17,15000000.0,,-536629972.1200006,.
409000438620',2018-05-17,TRF TO  Indiaforensic SERVICES I,,2018-05-17,9600000.0,,-546229972.1200006,.
409000438620',2018-05-17,AEPS ACQUIRING ADJ FEES 1,,2018-05-17,44.25,,-546230016.3700006,.
409000438620',2018-05-17,AEPS INCOME DT 16-05-2018,,2018-05-17,,58540.49,-546171475.8800006,.
409000438620',2018-05-17,AEPS GST INC DT 16-05-201,,2018-05-17,,11708.1,-546159767.7800006,.
409000438620',2018-05-18,Indiaforensic AEPS NPCI WDL SET,,2018-05-18,,23393800.0,-522765967.78000057,.
409000438620',2018-05-18,CR813512351165/RMCPL23035/1,,2018-05-18,2000.0,,-522767967.78000057,.
409000438620',2018-05-18,CR813516405365/RMCPL14542/1,,2018-05-18,500.0,,-522768467.78000057,.
409000438620',2018-05-18,CR813512351174/RMCPL20185/1,,2018-05-18,1000.0,,-522769467.78000057,.
409000438620',2018-05-18,CR813515384176/RMCPL22824/1,,2018-05-18,500.0,,-522769967.78000057,.
409000438620',2018-05-18,CR813516405373/RMCPL25283/1,,2018-05-18,10000.0,,-522779967.78000057,.
409000438620',2018-05-18,CR813516405357/RMCPL21822/1,,2018-05-18,8600.0,,-522788567.78000057,.
409000438620',2018-05-18,CR813510301416/RMCPL15314/1,,2018-05-18,1000.0,,-522789567.78000057,.
409000438620',2018-05-18,CR813510301389/RMCPL16346/1,,2018-05-18,10000.0,,-522799567.78000057,.
409000438620',2018-05-18,CR813512341118/RMCPL23144/1,,2018-05-18,1000.0,,-522800567.78000057,.
409000438620',2018-05-18,CR813515384178/RMCPL18236/1,,2018-05-18,1400.0,,-522801967.78000057,.
409000438620',2018-05-18,CR813411023393/RMCPL21454/1,,2018-05-18,600.0,,-522802567.78000057,.
409000438620',2018-05-18,CR813411034071/RMCPL23158/1,,2018-05-18,500.0,,-522803067.78000057,.
409000438620',2018-05-18,CR813411023401/RMCPL16204/1,,2018-05-18,5000.0,,-522808067.78000057,.
409000438620',2018-05-18,TRF TO  Indiaforensic SERVICES I,,2018-05-18,15000000.0,,-537808067.7800006,.
409000438620',2018-05-18,TRF TO  Indiaforensic SERVICES I,,2018-05-18,8500000.0,,-546308067.7800006,.
409000438620',2018-05-18,AEPS ACQUIRING ADJ FEES 1,,2018-05-18,17.7,,-546308085.4800006,.
409000438620',2018-05-18,AEPS ACQ CR ADJ FEES 1705,,2018-05-18,120.95,,-546308206.4300007,.
409000438620',2018-05-18,AEPS ACQ REP ADJ FEES 170,,2018-05-18,,44.25,-546308162.1800007,.
409000438620',2018-05-18,AEPS INCOME DT 17-05-2018,,2018-05-18,,55344.94,-546252817.2400006,.
409000438620',2018-05-18,AEPS GST INC DT 17-05-201,,2018-05-18,,11068.99,-546241748.2500006,.
409000438620',2018-05-19,Indiaforensic AEPS NPCI WDL SET,,2018-05-19,,20343600.0,-525898148.2500006,.
409000438620',2018-05-19,TRF TO  Indiaforensic SERVICES I,,2018-05-19,10000000.0,,-535898148.2500006,.
409000438620',2018-05-19,TRF TO  Indiaforensic SERVICES I,,2018-05-19,10000000.0,,-545898148.2500006,.
409000438620',2018-05-19,AEPS INCOME DT 18-05-2018,,2018-05-19,,48551.66,-545849596.5900006,.
409000438620',2018-05-19,AEPS GST INC DT 18-05-201,,2018-05-19,,9710.33,-545839886.2600006,.
409000438620',2018-05-19,AEPS ACQ REP ADJ FEES 180,,2018-05-19,,17.7,-545839868.5600005,.
409000438620',2018-05-19,Chq Book Issuance Charges,,2018-05-19,100.0,,-545839968.5600005,.
409000438620',2018-05-19,GST,,2018-05-19,18.0,,-545839986.5600005,.
409000438620',2018-05-21,MAW/5029649805879772/Cudd,,2018-05-21,,3000.0,-545836986.5600005,.
409000438620',2018-05-21,Indiaforensic AEPS NPCI WDL SET,,2018-05-21,,21258100.0,-524578886.56000054,.
409000438620',2018-05-21,Indiaforensic AEPS NPCI WDL SET,,2018-05-21,,13316800.0,-511262086.56000054,.
409000438620',2018-05-21,TRF TO  Indiaforensic SERVICES I,,2018-05-21,15000000.0,,-526262086.56000054,.
409000438620',2018-05-21,TRF TO  Indiaforensic SERVICES I,,2018-05-21,5000000.0,,-531262086.56000054,.
409000438620',2018-05-21,TRF TO  Indiaforensic SERVICES I,,2018-05-21,15000000.0,,-546262086.5600005,.
409000438620',2018-05-21,AEPS INCOME DT 19-05-2018,,2018-05-21,,50529.83,-546211556.7300005,.
409000438620',2018-05-21,AEPS GST INC DT 19-05-201,,2018-05-21,,10105.97,-546201450.7600005,.
409000438620',2018-05-21,AEPS INCOME DT 20-05-2018,,2018-05-21,,32362.52,-546169088.2400005,.
409000438620',2018-05-21,AEPS GST INC DT 20-05-201,,2018-05-21,,6472.5,-546162615.7400005,.
409000438620',2018-05-21,AEPS ACQ CR ADJ FEES 1905,,2018-05-21,212.4,,-546162828.1400005,.
409000438620',2018-05-21,CR813608532709/RMCPL22989/1,,2018-05-21,500.0,,-546163328.1400005,.
409000438620',2018-05-21,CR813612607046/RMCPL11862/1,,2018-05-21,3000.0,,-546166328.1400005,.
409000438620',2018-05-21,CR813619715117/RMCPL12685/1,,2018-05-21,1000.0,,-546167328.1400005,.
409000438620',2018-05-21,CR813616665041/RMCPL09827/1,,2018-05-21,1000.0,,-546168328.1400005,.
409000438620',2018-05-21,CR813616674575/RMCPL16346/1,,2018-05-21,1000.0,,-546169328.1400005,.
409000438620',2018-05-21,CR813611580858/RMCPL20185/1,,2018-05-21,1000.0,,-546170328.1400005,.
409000438620',2018-05-21,CR813716965748/RMCPL22261/1,,2018-05-21,2000.0,,-546172328.1400005,.
409000438620',2018-05-21,CR813710845670/RMCPL14462/1,,2018-05-21,4000.0,,-546176328.1400005,.
409000438620',2018-05-21,CR813712897037/RMCPL25095/1,,2018-05-21,6000.0,,-546182328.1400005,.
409000438620',2018-05-21,CR813717976588/RMCPL18789/1,,2018-05-21,3000.0,,-546185328.1400005,.
409000438620',2018-05-21,CR813712908440/RMCPL16909/1,,2018-05-21,10000.0,,-546195328.1400005,.
409000438620',2018-05-21,CR813711885218/RMCPL23228/1,,2018-05-21,2500.0,,-546197828.1400005,.
409000438620',2018-05-21,CR813713921091/RMCPL22583/1,,2018-05-21,1000.0,,-546198828.1400005,.
409000438620',2018-05-21,CR813717976602/RMCPL12785/1,,2018-05-21,10000.0,,-546208828.1400005,.
409000438620',2018-05-21,CR813710845667/RMCPL14453/1,,2018-05-21,6000.0,,-546214828.1400005,.
409000438620',2018-05-21,CR813717976575/RMCPL19721/1,,2018-05-21,1500.0,,-546216328.1400005,.
409000438620',2018-05-21,CR813712897054/RMCPL17454/1,,2018-05-21,500.0,,-546216828.1400005,.
409000438620',2018-05-21,CR813716965749/RMCPL24475/1,,2018-05-21,10000.0,,-546226828.1400005,.
409000438620',2018-05-22,Indiaforensic AEPS NPCI WDL SET,,2018-05-22,,20959900.0,-525266928.14000046,.
409000438620',2018-05-22,TRF TO  Indiaforensic SERVICES I,,2018-05-22,10000000.0,,-535266928.14000046,.
409000438620',2018-05-22,TRF TO  Indiaforensic SERVICES I,,2018-05-22,10000000.0,,-545266928.1400005,.
409000438620',2018-05-22,TRF TO  Indiaforensic SERVICES I,,2018-05-22,1000000.0,,-546266928.1400005,.
409000438620',2018-05-22,AEPS INCOME DT 21-05-2018,,2018-05-22,,50858.22,-546216069.9200004,.
409000438620',2018-05-22,AEPS GST INC DT 21-05-201,,2018-05-22,,10171.64,-546205898.2800004,.
409000438620',2018-05-22,AEPS ACQUIRING ADJ FEES 2,,2018-05-22,17.7,,-546205915.9800005,.
409000438620',2018-05-23,MAW/5029649800521213/NAGA,,2018-05-23,,1000.0,-546204915.9800005,.
409000438620',2018-05-23,Indiaforensic AEPS NPCI WDL SET,,2018-05-23,,23292700.0,-522912215.9800005,.
409000438620',2018-05-23,CR814010556839/RMCPL19369/2,,2018-05-23,2300.0,,-522914515.9800005,.
409000438620',2018-05-23,CR813911374048/RMCPL13536/1,,2018-05-23,1000.0,,-522915515.9800005,.
409000438620',2018-05-23,CR813911374051/RMCPL11794/1,,2018-05-23,1000.0,,-522916515.9800005,.
409000438620',2018-05-23,CR813916422161/RMCPL19834/1,,2018-05-23,2500.0,,-522919015.9800005,.
409000438620',2018-05-23,CR813916422179/RMCPL17150/1,,2018-05-23,5000.0,,-522924015.9800005,.
409000438620',2018-05-23,CR813916422254/RMCPL09726/1,,2018-05-23,10000.0,,-522934015.9800005,.
409000438620',2018-05-23,CR813916422262/RMCPL15446/1,,2018-05-23,10000.0,,-522944015.9800005,.
409000438620',2018-05-23,CR813910357191/RMCPL20827/1,,2018-05-23,6000.0,,-522950015.9800005,.
409000438620',2018-05-23,CR813918451696/RMCPL22063/1,,2018-05-23,2000.0,,-522952015.9800005,.
409000438620',2018-05-23,CR813916422175/RMCPL26215/1,,2018-05-23,1000.0,,-522953015.9800005,.
409000438620',2018-05-23,CR813910356269/RMCPL19146/1,,2018-05-23,500.0,,-522953515.9800005,.
409000438620',2018-05-23,CR813916422162/RMCPL20328/1,,2018-05-23,3000.0,,-522956515.9800005,.
409000438620',2018-05-23,CR813916422234/RMCPL16092/1,,2018-05-23,1500.0,,-522958015.9800005,.
409000438620',2018-05-23,CR813916422144/RMCPL16338/1,,2018-05-23,5000.0,,-522963015.9800005,.
409000438620',2018-05-23,CR813918451678/RMCPL18298/1,,2018-05-23,8000.0,,-522971015.9800005,.
409000438620',2018-05-23,CR813811143660/RMCPL10689/1,,2018-05-23,10000.0,,-522981015.9800005,.
409000438620',2018-05-23,CR813811143641/RMCPL22456/1,,2018-05-23,2000.0,,-522983015.9800005,.
409000438620',2018-05-23,CR813811143653/RMCPL16787/1,,2018-05-23,2000.0,,-522985015.9800005,.
409000438620',2018-05-23,CR813811143629/RMCPL24949/1,,2018-05-23,10000.0,,-522995015.9800005,.
409000438620',2018-05-23,CR813810126492/RMCPL22338/1,,2018-05-23,1000.0,,-522996015.9800005,.
409000438620',2018-05-23,CR813811143646/RMCPL22442/1,,2018-05-23,10000.0,,-523006015.9800005,.
409000438620',2018-05-23,CR813812152959/RMCPL20471/1,,2018-05-23,2000.0,,-523008015.9800005,.
409000438620',2018-05-23,CR813811143674/RMCPL04231/1,,2018-05-23,1000.0,,-523009015.9800005,.
409000438620',2018-05-23,CR813811143671/RMCPL24482/1,,2018-05-23,2600.0,,-523011615.9800005,.
409000438620',2018-05-23,CR813811143626/RMCPL14465/1,,2018-05-23,2500.0,,-523014115.9800005,.
409000438620',2018-05-23,CR813816203542/RMCPL17395/1,,2018-05-23,9000.0,,-523023115.9800005,.
409000438620',2018-05-23,CR813812152976/RMCPL19298/1,,2018-05-23,1000.0,,-523024115.9800005,.
409000438620',2018-05-23,CR813816203545/RMCPL19721/1,,2018-05-23,1300.0,,-523025415.9800005,.
409000438620',2018-05-23,TRF TO  Indiaforensic SERVICES I,,2018-05-23,15000000.0,,-538025415.9800005,.
409000438620',2018-05-23,TRF TO  Indiaforensic SERVICES I,,2018-05-23,8200000.0,,-546225415.9800005,.
409000438620',2018-05-23,AEPS INCOME DT 22-05-2018,,2018-05-23,,57170.03,-546168245.9500005,.
409000438620',2018-05-23,AEPS GST INC DT 22-05-201,,2018-05-23,,11434.01,-546156811.9400005,.
409000438620',2018-05-23,AEPS ACQUIRING ADJ FEES 2,,2018-05-23,17.7,,-546156829.6400006,.
409000438620',2018-05-23,AEPS ACQ CR ADJ FEES 2205,,2018-05-23,355.18,,-546157184.8200005,.
409000438620',2018-05-24,Indiaforensic AEPS NPCI WDL SET,,2018-05-24,,20514400.0,-525642784.8200005,.
409000438620',2018-05-24,TRF TO  Indiaforensic SERVICES I,,2018-05-24,15000000.0,,-540642784.8200005,.
409000438620',2018-05-24,TRF TO  Indiaforensic SERVICES I,,2018-05-24,5600000.0,,-546242784.8200005,.
409000438620',2018-05-24,AEPS INCOME DT 23-05-2018,,2018-05-24,,50464.07,-546192320.7500005,.
409000438620',2018-05-24,AEPS GST INC DT 23-05-201,,2018-05-24,,10092.81,-546182227.9400005,.
409000438620',2018-05-24,AEPS ACQUIRING ADJ FEES 2,,2018-05-24,147.5,,-546182375.4400005,.
409000438620',2018-05-24,AEPS ACQ CR ADJ FEES 2305,,2018-05-24,355.17,,-546182730.6100005,.
409000438620',2018-05-24,CB814110752086/RMCPL25879/2,,2018-05-24,2000.0,,-546184730.6100005,.
409000438620',2018-05-24,CB814110751964/RMCPL23387/2,,2018-05-24,2500.0,,-546187230.6100005,.
409000438620',2018-05-24,CB814113821728/RMCPL19746/2,,2018-05-24,2000.0,,-546189230.6100005,.
409000438620',2018-05-24,CB814113821828/RMCPL09608/2,,2018-05-24,10000.0,,-546199230.6100005,.
409000438620',2018-05-24,CB814113821783/RMCPL17789/2,,2018-05-24,1000.0,,-546200230.6100005,.
409000438620',2018-05-24,CB814113821799/RMCPL23561/2,,2018-05-24,2500.0,,-546202730.6100005,.
409000438620',2018-05-24,CB814110752033/RMCPL18664/2,,2018-05-24,10000.0,,-546212730.6100005,.
409000438620',2018-05-24,CB814113821658/RMCPL22583/2,,2018-05-24,7000.0,,-546219730.6100005,.
409000438620',2018-05-24,CB814113821567/RMCPL09758/2,,2018-05-24,3000.0,,-546222730.6100005,.
409000438620',2018-05-24,CB814112794181/RMCPL24460/2,,2018-05-24,5000.0,,-546227730.6100005,.
409000438620',2018-05-24,CB814110752115/RMCPL19589/2,,2018-05-24,1500.0,,-546229230.6100005,.
409000438620',2018-05-24,CB814110752039/RMCPL16346/2,,2018-05-24,2000.0,,-546231230.6100005,.
409000438620',2018-05-24,CB814110752017/RMCPL18488/2,,2018-05-24,2000.0,,-546233230.6100005,.
409000438620',2018-05-24,CB814110752113/RMCPL16624/2,,2018-05-24,3000.0,,-546236230.6100005,.
409000438620',2018-05-24,CB814110752024/RMCPL15393/2,,2018-05-24,4000.0,,-546240230.6100005,.
409000438620',2018-05-24,CB814110752015/RMCPL18980/2,,2018-05-24,5000.0,,-546245230.6100005,.
409000438620',2018-05-24,CB814111783080/RMCPL00045/2,,2018-05-24,1800.0,,-546247030.6100005,.
409000438620',2018-05-24,CB814112794207/RMCPL17491/2,,2018-05-24,2400.0,,-546249430.6100005,.
409000438620',2018-05-24,CB814113821666/RMCPL18460/2,,2018-05-24,5000.0,,-546254430.6100005,.
409000438620',2018-05-24,CB814113821577/RMCPL22775/2,,2018-05-24,500.0,,-546254930.6100005,.
409000438620',2018-05-24,CB814113821610/RMCPL17213/2,,2018-05-24,4000.0,,-546258930.6100005,.
409000438620',2018-05-24,CB814112794210/RMCPL24462/2,,2018-05-24,1000.0,,-546259930.6100005,.
409000438620',2018-05-24,CB814111771794/RMCPL24303/2,,2018-05-24,500.0,,-546260430.6100005,.
409000438620',2018-05-24,CB814113821564/RMCPL15233/2,,2018-05-24,1000.0,,-546261430.6100005,.
409000438620',2018-05-24,CB814113821647/RMCPL12343/2,,2018-05-24,6000.0,,-546267430.6100005,.
409000438620',2018-05-24,CB814113821565/RMCPL12580/2,,2018-05-24,500.0,,-546267930.6100005,.
409000438620',2018-05-24,CB814113821836/RMCPL19869/2,,2018-05-24,4500.0,,-546272430.6100005,.
409000438620',2018-05-24,CB814113821942/RMCPL24897/2,,2018-05-24,1000.0,,-546273430.6100005,.
409000438620',2018-05-24,AEPS ACQ REP ADJ FEES 230,,2018-05-24,,17.7,-546273412.9100004,.
409000438620',2018-05-25,Indiaforensic AEPS NPCI WDL SET,,2018-05-25,,20628200.0,-525645212.91000044,.
409000438620',2018-05-25,CB814113821635/RMCPL11793/2,,2018-05-25,3000.0,,-525648212.91000044,.
409000438620',2018-05-25,TRF TO  Indiaforensic SERVICES I,,2018-05-25,15000000.0,,-540648212.9100004,.
409000438620',2018-05-25,TRF TO  Indiaforensic SERVICES I,,2018-05-25,5600000.0,,-546248212.9100004,.
409000438620',2018-05-25,AEPS INCOME DT 24-05-2018,,2018-05-25,,50158.94,-546198053.9700004,.
409000438620',2018-05-25,AEPS GST INC DT 24-05-201,,2018-05-25,,10031.79,-546188022.1800004,.
409000438620',2018-05-25,AEPS ACQUIRING ADJ FEES 2,,2018-05-25,35.4,,-546188057.5800004,.
409000438620',2018-05-26,MAW/5029649807690078/NAGA,,2018-05-26,,100.0,-546187957.5800004,.
409000438620',2018-05-28,Indiaforensic AEPS NPCI WDL SET,,2018-05-28,,21378100.0,-524809857.5800004,.
409000438620',2018-05-28,Indiaforensic AEPS NPCI WDL SET,,2018-05-28,,18407100.0,-506402757.5800004,.
409000438620',2018-05-28,Indiaforensic AEPS NPCI WDL SET,,2018-05-28,,11986800.0,-494415957.5800004,.
409000438620',2018-05-28,TRF TO  Indiaforensic SERVICES I,,2018-05-28,6800000.0,,-501215957.5800004,.
409000438620',2018-05-28,TRF TO  Indiaforensic SERVICES I,,2018-05-28,15000000.0,,-516215957.5800004,.
409000438620',2018-05-28,TRF TO  Indiaforensic SERVICES I,,2018-05-28,15000000.0,,-531215957.5800004,.
409000438620',2018-05-28,TRF TO  Indiaforensic SERVICES I,,2018-05-28,15000000.0,,-546215957.5800004,.
409000438620',2018-05-28,AEPS ACQUIRING ADJ FEES 2,,2018-05-28,32.45,,-546215990.0300004,.
409000438620',2018-05-28,AEPS ACQ CR ADJ FEES 2505,,2018-05-28,453.71,,-546216443.7400005,.
409000438620',2018-05-29,Indiaforensic AEPS NPCI WDL SET,,2018-05-29,,21538200.0,-524678243.7400005,.
409000438620',2018-05-29,CR814311346216/RMCPL19418,,2018-05-29,500.0,,-524678743.7400005,.
409000438620',2018-05-29,CR814311346225/RMCPL22799,,2018-05-29,3000.0,,-524681743.7400005,.
409000438620',2018-05-29,CR814311346237/RMCPL03657,,2018-05-29,4500.0,,-524686243.7400005,.
409000438620',2018-05-29,CR814312368420/RMCPL18841,,2018-05-29,3000.0,,-524689243.7400005,.
409000438620',2018-05-29,CR814312368430/RMCPL17555,,2018-05-29,1000.0,,-524690243.7400005,.
409000438620',2018-05-29,CR814316422042/RMCPL17454,,2018-05-29,8000.0,,-524698243.7400005,.
409000438620',2018-05-29,CR814316422054/RMCPL16754,,2018-05-29,2400.0,,-524700643.7400005,.
409000438620',2018-05-29,CR814316422154/RMCPL22925,,2018-05-29,3000.0,,-524703643.7400005,.
409000438620',2018-05-29,CR814316422161/RMCPL19130,,2018-05-29,1000.0,,-524704643.7400005,.
409000438620',2018-05-29,CR814316422177/RMCPL22253,,2018-05-29,1500.0,,-524706143.7400005,.
409000438620',2018-05-29,CR814316422261/RMCPL13556,,2018-05-29,5000.0,,-524711143.7400005,.
409000438620',2018-05-29,CR814316422265/RMCPL14498,,2018-05-29,500.0,,-524711643.7400005,.
409000438620',2018-05-29,CR814316421834/RMCPL23517,,2018-05-29,1000.0,,-524712643.7400005,.
409000438620',2018-05-29,CR814316421842/RMCPL24236,,2018-05-29,3000.0,,-524715643.7400005,.
409000438620',2018-05-29,CR814316421865/RMCPL14995,,2018-05-29,500.0,,-524716143.7400005,.
409000438620',2018-05-29,CR814316421866/RMCPL22241,,2018-05-29,10000.0,,-524726143.7400005,.
409000438620',2018-05-29,CR814316421875/RMCPL18014,,2018-05-29,1200.0,,-524727343.7400005,.
409000438620',2018-05-29,CR814316421883/RMCPL24959,,2018-05-29,2100.0,,-524729443.7400005,.
409000438620',2018-05-29,CR814316421900/RMCPL16278,,2018-05-29,500.0,,-524729943.7400005,.
409000438620',2018-05-29,CR814316421921/RMCPL15384,,2018-05-29,1000.0,,-524730943.7400005,.
409000438620',2018-05-29,CR814316421931/RMCPL09612,,2018-05-29,4000.0,,-524734943.7400005,.
409000438620',2018-05-29,CR814316421933/RMCPL12343,,2018-05-29,1000.0,,-524735943.7400005,.
409000438620',2018-05-29,CR814316421940/RMCPL21824,,2018-05-29,1500.0,,-524737443.7400005,.
409000438620',2018-05-29,CR814316421952/RMCPL14190,,2018-05-29,3500.0,,-524740943.7400005,.
409000438620',2018-05-29,CR814213090372/RMCPL24303,,2018-05-29,4000.0,,-524744943.7400005,.
409000438620',2018-05-29,CR814213090413/RMCPL09489,,2018-05-29,500.0,,-524745443.7400005,.
409000438620',2018-05-29,CR814213090346/RMCPL13700,,2018-05-29,5000.0,,-524750443.7400005,.
409000438620',2018-05-29,CR814213090354/RMCPL23760,,2018-05-29,2500.0,,-524752943.7400005,.
409000438620',2018-05-29,CR814213090387/RMCPL12343,,2018-05-29,10000.0,,-524762943.7400005,.
409000438620',2018-05-29,CR814213090402/RMCPL22056,,2018-05-29,4000.0,,-524766943.7400005,.
409000438620',2018-05-29,CR814213090461/RMCPL25729,,2018-05-29,6000.0,,-524772943.7400005,.
409000438620',2018-05-29,CR814211064246/RMCPL14948,,2018-05-29,500.0,,-524773443.7400005,.
409000438620',2018-05-29,CR814211064248/RMCPL24617,,2018-05-29,500.0,,-524773943.7400005,.
409000438620',2018-05-29,CR814211064249/RMCPL22022,,2018-05-29,1000.0,,-524774943.7400005,.
409000438620',2018-05-29,CR814211064251/RMCPL25730,,2018-05-29,700.0,,-524775643.7400005,.
409000438620',2018-05-29,CR814213090537/RMCPL21404,,2018-05-29,2500.0,,-524778143.7400005,.
409000438620',2018-05-29,CR814213090270/RMCPL17491,,2018-05-29,2000.0,,-524780143.7400005,.
409000438620',2018-05-29,CR814212074496/RMCPL12343,,2018-05-29,3000.0,,-524783143.7400005,.
409000438620',2018-05-29,CR814213090579/RMCPL22941,,2018-05-29,1000.0,,-524784143.7400005,.
409000438620',2018-05-29,CR814213090262/RMCPL16275,,2018-05-29,1000.0,,-524785143.7400005,.
409000438620',2018-05-29,CR814213090551/RMCPL20613,,2018-05-29,1000.0,,-524786143.7400005,.
409000438620',2018-05-29,AEPS ACQ REP ADJ FEES 280,,2018-05-29,,182.9,-524785960.8400005,.
409000438620',2018-05-29,TRF TO  Indiaforensic SERVICES I,,2018-05-29,15000000.0,,-539785960.8400005,.
409000438620',2018-05-29,TRF TO  Indiaforensic SERVICES I,,2018-05-29,500000.0,,-540285960.8400005,.
409000438620',2018-05-29,TRF TO  Indiaforensic SERVICES I,,2018-05-29,3000000.0,,-543285960.8400005,.
409000438620',2018-05-29,TRF TO  Indiaforensic SERVICES I,,2018-05-29,2000000.0,,-545285960.8400005,.
409000438620',2018-05-29,TRF TO  Indiaforensic SERVICES I,,2018-05-29,1000000.0,,-546285960.8400005,.
409000438620',2018-05-29,MAW/5029649805976016/Akol,,2018-05-29,,1800.0,-546284160.8400005,.
409000438620',2018-05-29,AEPS INCOME DT 25-05-2018,,2018-05-29,,51864.52,-546232296.3200005,.
409000438620',2018-05-29,AEPS GST INC DT 25-05-201,,2018-05-29,,10372.9,-546221923.4200006,.
409000438620',2018-05-29,AEPS INCOME DT 26-05-2018,,2018-05-29,,44084.03,-546177839.3900006,.
409000438620',2018-05-29,AEPS GST INC DT 26-05-201,,2018-05-29,,8816.81,-546169022.5800006,.
409000438620',2018-05-29,AEPS INCOME DT 27-05-2018,,2018-05-29,,30108.83,-546138913.7500006,.
409000438620',2018-05-29,AEPS GST INC DT 27-05-201,,2018-05-29,,6021.77,-546132891.9800006,.
409000438620',2018-05-29,AEPS INCOME DT 28-05-2018,,2018-05-29,,52273.3,-546080618.6800007,.
409000438620',2018-05-29,AEPS GST INC DT 28-05-201,,2018-05-29,,10454.66,-546070164.0200007,.
409000438620',2018-05-30,MAW/5029649804017077/Vara,,2018-05-30,,10000.0,-546060164.0200007,.
409000438620',2018-05-30,Indiaforensic AEPS NPCI WDL SET,,2018-05-30,,20843100.0,-525217064.0200007,.
409000438620',2018-05-30,TRF TO  Indiaforensic SERVICES I,,2018-05-30,15000000.0,,-540217064.0200007,.
409000438620',2018-05-30,TRF TO  Indiaforensic SERVICES I,,2018-05-30,6000000.0,,-546217064.0200007,.
409000438620',2018-05-30,MAW/5029649812210102/Vals,,2018-05-30,,1000.0,-546216064.0200007,.
409000438620',2018-05-30,AEPS INCOME DT 29-05-2018,,2018-05-30,,50492.93,-546165571.0900007,.
409000438620',2018-05-30,AEPS GST INC DT 29-05-201,,2018-05-30,,10098.59,-546155472.5000007,.
409000438620',2018-05-30,AEPS ACQUIRING ADJ FEES 2,,2018-05-30,17.7,,-546155490.2000008,.
409000438620',2018-05-31,MAW/5029649804017077/Vara,,2018-05-31,,10000.0,-546145490.2000008,.
409000438620',2018-05-31,Indiaforensic AEPS NPCI WDL SET,,2018-05-31,,20946700.0,-525198790.20000076,.
409000438620',2018-05-31,CR814409573437/RMCPL12343/2,,2018-05-31,1000.0,,-525199790.20000076,.
409000438620',2018-05-31,CR814409573475/RMCPL18214/2,,2018-05-31,1000.0,,-525200790.20000076,.
409000438620',2018-05-31,CR814409573464/RMCPL20108/2,,2018-05-31,500.0,,-525201290.20000076,.
409000438620',2018-05-31,CR814417705972/RMCPL22341/2,,2018-05-31,2900.0,,-525204190.20000076,.
409000438620',2018-05-31,CR814416697987/RMCPL16388/2,,2018-05-31,2000.0,,-525206190.20000076,.
409000438620',2018-05-31,CR814416697979/RMCPL23233/2,,2018-05-31,600.0,,-525206790.20000076,.
409000438620',2018-05-31,CR814811565959/RMCPL10677/2,,2018-05-31,1000.0,,-525207790.20000076,.
409000438620',2018-05-31,CR814811576428/RMCPL20241/2,,2018-05-31,500.0,,-525208290.20000076,.
409000438620',2018-05-31,CR814811581947/RMCPL20275/2,,2018-05-31,1000.0,,-525209290.20000076,.
409000438620',2018-05-31,CR814815648246/RMCPL22520/2,,2018-05-31,1000.0,,-525210290.20000076,.
409000438620',2018-05-31,CR814815648245/RMCPL09003/2,,2018-05-31,1000.0,,-525211290.20000076,.
409000438620',2018-05-31,CR814815648247/RMCPL25783/2,,2018-05-31,1000.0,,-525212290.20000076,.
409000438620',2018-05-31,CR814510865344/RMCPL19090/2,,2018-05-31,1600.0,,-525213890.20000076,.
409000438620',2018-05-31,CR814511891896/RMCPL21533/2,,2018-05-31,8000.0,,-525221890.20000076,.
409000438620',2018-05-31,CR814511891876/RMCPL16251/2,,2018-05-31,2000.0,,-525223890.20000076,.
409000438620',2018-05-31,CR814512904800/RMCPL11375/2,,2018-05-31,500.0,,-525224390.20000076,.
409000438620',2018-05-31,CR814512917969/RMCPL20589/2,,2018-05-31,3000.0,,-525227390.20000076,.
409000438620',2018-05-31,CR814610128283/RMCPL09710/2,,2018-05-31,2500.0,,-525229890.20000076,.
409000438620',2018-05-31,CR814610128289/RMCPL19751/2,,2018-05-31,5000.0,,-525234890.20000076,.
409000438620',2018-05-31,MAW/5029649806207502/Akol,,2018-05-31,,500.0,-525234390.20000076,.
409000438620',2018-05-31,MAW/5029649804272227/Kush,,2018-05-31,,10000.0,-525224390.20000076,.
409000438620',2018-05-31,TRF TO  Indiaforensic SERVICES I,,2018-05-31,15000000.0,,-540224390.2000008,.
409000438620',2018-05-31,TRF TO  Indiaforensic SERVICES I,,2018-05-31,6000000.0,,-546224390.2000008,.
409000438620',2018-05-31,AEPS INCOME DT 30-05-2018,,2018-05-31,,50906.24,-546173483.9600008,.
409000438620',2018-05-31,AEPS GST INC DT 30-05-201,,2018-05-31,,10181.25,-546163302.7100008,.
409000438620',2018-05-31,AEPS ACQ CR ADJ FEES 3005,,2018-05-31,171.69,,-546163474.4000008,.
409000438620',2018-05-31,AEPS ACQ REP ADJ FEES 300,,2018-05-31,,14.75,-546163459.6500008,.
409000438620',2018-06-01,Indiaforensic AEPS NPCI WDL SET,,2018-06-01,,18806500.0,-527356959.6500008,.
409000438620',2018-06-01,CR814911860849/RMCPL24867/2,,2018-06-01,1000.0,,-527357959.6500008,.
409000438620',2018-06-01,CR814913883552/RMCPL14048/2,,2018-06-01,1100.0,,-527359059.6500008,.
409000438620',2018-06-01,CR814911860843/RMCPL09519/2,,2018-06-01,5000.0,,-527364059.6500008,.
409000438620',2018-06-01,CR814910838160/RMCPL20553/2,,2018-06-01,500.0,,-527364559.6500008,.
409000438620',2018-06-01,MAW/5029649805791001/Akol,,2018-06-01,,2500.0,-527362059.6500008,.
409000438620',2018-06-01,MAW/5029649805791019/Akol,,2018-06-01,,1500.0,-527360559.6500008,.
409000438620',2018-06-01,TRF TO  Indiaforensic SERVICES I,,2018-06-01,15000000.0,,-542360559.6500008,.
409000438620',2018-06-01,TRF TO  Indiaforensic SERVICES I,,2018-06-01,3900000.0,,-546260559.6500008,.
409000438620',2018-06-01,AEPS INCOME DT 31-05-2018,,2018-06-01,,44393.68,-546216165.9700009,.
409000438620',2018-06-01,AEPS GST INC DT 31-05-201,,2018-06-01,,8878.74,-546207287.2300009,.
409000438620',2018-06-01,AEPS ACQ CR ADJ FEES 3105,,2018-06-01,33.02,,-546207320.2500008,.
409000438620',2018-06-01,MAW/5029649804017077/Vara,,2018-06-01,,10000.0,-546197320.2500008,.
409000438620',2018-06-02,Indiaforensic AEPS NPCI WDL SET,,2018-06-02,,22445200.0,-523752120.25000083,.
409000438620',2018-06-02,TRF TO  Indiaforensic SERVICES I,,2018-06-02,500000.0,,-524252120.25000083,.
409000438620',2018-06-02,TRF TO  Indiaforensic SERVICES I,,2018-06-02,2000000.0,,-526252120.25000083,.
409000438620',2018-06-02,TRF TO  Indiaforensic SERVICES I,,2018-06-02,10000000.0,,-536252120.25000083,.
409000438620',2018-06-02,TRF TO  Indiaforensic SERVICES I,,2018-06-02,4000000.0,,-540252120.2500008,.
409000438620',2018-06-02,TRF TO  Indiaforensic SERVICES I,,2018-06-02,3000000.0,,-543252120.2500008,.
409000438620',2018-06-02,TRF TO  Indiaforensic SERVICES I,,2018-06-02,3000000.0,,-546252120.2500008,.
409000438620',2018-06-02,AEPS INCOME DT 01-06-2018,,2018-06-02,,52808.72,-546199311.5300008,.
409000438620',2018-06-02,AEPS GST INC DT 01-06-201,,2018-06-02,,10561.74,-546188749.7900008,.
409000438620',2018-06-02,AEPS ACQUIRING ADJ FEES 0,,2018-06-02,47.2,,-546188796.9900008,.
409000438620',2018-06-02,MAW/5029649804017077/Vara,,2018-06-02,,10000.0,-546178796.9900008,.
409000438620',2018-06-03,MAW/5029649808809255/NAGA,,2018-06-03,,1100.0,-546177696.9900008,.
409000438620',2018-06-04,MAW/5029649804017077/Vara,,2018-06-04,,10000.0,-546167696.9900008,.
409000438620',2018-06-04,Indiaforensic AEPS NPCI WDL SET,,2018-06-04,,18390200.0,-527777496.99000084,.
409000438620',2018-06-04,Indiaforensic AEPS NPCI WDL SET,,2018-06-04,,13472900.0,-514304596.99000084,.
409000438620',2018-06-04,MAW/5029649809768476/Vals,,2018-06-04,,4000.0,-514300596.99000084,.
409000438620',2018-06-04,TRF TO  Indiaforensic SERVICES I,,2018-06-04,15000000.0,,-529300596.99000084,.
409000438620',2018-06-04,TRF TO  Indiaforensic SERVICES I,,2018-06-04,15000000.0,,-544300596.9900008,.
409000438620',2018-06-04,TRF TO  Indiaforensic SERVICES I,,2018-06-04,2000000.0,,-546300596.9900008,.
409000438620',2018-06-04,AEPS INCOME DT 02-06-2018,,2018-06-04,,43728.11,-546256868.8800008,.
409000438620',2018-06-04,AEPS GST INC DT 02-06-201,,2018-06-04,,8745.62,-546248123.2600008,.
409000438620',2018-06-04,AEPS INCOME DT 03-06-2018,,2018-06-04,,33563.72,-546214559.5400008,.
409000438620',2018-06-04,AEPS GST INC DT 03-06-201,,2018-06-04,,6712.74,-546207846.8000008,.
409000438620',2018-06-04,AEPS ACQUIRING ADJ FEES 0,,2018-06-04,17.7,,-546207864.5000008,.
409000438620',2018-06-04,AEPS ACQ CR ADJ FEES 0206,,2018-06-04,8.85,,-546207873.3500009,.
409000438620',2018-06-04,CR815112403718/RMCPL00029/3,,2018-06-04,500.0,,-546208373.3500009,.
409000438620',2018-06-04,CR815112403700/RMCPL23829/3,,2018-06-04,500.0,,-546208873.3500009,.
409000438620',2018-06-04,CR815111392731/RMCPL23976/3,,2018-06-04,500.0,,-546209373.3500009,.
409000438620',2018-06-05,Indiaforensic AEPS NPCI WDL SET,,2018-06-05,,20267200.0,-525942173.35000086,.
409000438620',2018-06-05,CB814311346232/RMCPL14145/2,,2018-06-05,7000.0,,-525949173.35000086,.
409000438620',2018-06-05,CB814417705974/RMCPL24076/2,,2018-06-05,6200.0,,-525955373.35000086,.
409000438620',2018-06-05,TRF TO  Indiaforensic SERVICES I,,2018-06-05,10000000.0,,-535955373.35000086,.
409000438620',2018-06-05,TRF TO  Indiaforensic SERVICES I,,2018-06-05,10000000.0,,-545955373.3500009,.
409000438620',2018-06-05,AEPS INCOME DT 04-06-2018,,2018-06-05,,48085.36,-545907287.9900008,.
409000438620',2018-06-05,AEPS GST INC DT 04-06-201,,2018-06-05,,9617.07,-545897670.9200008,.
409000438620',2018-06-06,Indiaforensic AEPS NPCI WDL SET,,2018-06-06,,19181800.0,-526715870.9200008,.
409000438620',2018-06-06,MAW/5029649807139282/NAGA,,2018-06-06,,700.0,-526715170.9200008,.
409000438620',2018-06-06,TRF TO  Indiaforensic SERVICES I,,2018-06-06,15000000.0,,-541715170.9200008,.
409000438620',2018-06-06,TRF TO  Indiaforensic SERVICES I,,2018-06-06,4500000.0,,-546215170.9200008,.
409000438620',2018-06-06,AEPS INCOME DT 05-06-2018,,2018-06-06,,45698.45,-546169472.4700007,.
409000438620',2018-06-06,AEPS GST INC DT 05-06-201,,2018-06-06,,9139.69,-546160332.7800007,.
409000438620',2018-06-06,AEPS ACQ REP ADJ FEES 050,,2018-06-06,,47.2,-546160285.5800006,.
409000438620',2018-06-07,Indiaforensic AEPS NPCI WDL SET,,2018-06-07,,20080100.0,-526080185.58000064,.
409000438620',2018-06-07,CR815211655462/RMCPL13894/0,,2018-06-07,2000.0,,-526082185.58000064,.
409000438620',2018-06-07,CR815211655455/RMCPL23894/0,,2018-06-07,3000.0,,-526085185.58000064,.
409000438620',2018-06-07,CR815218793339/RMCPL19867/0,,2018-06-07,500.0,,-526085685.58000064,.
409000438620',2018-06-07,CR815216750138/RMCPL13506/0,,2018-06-07,1500.0,,-526087185.58000064,.
409000438620',2018-06-07,CR815216750117/RMCPL09588/0,,2018-06-07,10000.0,,-526097185.58000064,.
409000438620',2018-06-07,CR815216750131/RMCPL00195/0,,2018-06-07,700.0,,-526097885.58000064,.
409000438620',2018-06-07,CR815211655459/RMCPL26209/0,,2018-06-07,4000.0,,-526101885.58000064,.
409000438620',2018-06-07,CR815216760362/RMCPL18067/0,,2018-06-07,5000.0,,-526106885.58000064,.
409000438620',2018-06-07,CR815216760346/RMCPL22341/0,,2018-06-07,10000.0,,-526116885.58000064,.
409000438620',2018-06-07,CR815216760358/RMCPL14165/0,,2018-06-07,1000.0,,-526117885.58000064,.
409000438620',2018-06-07,CR815218793614/RMCPL14902/0,,2018-06-07,2000.0,,-526119885.58000064,.
409000438620',2018-06-07,CR815316036765/RMCPL13859/0,,2018-06-07,2000.0,,-526121885.58000064,.
409000438620',2018-06-07,CR815310934479/RMCPL21595/0,,2018-06-07,6000.0,,-526127885.58000064,.
409000438620',2018-06-07,TRF TO  Indiaforensic SERVICES I,,2018-06-07,15000000.0,,-541127885.5800006,.
409000438620',2018-06-07,TRF TO  Indiaforensic SERVICES I,,2018-06-07,4000000.0,,-545127885.5800006,.
409000438620',2018-06-07,TRF TO  Indiaforensic SERVICES I,,2018-06-07,1000000.0,,-546127885.5800006,.
409000438620',2018-06-07,AEPS INCOME DT 06-06-2018,,2018-06-07,,48614.9,-546079270.6800007,.
409000438620',2018-06-07,AEPS GST INC DT 06-06-201,,2018-06-07,,9722.98,-546069547.7000006,.
409000438620',2018-06-07,AEPS ACQ CR ADJ FEES 0606,,2018-06-07,163.43,,-546069711.1300006,.
409000438620',2018-06-07,MAW/5029649805749819/NAGA,,2018-06-07,,6000.0,-546063711.1300006,.
409000438620',2018-06-07,TRF TO  Indiaforensic SERVICES I,,2018-06-07,250000.0,,-546313711.1300006,.
409000438620',2018-06-08,Indiaforensic AEPS NPCI WDL SET,,2018-06-08,,19505400.0,-526808311.1300006,.
409000438620',2018-06-08,TRFT O  Indiaforensic SERVICES I,,2018-06-08,15000000.0,,-541808311.1300006,.
409000438620',2018-06-08,TRF TO  Indiaforensic SERVICES I,,2018-06-08,500000.0,,-542308311.1300006,.
409000438620',2018-06-08,TRF TO  Indiaforensic SERVICES I,,2018-06-08,4000000.0,,-546308311.1300006,.
409000438620',2018-06-08,AEPS INCOME DT 07-06-2018,,2018-06-08,,45683.32,-546262627.8100005,.
409000438620',2018-06-08,AEPS GST INC DT 07-06-201,,2018-06-08,,9136.66,-546253491.1500006,.
409000438620',2018-06-08,AEPS ACQUIRING ADJ FEES 0,,2018-06-08,23.6,,-546253514.7500006,.
409000438620',2018-06-08,AEPS ACQ CR ADJ FEES 0706,,2018-06-08,279.66,,-546253794.4100006,.
409000438620',2018-06-08,CR815609734470/RMCPL11459/0,,2018-06-08,5000.0,,-546258794.4100006,.
409000438620',2018-06-08,CR815610745510/RMCPL22124/0,,2018-06-08,1500.0,,-546260294.4100006,.
409000438620',2018-06-08,CR815609723994/RMCPL20257/0,,2018-06-08,1000.0,,-546261294.4100006,.
409000438620',2018-06-08,CR815611774518/RMCPL25552/0,,2018-06-08,1500.0,,-546262794.4100006,.
409000438620',2018-06-08,CR815610755903/RMCPL12343/0,,2018-06-08,3000.0,,-546265794.4100006,.
409000438620',2018-06-08,CR815611765135/RMCPL19418/0,,2018-06-08,1000.0,,-546266794.4100006,.
409000438620',2018-06-08,CR815611765137/RMCPL14558/0,,2018-06-08,1200.0,,-546267994.4100006,.
409000438620',2018-06-08,CR815616850064/RMCPL11794/0,,2018-06-08,7000.0,,-546274994.4100006,.
409000438620',2018-06-08,CR815611774525/RMCPL18380/0,,2018-06-08,1000.0,,-546275994.4100006,.
409000438620',2018-06-08,CR815611774500/RMCPL15054/0,,2018-06-08,3500.0,,-546279494.4100006,.
409000438620',2018-06-08,CR815611765136/RMCPL25344/0,,2018-06-08,5500.0,,-546284994.4100006,.
409000438620',2018-06-08,CR815610745494/RMCPL12343/0,,2018-06-08,1000.0,,-546285994.4100006,.
409000438620',2018-06-08,CR815612794979/RMCPL22866/0,,2018-06-08,500.0,,-546286494.4100006,.
409000438620',2018-06-08,CR815612795003/RMCPL22086/0,,2018-06-08,2000.0,,-546288494.4100006,.
409000438620',2018-06-08,CR815613804753/RMCPL18492/0,,2018-06-08,2700.0,,-546291194.4100006,.
409000438620',2018-06-08,CR815612784228/RMCPL20316/0,,2018-06-08,3000.0,,-546294194.4100006,.
409000438620',2018-06-08,CR815617868688/RMCPL09591/0,,2018-06-08,3000.0,,-546297194.4100006,.
409000438620',2018-06-08,CR815509433633/RMCPL11793/0,,2018-06-08,2000.0,,-546299194.4100006,.
409000438620',2018-06-08,CR815519613869/RMCPL21345/0,,2018-06-08,1000.0,,-546300194.4100006,.
409000438620',2018-06-08,CR815509433629/RMCPL19789/0,,2018-06-08,1000.0,,-546301194.4100006,.
409000438620',2018-06-08,CR815510454879/RMCPL20680/0,,2018-06-08,1000.0,,-546302194.4100006,.
409000438620',2018-06-08,CR815513507794/RMCPL09591/0,,2018-06-08,8000.0,,-546310194.4100006,.
409000438620',2018-06-08,CR815517571476/RMCPL18769/0,,2018-06-08,1500.0,,-546311694.4100006,.
409000438620',2018-06-08,CR815511483827/RMCPL12959/0,,2018-06-08,1500.0,,-546313194.4100006,.
409000438620',2018-06-08,CR815510454883/RMCPL22312/0,,2018-06-08,1000.0,,-546314194.4100006,.
409000438620',2018-06-11,MAW/5029649806189049/Akol,,2018-06-11,,4500.0,-546309694.4100006,.
409000438620',2018-06-11,Indiaforensic AEPS NPCI WDL SET,,2018-06-11,,22173100.0,-524136594.41000056,.
409000438620',2018-06-11,Indiaforensic AEPS NPCI WDL SET,,2018-06-11,,20183900.0,-503952694.41000056,.
409000438620',2018-06-11,Indiaforensic AEPS NPCI WDL SET,,2018-06-11,,11853000.0,-492099694.41000056,.
409000438620',2018-06-11,TRF TO  Indiaforensic SERVICES I,,2018-06-11,9200000.0,,-501299694.41000056,.
409000438620',2018-06-11,TRF TO  Indiaforensic SERVICES I,,2018-06-11,15000000.0,,-516299694.41000056,.
409000438620',2018-06-11,TRF TO  Indiaforensic SERVICES I,,2018-06-11,15000000.0,,-531299694.41000056,.
409000438620',2018-06-11,TRF TO  Indiaforensic SERVICES I,,2018-06-11,15000000.0,,-546299694.4100006,.
409000438620',2018-06-11,MAW/5029649803446863/Akol,,2018-06-11,,6500.0,-546293194.4100006,.
409000438620',2018-06-11,AEPS INCOME DT 08-06-2018,,2018-06-11,,52153.57,-546241040.8400005,.
409000438620',2018-06-11,AEPS GST INC DT 08-06-201,,2018-06-11,,10430.71,-546230610.1300005,.
409000438620',2018-06-11,AEPS INCOME DT 09-06-2018,,2018-06-11,,47961.71,-546182648.4200004,.
409000438620',2018-06-11,AEPS GST INC DT 09-06-201,,2018-06-11,,9592.34,-546173056.0800004,.
409000438620',2018-06-11,AEPS INCOME DT 10-06-2018,,2018-06-11,,29655.23,-546143400.8500004,.
409000438620',2018-06-11,AEPS GST INC DT 10-06-201,,2018-06-11,,5931.05,-546137469.8000004,.
409000438620',2018-06-11,AEPS ACQUIRING ADJ FEES 0,,2018-06-11,91.45,,-546137561.2500005,.
409000438620',2018-06-12,Indiaforensic AEPS NPCI WDL SET,,2018-06-12,,23390600.0,-522746961.2500005,.
409000438620',2018-06-12,CR815609724476/RMCPL20978/0,,2018-06-12,1000.0,,-522747961.2500005,.
409000438620',2018-06-12,TRF TO  Indiaforensic SERVICES I,,2018-06-12,15000000.0,,-537747961.2500005,.
409000438620',2018-06-12,TRF TO  Indiaforensic SERVICES I,,2018-06-12,8500000.0,,-546247961.2500005,.
409000438620',2018-06-12,AEPS INCOME DT 11-06-2018,,2018-06-12,,55754.39,-546192206.8600005,.
409000438620',2018-06-12,AEPS GST INC DT 11-06-201,,2018-06-12,,11150.88,-546181055.9800005,.
409000438620',2018-06-13,Indiaforensic AEPS NPCI WDL SET,,2018-06-13,,25480600.0,-520700455.9800005,.
409000438620',2018-06-13,CR816011886923/RMCPL20527/0,,2018-06-13,1000.0,,-520701455.9800005,.
409000438620',2018-06-13,CR816009836626/RMCPL22967/0,,2018-06-13,1000.0,,-520702455.9800005,.
409000438620',2018-06-13,CR816010867298/RMCPL20871/0,,2018-06-13,1000.0,,-520703455.9800005,.
409000438620',2018-06-13,CR816010867288/RMCPL24082/0,,2018-06-13,2000.0,,-520705455.9800005,.
409000438620',2018-06-13,CR815911595626/RMCPL18460/0,,2018-06-13,2000.0,,-520707455.9800005,.
409000438620',2018-06-13,CR815916689441/RMCPL13836/0,,2018-06-13,1000.0,,-520708455.9800005,.
409000438620',2018-06-13,CR815910576719/RMCPL17224/0,,2018-06-13,2000.0,,-520710455.9800005,.
409000438620',2018-06-13,CR815910576675/RMCPL23925/0,,2018-06-13,5000.0,,-520715455.9800005,.
409000438620',2018-06-13,CR815910586349/RMCPL16314/0,,2018-06-13,500.0,,-520715955.9800005,.
409000438620',2018-06-13,CR815917706079/RMCPL11353/0,,2018-06-13,500.0,,-520716455.9800005,.
409000438620',2018-06-13,CR815911595629/RMCPL22249/0,,2018-06-13,500.0,,-520716955.9800005,.
409000438620',2018-06-13,CR815912618442/RMCPL18492/0,,2018-06-13,2000.0,,-520718955.9800005,.
409000438620',2018-06-13,CR815916696102/RMCPL15451/0,,2018-06-13,5000.0,,-520723955.9800005,.
409000438620',2018-06-13,CR815912629648/RMCPL24871/0,,2018-06-13,1000.0,,-520724955.9800005,.
409000438620',2018-06-13,CR815912629717/RMCPL18214/0,,2018-06-13,1500.0,,-520726455.9800005,.
409000438620',2018-06-13,CR815912618441/RMCPL25099/0,,2018-06-13,1000.0,,-520727455.9800005,.
409000438620',2018-06-13,CR815910576718/RMCPL09957/0,,2018-06-13,2100.0,,-520729555.9800005,.
409000438620',2018-06-13,CR815910576697/RMCPL17789/0,,2018-06-13,7000.0,,-520736555.9800005,.
409000438620',2018-06-13,CR815816422734/RMCPL14126/0,,2018-06-13,500.0,,-520737055.9800005,.
409000438620',2018-06-13,CR815817426325/RMCPL21765/0,,2018-06-13,1000.0,,-520738055.9800005,.
409000438620',2018-06-13,CR815816417439/RMCPL25186/0,,2018-06-13,500.0,,-520738555.9800005,.
409000438620',2018-06-13,CR815712081324/RMCPL14380/0,,2018-06-13,600.0,,-520739155.9800005,.
409000438620',2018-06-13,CR815710048938/RMCPL18177/0,,2018-06-13,500.0,,-520739655.9800005,.
409000438620',2018-06-13,CR815712081203/RMCPL23090/0,,2018-06-13,5000.0,,-520744655.9800005,.
409000438620',2018-06-13,CB809618333637/RMCPL15079/0,,2018-06-13,10000.0,,-520754655.9800005,.
409000438620',2018-06-13,CB815612795005/RMCPL23228/0,,2018-06-13,1000.0,,-520755655.9800005,.
409000438620',2018-06-13,TRF TO  Indiaforensic SERVICES I,,2018-06-13,15000000.0,,-535755655.9800005,.
409000438620',2018-06-13,TRF TO  Indiaforensic SERVICES I,,2018-06-13,10500000.0,,-546255655.9800005,.
409000438620',2018-06-13,MAW/5029649805794468/Akol,,2018-06-13,,1100.0,-546254555.9800005,.
409000438620',2018-06-13,AEPS INCOME DT 12-06-2018,,2018-06-13,,61210.16,-546193345.8200005,.
409000438620',2018-06-13,AEPS GST INC DT 12-06-201,,2018-06-13,,12242.03,-546181103.7900006,.
409000438620',2018-06-13,AEPS ACQUIRING ADJ FEES 1,,2018-06-13,17.7,,-546181121.4900006,.
409000438620',2018-06-13,AEPS ACQ CR ADJ FEES 1206,,2018-06-13,201.78,,-546181323.2700006,.
409000438620',2018-06-13,AEPS ACQ REP ADJ FEES 120,,2018-06-13,,109.15,-546181214.1200006,.
409000438620',2018-06-14,MAW/5029649805976016/Akol,,2018-06-14,,1200.0,-546180014.1200006,.
409000438620',2018-06-14,MAW/5029649809760978/Vals,,2018-06-14,,10000.0,-546170014.1200006,.
409000438620',2018-06-14,Indiaforensic AEPS NPCI WDL SET,,2018-06-14,,22831100.0,-523338914.1200006,.
409000438620',2018-06-14,TRF TO  Indiaforensic SERVICES I,,2018-06-14,15000000.0,,-538338914.1200006,.
409000438620',2018-06-14,TRF TO  Indiaforensic SERVICES I,,2018-06-14,7900000.0,,-546238914.1200006,.
409000438620',2018-06-14,MAW/5029649805528221/Akol,,2018-06-14,,2100.0,-546236814.1200006,.
409000438620',2018-06-14,AEPS INCOME DT 13-06-2018,,2018-06-14,,55166.35,-546181647.7700006,.
409000438620',2018-06-14,AEPS GST INC DT 13-06-201,,2018-06-14,,11033.27,-546170614.5000006,.
409000438620',2018-06-14,AEPS ACQUIRING ADJ FEES 1,,2018-06-14,60.18,,-546170674.6800005,.
409000438620',2018-06-14,AEPS ACQ REP ADJ FEES 130,,2018-06-14,,17.7,-546170656.9800005,.
409000438620',2018-06-15,MAW/502964XXXXXX0978/Vals,,2018-06-15,,10000.0,-546160656.9800005,.
409000438620',2018-06-15,Indiaforensic AEPS NPCI WDL SET,,2018-06-15,,22893600.0,-523267056.9800005,.
409000438620',2018-06-15,TRF TO  Indiaforensic SERVICES I,,2018-06-15,15000000.0,,-538267056.9800005,.
409000438620',2018-06-15,TRF TO  Indiaforensic SERVICES I,,2018-06-15,4000000.0,,-542267056.9800005,.
409000438620',2018-06-15,TRF TO  Indiaforensic SERVICES I,,2018-06-15,4000000.0,,-546267056.9800005,.
409000438620',2018-06-15,AEPS INCOME DT 14-06-2018,,2018-06-15,,53974.72,-546213082.2600005,.
409000438620',2018-06-15,AEPS GST INC DT 14-06-201,,2018-06-15,,10794.94,-546202287.3200004,.
409000438620',2018-06-15,AEPS ACQUIRING ADJ FEES 1,,2018-06-15,35.4,,-546202322.7200004,.
409000438620',2018-06-15,AEPS INCOME DT 14-06-2018,,2018-06-15,,53974.72,-546148348.0000004,.
409000438620',2018-06-15,AEPS GST INC DT 14-06-201,,2018-06-15,,10794.94,-546137553.0600003,.
409000438620',2018-06-16,MAW/502964XXXXXX0978/Vals,,2018-06-16,,10000.0,-546127553.0600003,.
409000438620',2018-06-18,Indiaforensic AEPS NPCI WDL SET,,2018-06-18,,16291500.0,-529836053.0600003,.
409000438620',2018-06-18,Indiaforensic AEPS NPCI WDL SET,,2018-06-18,,12921000.0,-516915053.0600003,.
409000438620',2018-06-18,TRF TO  Indiaforensic SERVICES I,,2018-06-18,15000000.0,,-531915053.0600003,.
409000438620',2018-06-18,TRF TO  Indiaforensic SERVICES I,,2018-06-18,5000000.0,,-536915053.0600003,.
409000438620',2018-06-18,TRF TO  Indiaforensic SERVICES I,,2018-06-18,5000000.0,,-541915053.0600003,.
409000438620',2018-06-18,TRF TO  Indiaforensic SERVICES I,,2018-06-18,4000000.0,,-545915053.0600003,.
409000438620',2018-06-18,Indiaforensic AEPS NPCI WDL SET,,2018-06-18,,21409400.0,-524505653.0600003,.
409000438620',2018-06-18,TRF TO  Indiaforensic SERVICES I,,2018-06-18,15000000.0,,-539505653.0600003,.
409000438620',2018-06-18,TRF TO  Indiaforensic SERVICES I,,2018-06-18,6500000.0,,-546005653.0600003,.
409000438620',2018-06-18,AEPS INCOME DT 15-06-2018,,2018-06-18,,50970.31,-545954682.7500004,.
409000438620',2018-06-18,AEPS GST INC DT 15-06-201,,2018-06-18,,10194.06,-545944488.6900004,.
409000438620',2018-06-18,AEPS INCOME DT 16-06-2018,,2018-06-18,,40528.05,-545903960.6400005,.
409000438620',2018-06-18,AEPS GST INC DT 16-06-201,,2018-06-18,,8105.61,-545895855.0300004,.
409000438620',2018-06-18,AEPS INCOME DT 17-06-2018,,2018-06-18,,32311.55,-545863543.4800005,.
409000438620',2018-06-18,AEPS GST INC DT 17-06-201,,2018-06-18,,6462.31,-545857081.1700006,.
409000438620',2018-06-18,REV AEPS INC DT 14-06-201,,2018-06-18,53974.72,,-545911055.8900006,.
409000438620',2018-06-18,REV AEPS GST DT 14-06-201,,2018-06-18,10794.94,,-545921850.8300006,.
409000438620',2018-06-19,Indiaforensic AEPS NPCI WDL SET,,2018-06-19,,20585700.0,-525336150.83000064,.
409000438620',2018-06-19,TRF TO  Indiaforensic SERVICES I,,2018-06-19,15000000.0,,-540336150.8300006,.
409000438620',2018-06-19,TRF TO  Indiaforensic SERVICES I,,2018-06-19,5900000.0,,-546236150.8300006,.
409000438620',2018-06-19,AEPS INCOME DT 18-06-2018,,2018-06-19,,50166.78,-546185984.0500007,.
409000438620',2018-06-19,AEPS GST INC DT 18-06-201,,2018-06-19,,10033.36,-546175950.6900007,.
409000438620',2018-06-20,Indiaforensic AEPS NPCI WDL SET,,2018-06-20,,22099300.0,-524076650.69000065,.
409000438620',2018-06-20,TRF TO Indiaforensic SERVICES IN,,2018-06-20,15000000.0,,-539076650.6900007,.
409000438620',2018-06-20,TRF  FROM Indiaforensic SERVICES,,2018-06-20,7200000.0,,-546276650.6900007,.
409000438620',2018-06-20,AEPS INCOME DT 19-06-2018,,2018-06-20,,53933.71,-546222716.9800006,.
409000438620',2018-06-20,AEPS GST INC DT 19-06-201,,2018-06-20,,10786.74,-546211930.2400006,.
409000438620',2018-06-20,AEPS ACQ CR ADJ FEES 1906,,2018-06-20,453.12,,-546212383.3600006,.
409000438620',2018-06-20,CR816410013229/RMCPL19723/1,,2018-06-20,500.0,,-546212883.3600006,.
409000438620',2018-06-20,CR816410013230/RMCPL20185/1,,2018-06-20,1000.0,,-546213883.3600006,.
409000438620',2018-06-20,CR816413068195/RMCPL12626/1,,2018-06-20,6400.0,,-546220283.3600006,.
409000438620',2018-06-20,CR816413068178/RMCPL09617/1,,2018-06-20,800.0,,-546221083.3600006,.
409000438620',2018-06-20,CR816411022628/RMCPL14734/1,,2018-06-20,1000.0,,-546222083.3600006,.
409000438620',2018-06-20,CR816411022644/RMCPL22022/1,,2018-06-20,1500.0,,-546223583.3600006,.
409000438620',2018-06-20,CR816411022629/RMCPL20943/1,,2018-06-20,500.0,,-546224083.3600006,.
409000438620',2018-06-20,CR816410013225/RMCPL12343/1,,2018-06-20,500.0,,-546224583.3600006,.
409000438620',2018-06-20,CR816312748180/RMCPL24661/1,,2018-06-20,3000.0,,-546227583.3600006,.
409000438620',2018-06-20,CR816710892427/RMCPL23564/1,,2018-06-20,4500.0,,-546232083.3600006,.
409000438620',2018-06-20,CR816612663210/RMCPL09003/1,,2018-06-20,1000.0,,-546233083.3600006,.
409000438620',2018-06-20,CR816618752066/RMCPL19959/1,,2018-06-20,500.0,,-546233583.3600006,.
409000438620',2018-06-20,CR816618752073/RMCPL23923/1,,2018-06-20,500.0,,-546234083.3600006,.
409000438620',2018-06-20,CR816618752082/RMCPL17294/1,,2018-06-20,1000.0,,-546235083.3600006,.
409000438620',2018-06-20,CR816610624970/RMCPL20628/1,,2018-06-20,10000.0,,-546245083.3600006,.
409000438620',2018-06-20,CR816617740873/RMCPL22821/1,,2018-06-20,4000.0,,-546249083.3600006,.
409000438620',2018-06-20,CR816516396045/RMCPL24462/1,,2018-06-20,500.0,,-546249583.3600006,.
409000438620',2018-06-20,CR816517413920/RMCPL18514/1,,2018-06-20,500.0,,-546250083.3600006,.
409000438620',2018-06-20,CR816510296677/RMCPL12343/1,,2018-06-20,1000.0,,-546251083.3600006,.
409000438620',2018-06-20,CR816510296663/RMCPL14724/1,,2018-06-20,5000.0,,-546256083.3600006,.
409000438620',2018-06-20,CR816510296661/RMCPL12252/1,,2018-06-20,1000.0,,-546257083.3600006,.
409000438620',2018-06-20,CR816510296670/RMCPL18859/1,,2018-06-20,6000.0,,-546263083.3600006,.
409000438620',2018-06-20,CR816419174216/RMCPL21735/1,,2018-06-20,3000.0,,-546266083.3600006,.
409000438620',2018-06-20,CR816415106340/RMCPL09726/1,,2018-06-20,2000.0,,-546268083.3600006,.
409000438620',2018-06-20,CR816316816501/RMCPL22941/1,,2018-06-20,1500.0,,-546269583.3600006,.
409000438620',2018-06-20,CR816311713817/RMCPL24066/1,,2018-06-20,500.0,,-546270083.3600006,.
409000438620',2018-06-20,CR816310704026/RMCPL25821/1,,2018-06-20,8000.0,,-546278083.3600006,.
409000438620',2018-06-20,CR816317825182/RMCPL19559/1,,2018-06-20,500.0,,-546278583.3600006,.
409000438620',2018-06-20,CR816211426816/RMCPL20957/1,,2018-06-20,500.0,,-546279083.3600006,.
409000438620',2018-06-20,CR816211418865/RMCPL25027/1,,2018-06-20,500.0,,-546279583.3600006,.
409000438620',2018-06-20,CR816211418847/RMCPL11793/1,,2018-06-20,2000.0,,-546281583.3600006,.
409000438620',2018-06-20,CR816617728842/RMCPL18625/1,,2018-06-20,500.0,,-546282083.3600006,.
409000438620',2018-06-20,CR816617728591/RMCPL05229/1,,2018-06-20,2500.0,,-546284583.3600006,.
409000438620',2018-06-20,CR816617728574/RMCPL22700/1,,2018-06-20,2000.0,,-546286583.3600006,.
409000438620',2018-06-20,CR816419162571/RMCPL19808/1,,2018-06-20,2000.0,,-546288583.3600006,.
409000438620',2018-06-20,CR816419162534/RMCPL00125/1,,2018-06-20,3000.0,,-546291583.3600006,.
409000438620',2018-06-20,CR816614686134/RMCPL21959/1,,2018-06-20,1000.0,,-546292583.3600006,.
409000438620',2018-06-20,CR816614686132/RMCPL22799/1,,2018-06-20,3000.0,,-546295583.3600006,.
409000438620',2018-06-20,CR816614686137/RMCPL22681/1,,2018-06-20,1000.0,,-546296583.3600006,.
409000438620',2018-06-20,CR816512335400/RMCPL22326/1,,2018-06-20,2000.0,,-546298583.3600006,.
409000438620',2018-06-20,CR816517415566/RMCPL26215/1,,2018-06-20,1000.0,,-546299583.3600006,.
409000438620',2018-06-20,CR816311713785/RMCPL13111/1,,2018-06-20,10000.0,,-546309583.3600006,.
409000438620',2018-06-20,CR816211418829/RMCPL20772/1,,2018-06-20,500.0,,-546310083.3600006,.
409000438620',2018-06-20,CR816211426787/RMCPL23898/1,,2018-06-20,3500.0,,-546313583.3600006,.
409000438620',2018-06-20,AEPS ACQ REP ADJ FEES 190,,2018-06-20,,35.4,-546313547.9600006,.
409000438620',2018-06-21,Indiaforensic AEPS NPCI WDL SET,,2018-06-21,,19624600.0,-526688947.96000063,.
409000438620',2018-06-21,CB815612793122/RMCPL12204/0,,2018-06-21,10000.0,,-526698947.96000063,.
409000438620',2018-06-21,CB815513507914/RMCPL23519/0,,2018-06-21,10000.0,,-526708947.96000063,.
409000438620',2018-06-21,CB815509444154/RMCPL14700/0,,2018-06-21,700.0,,-526709647.96000063,.
409000438620',2018-06-21,CB815312968821/RMCPL18085/0,,2018-06-21,10000.0,,-526719647.96000063,.
409000438620',2018-06-21,CB815116470962/RMCPL25816/3,,2018-06-21,500.0,,-526720147.96000063,.
409000438620',2018-06-21,TRF TO  Indiaforensic SERVICES I,,2018-06-21,4600000.0,,-531320147.96000063,.
409000438620',2018-06-21,TRF TO  Indiaforensic SERVICES I,,2018-06-21,14900000.0,,-546220147.9600006,.
409000438620',2018-06-21,AEPS INCOME DT 20-06-2018,,2018-06-21,,48644.74,-546171503.2200006,.
409000438620',2018-06-21,AEPS GST INC DT 20-06-201,,2018-06-21,,9728.95,-546161774.2700006,.
409000438620',2018-06-22,Indiaforensic AEPS NPCI WDL SET,,2018-06-22,,18803400.0,-527358374.2700006,.
409000438620',2018-06-22,CR817011723188/RMCPL18083/1,,2018-06-22,4000.0,,-527362374.2700006,.
409000438620',2018-06-22,CR817012751705/RMCPL14573/1,,2018-06-22,700.0,,-527363074.2700006,.
409000438620',2018-06-22,CR817011723155/RMCPL14954/1,,2018-06-22,500.0,,-527363574.2700006,.
409000438620',2018-06-22,CR817011739722/RMCPL11875/1,,2018-06-22,1800.0,,-527365374.2700006,.
409000438620',2018-06-22,CR817010712711/RMCPL13376/1,,2018-06-22,1800.0,,-527367174.2700006,.
409000438620',2018-06-22,CR817010712485/RMCPL20610/1,,2018-06-22,4000.0,,-527371174.2700006,.
409000438620',2018-06-22,CR817017833421/RMCPL24532/1,,2018-06-22,2000.0,,-527373174.2700006,.
409000438620',2018-06-22,CR817010713140/RMCPL23693/1,,2018-06-22,2300.0,,-527375474.2700006,.
409000438620',2018-06-22,CR817010713031/RMCPL20307/1,,2018-06-22,2000.0,,-527377474.2700006,.
409000438620',2018-06-22,CR817010713304/RMCPL10451/1,,2018-06-22,3000.0,,-527380474.2700006,.
409000438620',2018-06-22,CR817017833405/RMCPL11811/1,,2018-06-22,10000.0,,-527390474.2700006,.
409000438620',2018-06-22,CR817017833433/RMCPL10108/1,,2018-06-22,10000.0,,-527400474.2700006,.
409000438620',2018-06-22,CR817010712436/RMCPL00045/1,,2018-06-22,4000.0,,-527404474.2700006,.
409000438620',2018-06-22,CR817011723172/RMCPL18078/1,,2018-06-22,8000.0,,-527412474.2700006,.
409000438620',2018-06-22,CR817010712973/RMCPL24657/1,,2018-06-22,9000.0,,-527421474.2700006,.
409000438620',2018-06-22,CR817010713168/RMCPL24426/1,,2018-06-22,10000.0,,-527431474.2700006,.
409000438620',2018-06-22,CR817010713047/RMCPL13376/1,,2018-06-22,2200.0,,-527433674.2700006,.
409000438620',2018-06-22,CR817010713160/RMCPL26552/1,,2018-06-22,1500.0,,-527435174.2700006,.
409000438620',2018-06-22,CR817010713332/RMCPL25168/1,,2018-06-22,1000.0,,-527436174.2700006,.
409000438620',2018-06-22,CR817010713158/RMCPL23448/1,,2018-06-22,4000.0,,-527440174.2700006,.
409000438620',2018-06-22,CR817010713083/RMCPL26215/1,,2018-06-22,1000.0,,-527441174.2700006,.
409000438620',2018-06-22,CR816917548522/RMCPL11764/1,,2018-06-22,7000.0,,-527448174.2700006,.
409000438620',2018-06-22,CR816913477500/RMCPL26743/1,,2018-06-22,5000.0,,-527453174.2700006,.
409000438620',2018-06-22,CR816910423754/RMCPL24426/1,,2018-06-22,2000.0,,-527455174.2700006,.
409000438620',2018-06-22,CR816910423739/RMCPL09829/1,,2018-06-22,5500.0,,-527460674.2700006,.
409000438620',2018-06-22,CR816917541174/RMCPL18749/1,,2018-06-22,2100.0,,-527462774.2700006,.
409000438620',2018-06-22,CR816913477488/RMCPL23207/1,,2018-06-22,1000.0,,-527463774.2700006,.
409000438620',2018-06-22,CR816914499690/RMCPL19952/1,,2018-06-22,1500.0,,-527465274.2700006,.
409000438620',2018-06-22,CR816914499682/RMCPL22227/1,,2018-06-22,500.0,,-527465774.2700006,.
409000438620',2018-06-22,CR816917548542/RMCPL10689/1,,2018-06-22,700.0,,-527466474.2700006,.
409000438620',2018-06-22,CR816911442407/RMCPL24117/1,,2018-06-22,1000.0,,-527467474.2700006,.
409000438620',2018-06-22,CR816912467535/RMCPL23222/1,,2018-06-22,2500.0,,-527469974.2700006,.
409000438620',2018-06-22,CR816914499653/RMCPL16484/1,,2018-06-22,2500.0,,-527472474.2700006,.
409000438620',2018-06-22,TRF TO  Indiaforensic SERVICES I,,2018-06-22,3800000.0,,-531272474.2700006,.
409000438620',2018-06-22,TRF TO  Indiaforensic SERVICES I,,2018-06-22,15000000.0,,-546272474.2700006,.
409000438620',2018-06-22,AEPS INCOME DT 21-06-2018,,2018-06-22,,46923.8,-546225550.4700006,.
409000438620',2018-06-22,AEPS GST INC DT 21-06-201,,2018-06-22,,9384.76,-546216165.7100006,.
409000438620',2018-06-22,AEPS ACQ CR ADJ FEES 2106,,2018-06-22,410.64,,-546216576.3500006,.
409000438620',2018-06-22,CR816310704019/RMCPL17430/1,,2018-06-22,10000.0,,-546226576.3500006,.
409000438620',2018-06-22,CR816211418783/RMCPL20307/1,,2018-06-22,3500.0,,-546230076.3500006,.
409000438620',2018-06-25,Indiaforensic AEPS NPCI WDL SET,,2018-06-25,,19558700.0,-526671376.3500006,.
409000438620',2018-06-25,Indiaforensic AEPS NPCI WDL SET,,2018-06-25,,16619500.0,-510051876.3500006,.
409000438620',2018-06-25,Indiaforensic AEPS NPCI WDL SET,,2018-06-25,,11601800.0,-498450076.3500006,.
409000438620',2018-06-25,TRF TO  Indiaforensic SERVICES I,,2018-06-25,2800000.0,,-501250076.3500006,.
409000438620',2018-06-25,RTGS CHARGES AND GST/YESB,,2018-06-25,29.5,,-501250105.8500006,.
409000438620',2018-06-25,RTGS/YESBH18176501898/Indfor,1.0,2018-06-25,15000000.0,,-516250105.8500006,.
409000438620',2018-06-25,RTGS CHARGES AND GST/YESB,,2018-06-25,29.5,,-516250135.3500006,.
409000438620',2018-06-25,RTGS/YESBH18176502779/Indfor,3.0,2018-06-25,15000000.0,,-531250135.3500006,.
409000438620',2018-06-25,RTGS CHARGES AND GST/YESB,,2018-06-25,29.5,,-531250164.8500006,.
409000438620',2018-06-25,RTGS/YESBH18176503243/Indfor,2.0,2018-06-25,15000000.0,,-546250164.8500006,.
409000438620',2018-06-25,AEPS INCOME DT 22-06-2018,,2018-06-25,,49171.96,-546200992.8900006,.
409000438620',2018-06-25,AEPS GST INC DT 22-06-201,,2018-06-25,,9834.39,-546191158.5000006,.
409000438620',2018-06-25,AEPS INCOME DT 23-06-2018,,2018-06-25,,40706.18,-546150452.3200006,.
409000438620',2018-06-25,AEPS GST INC DT 23-06-201,,2018-06-25,,8141.24,-546142311.0800006,.
409000438620',2018-06-25,AEPS INCOME DT 24-06-2018,,2018-06-25,,29917.31,-546112393.7700007,.
409000438620',2018-06-25,AEPS GST INC DT 24-06-201,,2018-06-25,,5983.46,-546106410.3100007,.
409000438620',2018-06-25,AEPS ACQUIRING ADJ FEES 2,,2018-06-25,29.5,,-546106439.8100007,.
409000438620',2018-06-25,AEPS ACQ CR ADJ FEES 2206,,2018-06-25,109.15,,-546106548.9600006,.
409000438620',2018-06-25,CR817109957523/RMCPL18869/2,,2018-06-25,9000.0,,-546115548.9600006,.
409000438620',2018-06-25,CR817118112380/RMCPL02175/2,,2018-06-25,4000.0,,-546119548.9600006,.
409000438620',2018-06-25,CR817110980869/RMCPL15464/2,,2018-06-25,3000.0,,-546122548.9600006,.
409000438620',2018-06-25,CR817110972964/RMCPL18408/2,,2018-06-25,1000.0,,-546123548.9600006,.
409000438620',2018-06-25,CR817110972958/RMCPL22022/2,,2018-06-25,1500.0,,-546125048.9600006,.
409000438620',2018-06-25,CR817110975522/RMCPL18236/2,,2018-06-25,500.0,,-546125548.9600006,.
409000438620',2018-06-25,CR817110980728/RMCPL11253/2,,2018-06-25,500.0,,-546126048.9600006,.
409000438620',2018-06-25,CR817110980764/RMCPL16314/2,,2018-06-25,3000.0,,-546129048.9600006,.
409000438620',2018-06-25,CR817112005622/RMCPL21975/2,,2018-06-25,3000.0,,-546132048.9600006,.
409000438620',2018-06-25,AEPS ACQUIRING ADJ FEES 2,,2018-06-25,17.7,,-546132066.6600007,.
409000438620',2018-06-26,Indiaforensic AEPS NPCI WDL SET,,2018-06-26,,18813700.0,-527318366.6600007,.
409000438620',2018-06-26,CR817212263979/RMCPL23655/2,,2018-06-26,2300.0,,-527320666.6600007,.
409000438620',2018-06-26,CR817212267312/RMCPL26238/2,,2018-06-26,1600.0,,-527322266.6600007,.
409000438620',2018-06-26,CR817212267323/RMCPL22522/2,,2018-06-26,500.0,,-527322766.6600007,.
409000438620',2018-06-26,CR817211249534/RMCPL11613/2,,2018-06-26,10000.0,,-527332766.6600007,.
409000438620',2018-06-26,CR817211258807/RMCPL17863/2,,2018-06-26,2300.0,,-527335066.6600007,.
409000438620',2018-06-26,CR817213294235/RMCPL18850/2,,2018-06-26,1000.0,,-527336066.6600007,.
409000438620',2018-06-26,CR817213294233/RMCPL14558/2,,2018-06-26,5000.0,,-527341066.6600007,.
409000438620',2018-06-26,CR817216336056/RMCPL17244/2,,2018-06-26,1500.0,,-527342566.6600007,.
409000438620',2018-06-26,CR817217339541/RMCPL23655/2,,2018-06-26,1000.0,,-527343566.6600007,.
409000438620',2018-06-26,RTGS CHARGES AND GST/YESB,,2018-06-26,29.5,,-527343596.1600007,.
409000438620',2018-06-26,RTGS/YESBH18177599358/Indfor,5.0,2018-06-26,3900000.0,,-531243596.1600007,.
409000438620',2018-06-26,RTGS CHARGES AND GST/YESB,,2018-06-26,29.5,,-531243625.6600007,.
409000438620',2018-06-26,RTGS/YESBH18177600906/Indfor,4.0,2018-06-26,15000000.0,,-546243625.6600007,.
409000438620',2018-06-26,MAW/502964XXXXXX6863/Akol,,2018-06-26,,7000.0,-546236625.6600007,.
409000438620',2018-06-26,MAW/502964XXXXXX6863/Akol,,2018-06-26,,200.0,-546236425.6600007,.
409000438620',2018-06-26,AEPS INCOME DT 25-06-2018,,2018-06-26,,46179.69,-546190245.9700006,.
409000438620',2018-06-26,AEPS GST INC DT 25-06-201,,2018-06-26,,9235.94,-546181010.0300006,.
409000438620',2018-06-26,AEPS ACQUIRING ADJ FEES 2,,2018-06-26,26.55,,-546181036.5800005,.
409000438620',2018-06-26,AEPS ACQ CR ADJ FEES 2506,,2018-06-26,95.58,,-546181132.1600006,.
409000438620',2018-06-27,Indiaforensic AEPS NPCI WDL SET,,2018-06-27,,19526600.0,-526654532.16000056,.
409000438620',2018-06-27,TRF TO  Indiaforensic SERVICES I,,2018-06-27,9600000.0,,-536254532.16000056,.
409000438620',2018-06-27,RTGS CHARGES AND GST/YESB,,2018-06-27,29.5,,-536254561.66000056,.
409000438620',2018-06-27,RTGS/YESBH18178695745/Indfor,8.0,2018-06-27,10000000.0,,-546254561.6600006,.
409000438620',2018-06-27,AEPS INCOME DT 26-06-2018,,2018-06-27,,47661.58,-546206900.0800005,.
409000438620',2018-06-27,AEPS GST INC DT 26-06-201,,2018-06-27,,9532.32,-546197367.7600005,.
409000438620',2018-06-28,Indiaforensic AEPS NPCI WDL SET,,2018-06-28,,16865100.0,-529332267.76000047,.
409000438620',2018-06-28,CR817411782281/RMCPL18354/2,,2018-06-28,3000.0,,-529335267.76000047,.
409000438620',2018-06-28,CR817411782282/RMCPL14643/2,,2018-06-28,5000.0,,-529340267.76000047,.
409000438620',2018-06-28,CR817411776616/RMCPL18014/2,,2018-06-28,500.0,,-529340767.76000047,.
409000438620',2018-06-28,CR817317605451/RMCPL25198/2,,2018-06-28,1000.0,,-529341767.76000047,.
409000438620',2018-06-28,CR817316595526/RMCPL11966/2,,2018-06-28,2700.0,,-529344467.76000047,.
409000438620',2018-06-28,CR817316595522/RMCPL16817/2,,2018-06-28,500.0,,-529344967.76000047,.
409000438620',2018-06-28,CR817316595502/RMCPL19297/2,,2018-06-28,1400.0,,-529346367.76000047,.
409000438620',2018-06-28,CR817312540196/RMCPL26071/2,,2018-06-28,2000.0,,-529348367.76000047,.
409000438620',2018-06-28,CR817312531513/RMCPL24213/2,,2018-06-28,500.0,,-529348867.76000047,.
409000438620',2018-06-28,CR817312531539/RMCPL24844/2,,2018-06-28,4000.0,,-529352867.76000047,.
409000438620',2018-06-28,CR817609225859/RMCPL25781/2,,2018-06-28,1000.0,,-529353867.76000047,.
409000438620',2018-06-28,CR817616339194/RMCPL25346/2,,2018-06-28,3500.0,,-529357367.76000047,.
409000438620',2018-06-28,CR817612278991/RMCPL14558/2,,2018-06-28,1200.0,,-529358567.76000047,.
409000438620',2018-06-28,CR817610250420/RMCPL24033/2,,2018-06-28,1000.0,,-529359567.76000047,.
409000438620',2018-06-28,CR817612288042/RMCPL17579/2,,2018-06-28,500.0,,-529360067.76000047,.
409000438620',2018-06-28,CR817612288045/RMCPL23710/2,,2018-06-28,2000.0,,-529362067.76000047,.
409000438620',2018-06-28,CR817611260350/RMCPL25813/2,,2018-06-28,1500.0,,-529363567.76000047,.
409000438620',2018-06-28,CR817611270099/RMCPL15381/2,,2018-06-28,9000.0,,-529372567.76000047,.
409000438620',2018-06-28,CR817612278980/RMCPL11618/2,,2018-06-28,500.0,,-529373067.76000047,.
409000438620',2018-06-28,CR817614309773/RMCPL13065/2,,2018-06-28,500.0,,-529373567.76000047,.
409000438620',2018-06-28,RTGS CHARGES AND GST/YESB,,2018-06-28,29.5,,-529373597.26000047,.
409000438620',2018-06-28,RTGS/YESBH18179801413/Indfor,10.0,2018-06-28,1900000.0,,-531273597.26000047,.
409000438620',2018-06-28,RTGS CHARGES AND GST/YESB,,2018-06-28,29.5,,-531273626.76000047,.
409000438620',2018-06-28,RTGS/YESBH18179801622/Indfor,9.0,2018-06-28,15000000.0,,-546273626.7600005,.
409000438620',2018-06-28,AEPS INCOME DT 27-06-2018,,2018-06-28,,41473.49,-546232153.2700005,.
409000438620',2018-06-28,AEPS GST INC DT 27-06-201,,2018-06-28,,8294.7,-546223858.5700004,.
409000438620',2018-06-28,AEPS ACQUIRING ADJ FEES 2,,2018-06-28,53.1,,-546223911.6700004,.
409000438620',2018-06-28,AEPS ACQ CR ADJ FEES 2706,,2018-06-28,187.62,,-546224099.2900004,.
409000438620',2018-06-28,AEPS ACQ REP ADJ FEES 270,,2018-06-28,,73.75,-546224025.5400004,.
409000438620',2018-06-29,Indiaforensic AEPS NPCI WDL SET,,2018-06-29,,16653600.0,-529570425.54000044,.
409000438620',2018-06-29,TRF TO  Indiaforensic SERVICES I,,2018-06-29,15000000.0,,-544570425.5400004,.
409000438620',2018-06-29,TRF TO  Indiaforensic SERVICES I,,2018-06-29,1600000.0,,-546170425.5400004,.
409000438620',2018-06-29,AEPS INCOME DT 28-06-2018,,2018-06-29,,40141.18,-546130284.3600005,.
409000438620',2018-06-29,AEPS GST INC DT 28-06-201,,2018-06-29,,8028.24,-546122256.1200005,.
409000438620',2018-06-29,AEPS ACQ REP ADJ FEES 280,,2018-06-29,,53.1,-546122203.0200005,.
409000438620',2018-06-30,Indiaforensic AEPS NPCI WDL SET,,2018-06-30,,19723400.0,-526398803.02000046,.
409000438620',2018-06-30,CB809618333637/RMCPL15079/0,,2018-06-30,,10000.0,-526388803.02000046,.
409000438620',2018-06-30,TRF TO  Indiaforensic SERVICES I,,2018-06-30,15000000.0,,-541388803.0200005,.
409000438620',2018-06-30,TRF TO  Indiaforensic SERVICES I,,2018-06-30,4000000.0,,-545388803.0200005,.
409000438620',2018-06-30,TRF TO  Indiaforensic SERVICES I,,2018-06-30,500000.0,,-545888803.0200005,.
409000438620',2018-06-30,AEPS INCOME DT 29-06-2018,,2018-06-30,,49101.5,-545839701.5200005,.
409000438620',2018-06-30,AEPS GST INC DT 29-06-201,,2018-06-30,,9820.3,-545829881.2200005,.
409000438620',2018-06-30,AEPS ACQUIRING ADJ FEES 2,,2018-06-30,23.6,,-545829904.8200005,.
409000438620',2018-07-02,Indiaforensic AEPS NPCI WDL SET,,2018-07-02,,17213700.0,-528616204.8200005,.
409000438620',2018-07-02,Indiaforensic AEPS NPCI WDL SET,,2018-07-02,,10978600.0,-517637604.8200005,.
409000438620',2018-07-02,TRF TO  Indiaforensic SERVICES I,,2018-07-02,15000000.0,,-532637604.8200005,.
409000438620',2018-07-02,TRF TO  Indiaforensic SERVICES I,,2018-07-02,10000000.0,,-542637604.8200005,.
409000438620',2018-07-02,TRF TO  Indiaforensic SERVICES I,,2018-07-02,3000000.0,,-545637604.8200005,.
409000438620',2018-07-02,AEPS INCOME DT 30-06-2018,,2018-07-02,,42968.17,-545594636.6500006,.
409000438620',2018-07-02,AEPS GST INC DT 30-06-201,,2018-07-02,,8593.63,-545586043.0200006,.
409000438620',2018-07-02,AEPS INCOME DT 01-07-2018,,2018-07-02,,28448.23,-545557594.7900006,.
409000438620',2018-07-02,AEPS GST INC DT 01-07-201,,2018-07-02,,5689.65,-545551905.1400006,.
409000438620',2018-07-02,TRF TO  Indiaforensic SERVICES I,,2018-07-02,500000.0,,-546051905.1400006,.
409000438620',2018-07-03,Indiaforensic AEPS NPCI WDL SET,,2018-07-03,,14566600.0,-531485305.1400006,.
409000438620',2018-07-03,TRF TO  Indiaforensic SERVICES I,,2018-07-03,14800000.0,,-546285305.1400006,.
409000438620',2018-07-03,AEPS ACQUIRING ADJ FEES 0,,2018-07-03,2.95,,-546285308.0900006,.
409000438620',2018-07-03,AEPS ACQ REP ADJ FEES 020,,2018-07-03,,5.9,-546285302.1900007,.
409000438620',2018-07-03,AEPS INCOME DT 02-07-2018,,2018-07-03,,36266.16,-546249036.0300007,.
409000438620',2018-07-03,AEPS GST INC DT 02-07-201,,2018-07-03,,7253.23,-546241782.8000007,.
409000438620',2018-07-03,MAW/502964XXXXXX9901/Band,,2018-07-03,,500.0,-546241282.8000007,.
409000438620',2018-07-03,MAW/502964XXXXXX9901/Band,,2018-07-03,,1800.0,-546239482.8000007,.
409000438620',2018-07-04,Indiaforensic AEPS NPCI WDL SET,,2018-07-04,,21993000.0,-524246482.80000067,.
409000438620',2018-07-04,TRF TO  Indiaforensic SERVICES I,,2018-07-04,15000000.0,,-539246482.8000007,.
409000438620',2018-07-04,TRF TO  Indiaforensic SERVICES I,,2018-07-04,7000000.0,,-546246482.8000007,.
409000438620',2018-07-04,AEPS ACQUIRING ADJ FEES 0,,2018-07-04,35.4,,-546246518.2000006,.
409000438620',2018-07-04,AEPS INCOME DT 03-07-2018,,2018-07-04,,55769.54,-546190748.6600007,.
409000438620',2018-07-04,AEPS GST INC DT 03-07-201,,2018-07-04,,11153.91,-546179594.7500007,.
409000438620',2018-07-05,Indiaforensic AEPS NPCI WDL SET,,2018-07-05,,19312500.0,-526867094.7500007,.
409000438620',2018-07-05,CR817911060625/RMCPL20259/2,,2018-07-05,1000.0,,-526868094.7500007,.
409000438620',2018-07-05,CR817913095139/RMCPL17150/2,,2018-07-05,4000.0,,-526872094.7500007,.
409000438620',2018-07-05,CR817913090718/RMCPL20680/2,,2018-07-05,3200.0,,-526875294.7500007,.
409000438620',2018-07-05,CR817910049378/RMCPL09617/2,,2018-07-05,1700.0,,-526876994.7500007,.
409000438620',2018-07-05,CR817913087788/RMCPL14724/2,,2018-07-05,500.0,,-526877494.7500007,.
409000438620',2018-07-05,CR817913087774/RMCPL20185/2,,2018-07-05,5000.0,,-526882494.7500007,.
409000438620',2018-07-05,CR818313032506/RMCPL14700/0,,2018-07-05,5000.0,,-526887494.7500007,.
409000438620',2018-07-05,CR818312015733/RMCPL17511/0,,2018-07-05,1000.0,,-526888494.7500007,.
409000438620',2018-07-05,CR818312015805/RMCPL19070/0,,2018-07-05,10000.0,,-526898494.7500007,.
409000438620',2018-07-05,CR818313026150/RMCPL25168/0,,2018-07-05,500.0,,-526898994.7500007,.
409000438620',2018-07-05,CR818316076786/RMCPL09386/0,,2018-07-05,3000.0,,-526901994.7500007,.
409000438620',2018-07-05,CR818312011337/RMCPL20275/0,,2018-07-05,6000.0,,-526907994.7500007,.
409000438620',2018-07-05,CR818312011290/RMCPL18460/0,,2018-07-05,1200.0,,-526909194.7500007,.
409000438620',2018-07-05,CR818317083670/RMCPL21965/0,,2018-07-05,1000.0,,-526910194.7500007,.
409000438620',2018-07-05,CR818317084842/RMCPL14558/0,,2018-07-05,1600.0,,-526911794.7500007,.
409000438620',2018-07-05,CR818312005818/RMCPL22522/0,,2018-07-05,2000.0,,-526913794.7500007,.
409000438620',2018-07-05,CR818312011354/RMCPL20933/0,,2018-07-05,500.0,,-526914294.7500007,.
409000438620',2018-07-05,CR818312014256/RMCPL09617/0,,2018-07-05,3000.0,,-526917294.7500007,.
409000438620',2018-07-05,CR818315054200/RMCPL21339/0,,2018-07-05,2000.0,,-526919294.7500007,.
409000438620',2018-07-05,CR818312015709/RMCPL16347/0,,2018-07-05,1000.0,,-526920294.7500007,.
409000438620',2018-07-05,CR818013345168/RMCPL09533/2,,2018-07-05,4000.0,,-526924294.7500007,.
409000438620',2018-07-05,CR818012318019/RMCPL14562/2,,2018-07-05,10000.0,,-526934294.7500007,.
409000438620',2018-07-05,CR818012318045/RMCPL19605/2,,2018-07-05,500.0,,-526934794.7500007,.
409000438620',2018-07-05,CR818012315110/RMCPL21362/2,,2018-07-05,2000.0,,-526936794.7500007,.
409000438620',2018-07-05,CR818015388097/RMCPL21965/2,,2018-07-05,2000.0,,-526938794.7500007,.
409000438620',2018-07-05,CR818311999091/RMCPL24618/0,,2018-07-05,2500.0,,-526941294.7500007,.
409000438620',2018-07-05,CR817917134148/RMCPL21524/2,,2018-07-05,1500.0,,-526942794.7500007,.
409000438620',2018-07-05,CR817915118355/RMCPL21455/2,,2018-07-05,2000.0,,-526944794.7500007,.
409000438620',2018-07-05,CR817915118351/RMCPL22628/2,,2018-07-05,500.0,,-526945294.7500007,.
409000438620',2018-07-05,CR817917134154/RMCPL21904/2,,2018-07-05,2000.0,,-526947294.7500007,.
409000438620',2018-07-05,CR817917134145/RMCPL24604/2,,2018-07-05,500.0,,-526947794.7500007,.
409000438620',2018-07-05,CR818011300595/RMCPL18952/2,,2018-07-05,8500.0,,-526956294.7500007,.
409000438620',2018-07-05,CR818015385415/RMCPL11811/2,,2018-07-05,10000.0,,-526966294.7500007,.
409000438620',2018-07-05,CR818012327671/RMCPL21354/2,,2018-07-05,3000.0,,-526969294.7500007,.
409000438620',2018-07-05,CR818016404298/RMCPL16251/2,,2018-07-05,2500.0,,-526971794.7500007,.
409000438620',2018-07-05,CR818012327692/RMCPL26747/2,,2018-07-05,1400.0,,-526973194.7500007,.
409000438620',2018-07-05,CR818009258507/RMCPL12219/2,,2018-07-05,500.0,,-526973694.7500007,.
409000438620',2018-07-05,CR818111578716/RMCPL20276/3,,2018-07-05,10000.0,,-526983694.7500007,.
409000438620',2018-07-05,CR818111568607/RMCPL23894/3,,2018-07-05,3500.0,,-526987194.7500007,.
409000438620',2018-07-05,CR818110558087/RMCPL19297/3,,2018-07-05,5000.0,,-526992194.7500007,.
409000438620',2018-07-05,CR818118674563/RMCPL20275/3,,2018-07-05,5000.0,,-526997194.7500007,.
409000438620',2018-07-05,CR817917134139/RMCPL16173/2,,2018-07-05,500.0,,-526997694.7500007,.
409000438620',2018-07-05,CR817917141269/RMCPL16256/2,,2018-07-05,2000.0,,-526999694.7500007,.
409000438620',2018-07-05,CR818011281869/RMCPL22028/2,,2018-07-05,5000.0,,-527004694.7500007,.
409000438620',2018-07-05,CR818010267029/RMCPL16251/2,,2018-07-05,1000.0,,-527005694.7500007,.
409000438620',2018-07-05,CR818011301402/RMCPL24338/2,,2018-07-05,500.0,,-527006194.7500007,.
409000438620',2018-07-05,CR818018423001/RMCPL19798/2,,2018-07-05,500.0,,-527006694.7500007,.
409000438620',2018-07-05,CR818112597341/RMCPL22022/3,,2018-07-05,2000.0,,-527008694.7500007,.
409000438620',2018-07-05,TRF TO  Indiaforensic SERVICES I,,2018-07-05,15000000.0,,-542008694.7500007,.
409000438620',2018-07-05,TRF TO  Indiaforensic SERVICES I,,2018-07-05,4300000.0,,-546308694.7500007,.
409000438620',2018-07-05,AEPS ACQ CR ADJ FEES 0407,,2018-07-05,515.66,,-546309210.4100007,.
409000438620',2018-07-05,AEPS ACQ REP ADJ FEES 040,,2018-07-05,,2.95,-546309207.4600006,.
409000438620',2018-07-05,AEPS INCOME DT 04-07-2018,,2018-07-05,,49800.23,-546259407.2300006,.
409000438620',2018-07-05,AEPS GST INC DT 04-07-201,,2018-07-05,,9960.05,-546249447.1800007,.
409000438620',2018-07-06,MAW/502964XXXXXX6863/Akol,,2018-07-06,,7000.0,-546242447.1800007,.
409000438620',2018-07-06,Indiaforensic AEPS NPCI WDL SET,,2018-07-06,,18632000.0,-527610447.18000066,.
409000438620',2018-07-06,CR818410227877/RMCPL09497/0,,2018-07-06,2000.0,,-527612447.18000066,.
409000438620',2018-07-06,CR818412260023/RMCPL18625/0,,2018-07-06,10000.0,,-527622447.18000066,.
409000438620',2018-07-06,CR818411245398/RMCPL18408/0,,2018-07-06,6000.0,,-527628447.18000066,.
409000438620',2018-07-06,CR818415308774/RMCPL09534/0,,2018-07-06,5000.0,,-527633447.18000066,.
409000438620',2018-07-06,CR818412274562/RMCPL18521/0,,2018-07-06,2100.0,,-527635547.18000066,.
409000438620',2018-07-06,CR818411236569/RMCPL18136/0,,2018-07-06,1000.0,,-527636547.18000066,.
409000438620',2018-07-06,CR818415322197/RMCPL16774/0,,2018-07-06,8000.0,,-527644547.18000066,.
409000438620',2018-07-06,CR818416329948/RMCPL17854/0,,2018-07-06,500.0,,-527645047.18000066,.
409000438620',2018-07-06,CR818409216440/RMCPL18524/0,,2018-07-06,1000.0,,-527646047.18000066,.
409000438620',2018-07-06,CR818412260029/RMCPL17748/0,,2018-07-06,500.0,,-527646547.18000066,.
409000438620',2018-07-06,CR818412267120/RMCPL15775/0,,2018-07-06,1000.0,,-527647547.18000066,.
409000438620',2018-07-06,CR818408198262/RMCPL11592/0,,2018-07-06,10000.0,,-527657547.18000066,.
409000438620',2018-07-06,CR818415322198/RMCPL14523/0,,2018-07-06,1000.0,,-527658547.18000066,.
409000438620',2018-07-06,CR818409216443/RMCPL15451/0,,2018-07-06,6000.0,,-527664547.18000066,.
409000438620',2018-07-06,CR818410227876/RMCPL25095/0,,2018-07-06,3000.0,,-527667547.18000066,.
409000438620',2018-07-06,CR818417353905/RMCPL11784/0,,2018-07-06,2000.0,,-527669547.18000066,.
409000438620',2018-07-06,CR818412274688/RMCPL26684/0,,2018-07-06,10000.0,,-527679547.18000066,.
409000438620',2018-07-06,CR818417353932/RMCPL09185/0,,2018-07-06,1000.0,,-527680547.18000066,.
409000438620',2018-07-06,CR818412274692/RMCPL17652/0,,2018-07-06,10000.0,,-527690547.18000066,.
409000438620',2018-07-06,CR818413281719/RMCPL20610/0,,2018-07-06,1500.0,,-527692047.18000066,.
409000438620',2018-07-06,CR818413281756/RMCPL12522/0,,2018-07-06,1000.0,,-527693047.18000066,.
409000438620',2018-07-06,CR818411236552/RMCPL20023/0,,2018-07-06,1000.0,,-527694047.18000066,.
409000438620',2018-07-06,CR818412260018/RMCPL19639/0,,2018-07-06,4000.0,,-527698047.18000066,.
409000438620',2018-07-06,TRF TO  Indiaforensic SERVICES I,,2018-07-06,15000000.0,,-542698047.1800007,.
409000438620',2018-07-06,AEPS ACQUIRING ADJ FEES 0,,2018-07-06,17.7,,-542698064.8800007,.
409000438620',2018-07-06,AEPS ACQ CR ADJ FEES 0507,,2018-07-06,269.04,,-542698333.9200007,.
409000438620',2018-07-06,AEPS ACQ REP ADJ FEES 050,,2018-07-06,,17.7,-542698316.2200006,.
409000438620',2018-07-06,AEPS INCOME DT 05-07-2018,,2018-07-06,,47084.77,-542651231.4500006,.
409000438620',2018-07-06,AEPS GST INC DT 05-07-201,,2018-07-06,,9416.95,-542641814.5000006,.
409000438620',2018-07-06,TRF TO  Indiaforensic SERVICES I,,2018-07-06,3600000.0,,-546241814.5000006,.
409000438620',2018-07-07,Indiaforensic AEPS NPCI WDL SET,,2018-07-07,,18843900.0,-527397914.5000006,.
409000438620',2018-07-07,CR818508479479/RMCPL18106/0,,2018-07-07,2600.0,,-527400514.5000006,.
409000438620',2018-07-07,CR818511536215/RMCPL12778/0,,2018-07-07,1000.0,,-527401514.5000006,.
409000438620',2018-07-07,CR818511536234/RMCPL16251/0,,2018-07-07,3000.0,,-527404514.5000006,.
409000438620',2018-07-07,CR818516611615/RMCPL24303/0,,2018-07-07,1000.0,,-527405514.5000006,.
409000438620',2018-07-07,CR818511523838/RMCPL12363/0,,2018-07-07,2000.0,,-527407514.5000006,.
409000438620',2018-07-07,CR818511525588/RMCPL24609/0,,2018-07-07,2500.0,,-527410014.5000006,.
409000438620',2018-07-07,CR818512544376/RMCPL22656/0,,2018-07-07,2000.0,,-527412014.5000006,.
409000438620',2018-07-07,CR818512544371/RMCPL16956/0,,2018-07-07,1000.0,,-527413014.5000006,.
409000438620',2018-07-07,CR818511524865/RMCPL23088/0,,2018-07-07,5000.0,,-527418014.5000006,.
409000438620',2018-07-07,CR818511527060/RMCPL18600/0,,2018-07-07,1000.0,,-527419014.5000006,.
409000438620',2018-07-07,CR818516611619/RMCPL25854/0,,2018-07-07,2500.0,,-527421514.5000006,.
409000438620',2018-07-07,CR818511524286/RMCPL22056/0,,2018-07-07,1000.0,,-527422514.5000006,.
409000438620',2018-07-07,CR818511524239/RMCPL20743/0,,2018-07-07,2000.0,,-527424514.5000006,.
409000438620',2018-07-07,MAW/502964XXXXXX6016/Akol,,2018-07-07,,700.0,-527423814.5000006,.
409000438620',2018-07-07,TRF TO  Indiaforensic SERVICES I,,2018-07-07,15000000.0,,-542423814.5000006,.
409000438620',2018-07-07,TRF TO  Indiaforensic SERVICES I,,2018-07-07,500000.0,,-542923814.5000006,.
409000438620',2018-07-07,TRF TO  Indiaforensic SERVICES I,,2018-07-07,3000000.0,,-545923814.5000006,.
409000438620',2018-07-07,AEPS ACQ CR ADJ FEES 0607,,2018-07-07,145.14,,-545923959.6400006,.
409000438620',2018-07-07,AEPS INCOME DT 06-07-2018,,2018-07-07,,47565.41,-545876394.2300006,.
409000438620',2018-07-07,AEPS GST INC DT 06-07-201,,2018-07-07,,9513.08,-545866881.1500006,.
409000438620',2018-07-09,Indiaforensic AEPS NPCI WDL SET,,2018-07-09,,17365500.0,-528501381.1500006,.
409000438620',2018-07-09,Indiaforensic AEPS NPCI WDL SET,,2018-07-09,,12625100.0,-515876281.1500006,.
409000438620',2018-07-09,CR818610778061/RMCPL24389/0,,2018-07-09,1000.0,,-515877281.1500006,.
409000438620',2018-07-09,CR818618909621/RMCPL18599/0,,2018-07-09,1000.0,,-515878281.1500006,.
409000438620',2018-07-09,CR818613838475/RMCPL24532/0,,2018-07-09,2000.0,,-515880281.1500006,.
409000438620',2018-07-09,CR818613838491/RMCPL19108/0,,2018-07-09,4500.0,,-515884781.1500006,.
409000438620',2018-07-09,CR818618908084/RMCPL15322/0,,2018-07-09,1000.0,,-515885781.1500006,.
409000438620',2018-07-09,CR818608755841/RMCPL17729/0,,2018-07-09,1000.0,,-515886781.1500006,.
409000438620',2018-07-09,CR818618911045/RMCPL24776/0,,2018-07-09,2400.0,,-515889181.1500006,.
409000438620',2018-07-09,CR818608755838/RMCPL21831/0,,2018-07-09,500.0,,-515889681.1500006,.
409000438620',2018-07-09,CR818618919538/RMCPL23653/0,,2018-07-09,1000.0,,-515890681.1500006,.
409000438620',2018-07-09,CR818615872244/RMCPL14838/0,,2018-07-09,2000.0,,-515892681.1500006,.
409000438620',2018-07-09,CR818618907008/RMCPL24776/0,,2018-07-09,10000.0,,-515902681.1500006,.
409000438620',2018-07-09,CR818611805318/RMCPL23482/0,,2018-07-09,10000.0,,-515912681.1500006,.
409000438620',2018-07-09,CR818617902000/RMCPL17890/0,,2018-07-09,1000.0,,-515913681.1500006,.
409000438620',2018-07-09,CR818617906464/RMCPL25318/0,,2018-07-09,500.0,,-515914181.1500006,.
409000438620',2018-07-09,CR818611796795/RMCPL24657/0,,2018-07-09,2000.0,,-515916181.1500006,.
409000438620',2018-07-09,CR818611796804/RMCPL12805/0,,2018-07-09,500.0,,-515916681.1500006,.
409000438620',2018-07-09,CR818611796754/RMCPL12509/0,,2018-07-09,5000.0,,-515921681.1500006,.
409000438620',2018-07-09,CR818618907118/RMCPL18215/0,,2018-07-09,2000.0,,-515923681.1500006,.
409000438620',2018-07-09,CR818618907044/RMCPL09982/0,,2018-07-09,2000.0,,-515925681.1500006,.
409000438620',2018-07-09,CR818618907269/RMCPL09615/0,,2018-07-09,7000.0,,-515932681.1500006,.
409000438620',2018-07-09,CR818610792624/RMCPL20121/0,,2018-07-09,500.0,,-515933181.1500006,.
409000438620',2018-07-09,CR818616887075/RMCPL11922/0,,2018-07-09,500.0,,-515933681.1500006,.
409000438620',2018-07-09,CR818608755837/RMCPL21533/0,,2018-07-09,10000.0,,-515943681.1500006,.
409000438620',2018-07-09,CR818618906640/RMCPL17538/0,,2018-07-09,1000.0,,-515944681.1500006,.
409000438620',2018-07-09,CR818618910927/RMCPL23764/0,,2018-07-09,1000.0,,-515945681.1500006,.
409000438620',2018-07-09,CR818611796803/RMCPL18201/0,,2018-07-09,2500.0,,-515948181.1500006,.
409000438620',2018-07-09,CR818615872249/RMCPL20978/0,,2018-07-09,10000.0,,-515958181.1500006,.
409000438620',2018-07-09,CR818618910200/RMCPL22856/0,,2018-07-09,2000.0,,-515960181.1500006,.
409000438620',2018-07-09,CR818617894311/RMCPL12321/0,,2018-07-09,1000.0,,-515961181.1500006,.
409000438620',2018-07-09,CR818611813747/RMCPL25225/0,,2018-07-09,2500.0,,-515963681.1500006,.
409000438620',2018-07-09,CR818611813775/RMCPL18244/0,,2018-07-09,1000.0,,-515964681.1500006,.
409000438620',2018-07-09,CR818618909994/RMCPL12626/0,,2018-07-09,9500.0,,-515974181.1500006,.
409000438620',2018-07-09,CR818618910659/RMCPL20797/0,,2018-07-09,7000.0,,-515981181.1500006,.
409000438620',2018-07-09,TRF TO  Indiaforensic SERVICES I,,2018-07-09,15000000.0,,-530981181.1500006,.
409000438620',2018-07-09,TRF TO  Indiaforensic SERVICES I,,2018-07-09,10000000.0,,-540981181.1500006,.
409000438620',2018-07-09,TRF TO  Indiaforensic SERVICES I,,2018-07-09,5000000.0,,-545981181.1500006,.
409000438620',2018-07-09,AEPS ACQ CR ADJ FEES 0707,,2018-07-09,347.51,,-545981528.6600006,.
409000438620',2018-07-09,AEPS INCOME DT 07-07-2018,,2018-07-09,,43328.45,-545938200.2100005,.
409000438620',2018-07-09,AEPS GST INC DT 07-07-201,,2018-07-09,,8665.69,-545929534.5200005,.
409000438620',2018-07-09,AEPS INCOME DT 08-07-2018,,2018-07-09,,32497.97,-545897036.5500004,.
409000438620',2018-07-09,AEPS GST INC DT 08-07-201,,2018-07-09,,6499.59,-545890536.9600004,.
409000438620',2018-07-09,TRF TO  Indiaforensic SERVICES I,,2018-07-09,400000.0,,-546290536.9600004,.
409000438620',2018-07-10,Indiaforensic AEPS NPCI WDL SET,,2018-07-10,,18969000.0,-527321536.9600004,.
409000438620',2018-07-10,TRF TO  Indiaforensic SERVICES I,,2018-07-10,5000000.0,,-532321536.9600004,.
409000438620',2018-07-10,TRF TO  Indiaforensic SERVICES I,,2018-07-10,5000000.0,,-537321536.9600004,.
409000438620',2018-07-10,TRF TO  Indiaforensic SERVICES I,,2018-07-10,5000000.0,,-542321536.9600004,.
409000438620',2018-07-10,TRF TO  Indiaforensic SERVICES I,,2018-07-10,3000000.0,,-545321536.9600004,.
409000438620',2018-07-10,TRF TO  Indiaforensic SERVICES I,,2018-07-10,500000.0,,-545821536.9600004,.
409000438620',2018-07-10,TRF TO  Indiaforensic SERVICES I,,2018-07-10,400000.0,,-546221536.9600004,.
409000438620',2018-07-10,AEPS INCOME DT 09-07-2018,,2018-07-10,,48533.01,-546173003.9500004,.
409000438620',2018-07-10,AEPS GST INC DT 09-07-201,,2018-07-10,,9706.6,-546163297.3500004,.
409000438620',2018-07-10,AEPS ACQ REP ADJ FEES 080,,2018-07-10,,11.8,-546163285.5500004,.
409000438620',2018-07-11,Indiaforensic AEPS NPCI WDL SET,,2018-07-11,,20547500.0,-525615785.5500004,.
409000438620',2018-07-11,TRF TO  Indiaforensic SERVICES I,,2018-07-11,15000000.0,,-540615785.5500004,.
409000438620',2018-07-11,TRF TO  Indiaforensic SERVICES I,,2018-07-11,5600000.0,,-546215785.5500004,.
409000438620',2018-07-11,AEPS INCOME DT 10-07-2018,,2018-07-11,,51568.79,-546164216.7600005,.
409000438620',2018-07-11,AEPS GST INC DT 10-07-201,,2018-07-11,,10313.76,-546153903.0000005,.
409000438620',2018-07-11,AEPS ACQUIRING ADJ FEES 1,,2018-07-11,32.45,,-546153935.4500005,.
409000438620',2018-07-12,MAW/502964XXXXXX3725/Karu,,2018-07-12,,1600.0,-546152335.4500005,.
409000438620',2018-07-12,Indiaforensic AEPS NPCI WDL SET,,2018-07-12,,18954100.0,-527198235.4500005,.
409000438620',2018-07-12,MAW/502964XXXXXX1878/Karu,,2018-07-12,,1600.0,-527196635.4500005,.
409000438620',2018-07-12,MAW/502964XXXXXX6904/Karu,,2018-07-12,,1600.0,-527195035.4500005,.
409000438620',2018-07-12,MAW/502964XXXXXX1886/Karu,,2018-07-12,,1600.0,-527193435.4500005,.
409000438620',2018-07-12,MAW/502964XXXXXX3632/Karu,,2018-07-12,,1600.0,-527191835.4500005,.
409000438620',2018-07-12,CR818910567520/RMCPL19766/0,,2018-07-12,1000.0,,-527192835.4500005,.
409000438620',2018-07-12,CR818910567410/RMCPL23172/0,,2018-07-12,500.0,,-527193335.4500005,.
409000438620',2018-07-12,CR818810313632/RMCPL18971/0,,2018-07-12,4300.0,,-527197635.4500005,.
409000438620',2018-07-12,CR818716144454/RMCPL15214/0,,2018-07-12,1500.0,,-527199135.4500005,.
409000438620',2018-07-12,CR818716152598/RMCPL24568/0,,2018-07-12,1500.0,,-527200635.4500005,.
409000438620',2018-07-12,CR819014861159/RMCPL18940/0,,2018-07-12,800.0,,-527201435.4500005,.
409000438620',2018-07-12,CR819011815294/RMCPL18312/0,,2018-07-12,3500.0,,-527204935.4500005,.
409000438620',2018-07-12,CR819011815300/RMCPL18122/0,,2018-07-12,1200.0,,-527206135.4500005,.
409000438620',2018-07-12,CR819011815326/RMCPL20111/0,,2018-07-12,3900.0,,-527210035.4500005,.
409000438620',2018-07-12,CR819011807398/RMCPL19220/0,,2018-07-12,1000.0,,-527211035.4500005,.
409000438620',2018-07-12,CR819011807396/RMCPL24591/0,,2018-07-12,8000.0,,-527219035.4500005,.
409000438620',2018-07-12,CR818813371165/RMCPL20869/0,,2018-07-12,1000.0,,-527220035.4500005,.
409000438620',2018-07-12,CR818813371167/RMCPL11793/0,,2018-07-12,500.0,,-527220535.4500005,.
409000438620',2018-07-12,CR818819458388/RMCPL21152/0,,2018-07-12,3500.0,,-527224035.4500005,.
409000438620',2018-07-12,CR818810304652/RMCPL16726/0,,2018-07-12,500.0,,-527224535.4500005,.
409000438620',2018-07-12,CR818811323820/RMCPL21354/0,,2018-07-12,1000.0,,-527225535.4500005,.
409000438620',2018-07-12,CR818810304681/RMCPL17774/0,,2018-07-12,1000.0,,-527226535.4500005,.
409000438620',2018-07-12,CR818712100809/RMCPL17070/0,,2018-07-12,1000.0,,-527227535.4500005,.
409000438620',2018-07-12,CR818717165778/RMCPL18014/0,,2018-07-12,3000.0,,-527230535.4500005,.
409000438620',2018-07-12,CR818714126531/RMCPL26747/0,,2018-07-12,10000.0,,-527240535.4500005,.
409000438620',2018-07-12,CR819010789968/RMCPL23352/0,,2018-07-12,5000.0,,-527245535.4500005,.
409000438620',2018-07-12,CR819011807449/RMCPL15696/0,,2018-07-12,500.0,,-527246035.4500005,.
409000438620',2018-07-12,CR819017920509/RMCPL11996/0,,2018-07-12,1000.0,,-527247035.4500005,.
409000438620',2018-07-12,CR819010797887/RMCPL22378/0,,2018-07-12,800.0,,-527247835.4500005,.
409000438620',2018-07-12,CR819011807456/RMCPL15500/0,,2018-07-12,4500.0,,-527252335.4500005,.
409000438620',2018-07-12,CR819010789974/RMCPL26747/0,,2018-07-12,500.0,,-527252835.4500005,.
409000438620',2018-07-12,CR819012824692/RMCPL20757/0,,2018-07-12,4000.0,,-527256835.4500005,.
409000438620',2018-07-12,CR818712095216/RMCPL26867/0,,2018-07-12,1000.0,,-527257835.4500005,.
409000438620',2018-07-12,CR818711076151/RMCPL18216/0,,2018-07-12,1800.0,,-527259635.4500005,.
409000438620',2018-07-12,CR818710049716/RMCPL20307/0,,2018-07-12,1500.0,,-527261135.4500005,.
409000438620',2018-07-12,MAW/502964XXXXXX7940/Karu,,2018-07-12,,1600.0,-527259535.4500005,.
409000438620',2018-07-12,MAW/502964XXXXXX7614/Karu,,2018-07-12,,1600.0,-527257935.4500005,.
409000438620',2018-07-12,MAW/502964XXXXXX6896/Karu,,2018-07-12,,1600.0,-527256335.4500005,.
409000438620',2018-07-12,TRF TO  Indiaforensic SERVICES I,,2018-07-12,15000000.0,,-542256335.4500005,.
409000438620',2018-07-12,TRF TO  Indiaforensic SERVICES I,,2018-07-12,4000000.0,,-546256335.4500005,.
409000438620',2018-07-12,AEPS INCOME DT 11-07-2018,,2018-07-12,,46763.67,-546209571.7800006,.
409000438620',2018-07-12,AEPS GST INC DT 11-07-201,,2018-07-12,,9352.73,-546200219.0500005,.
409000438620',2018-07-12,AEPS ACQ CR ADJ FEES 1107,,2018-07-12,292.64,,-546200511.6900005,.
409000438620',2018-07-12,MAW/502964XXXXXX1963/NAGA,,2018-07-12,,700.0,-546199811.6900005,.
409000438620',2018-07-12,TRF TO  Indiaforensic SERVICES I,,2018-07-12,100000.0,,-546299811.6900005,.
409000438620',2018-07-13,Indiaforensic AEPS NPCI WDL SET,,2018-07-13,,17435700.0,-528864111.69000053,.
409000438620',2018-07-13,CR819115163468/RMCPL21107/1,,2018-07-13,1100.0,,-528865211.69000053,.
409000438620',2018-07-13,CR819115163485/RMCPL15540/1,,2018-07-13,5000.0,,-528870211.69000053,.
409000438620',2018-07-13,CR819112110491/RMCPL22588/1,,2018-07-13,1000.0,,-528871211.69000053,.
409000438620',2018-07-13,CR819113123586/RMCPL23228/1,,2018-07-13,3000.0,,-528874211.69000053,.
409000438620',2018-07-13,CR819115156767/RMCPL12778/1,,2018-07-13,3500.0,,-528877711.69000053,.
409000438620',2018-07-13,CR819115156780/RMCPL18799/1,,2018-07-13,500.0,,-528878211.69000053,.
409000438620',2018-07-13,CR819115156769/RMCPL22584/1,,2018-07-13,2000.0,,-528880211.69000053,.
409000438620',2018-07-13,CR819118214018/RMCPL09003/1,,2018-07-13,500.0,,-528880711.69000053,.
409000438620',2018-07-13,CR819115160060/RMCPL11811/1,,2018-07-13,10000.0,,-528890711.69000053,.
409000438620',2018-07-13,CR819111087856/RMCPL09523/1,,2018-07-13,10000.0,,-528900711.69000053,.
409000438620',2018-07-13,CR819113123593/RMCPL11480/1,,2018-07-13,500.0,,-528901211.69000053,.
409000438620',2018-07-13,CR819115160040/RMCPL11151/1,,2018-07-13,3000.0,,-528904211.69000053,.
409000438620',2018-07-13,CR819109062279/RMCPL19554/1,,2018-07-13,500.0,,-528904711.69000053,.
409000438620',2018-07-13,CR819117183044/RMCPL17349/1,,2018-07-13,1000.0,,-528905711.69000053,.
409000438620',2018-07-13,CR819111094917/RMCPL17167/1,,2018-07-13,2000.0,,-528907711.69000053,.
409000438620',2018-07-13,CR819113124841/RMCPL17454/1,,2018-07-13,8500.0,,-528916211.69000053,.
409000438620',2018-07-13,CR819113124815/RMCPL18460/1,,2018-07-13,1200.0,,-528917411.69000053,.
409000438620',2018-07-13,CR819111094924/RMCPL17957/1,,2018-07-13,6500.0,,-528923911.69000053,.
409000438620',2018-07-13,CB817712550115/RMCPL25522/2,,2018-07-13,6500.0,,-528930411.69000053,.
409000438620',2018-07-13,CB817711530397/RMCPL19108/1,,2018-07-13,10000.0,,-528940411.69000053,.
409000438620',2018-07-13,CB817812811494/RMCPL18940/2,,2018-07-13,1000.0,,-528941411.69000053,.
409000438620',2018-07-13,TRF TO  Indiaforensic SERVICES I,,2018-07-13,15000000.0,,-543941411.6900005,.
409000438620',2018-07-13,TRF TO  Indiaforensic SERVICES I,,2018-07-13,2300000.0,,-546241411.6900005,.
409000438620',2018-07-13,MAW/502964XXXXXX7548/Karu,,2018-07-13,,2000.0,-546239411.6900005,.
409000438620',2018-07-13,MAW/502964XXXXXX8066/Karu,,2018-07-13,,2000.0,-546237411.6900005,.
409000438620',2018-07-13,AEPS INCOME DT 12-07-2018,,2018-07-13,,43633.34,-546193778.3500005,.
409000438620',2018-07-13,AEPS GST INC DT 12-07-201,,2018-07-13,,8726.67,-546185051.6800005,.
409000438620',2018-07-13,AEPS ACQUIRING ADJ FEES 1,,2018-07-13,8.85,,-546185060.5300006,.
409000438620',2018-07-13,AEPS ACQ CR ADJ FEES 1207,,2018-07-13,202.27,,-546185262.8000005,.
409000438620',2018-07-13,AEPS ACQ REP ADJ FEES 120,,2018-07-13,,14.75,-546185248.0500005,.
409000438620',2018-07-16,MAW/502964XXXXXX8768/Karu,,2018-07-16,,1600.0,-546183648.0500005,.
409000438620',2018-07-16,MAW/502964XXXXXX0681/Karu,,2018-07-16,,1600.0,-546182048.0500005,.
409000438620',2018-07-16,MAW/502964XXXXXX4077/Karu,,2018-07-16,,1600.0,-546180448.0500005,.
409000438620',2018-07-16,Indiaforensic AEPS NPCI WDL SET,,2018-07-16,,19193300.0,-526987148.05000055,.
409000438620',2018-07-16,Indiaforensic AEPS NPCI WDL SET,,2018-07-16,,16914600.0,-510072548.05000055,.
409000438620',2018-07-16,Indiaforensic AEPS NPCI WDL SET,,2018-07-16,,11609400.0,-498463148.05000055,.
409000438620',2018-07-16,MAW/502964XXXXXX6586/Karu,,2018-07-16,,1700.0,-498461448.05000055,.
409000438620',2018-07-16,MAW/502964XXXXXX3387/Karu,,2018-07-16,,1700.0,-498459748.05000055,.
409000438620',2018-07-16,MAW/502964XXXXXX6214/Karu,,2018-07-16,,1700.0,-498458048.05000055,.
409000438620',2018-07-16,TRF TO  Indiaforensic SERVICES I,,2018-07-16,15000000.0,,-513458048.05000055,.
409000438620',2018-07-16,TRF TO  Indiaforensic SERVICES I,,2018-07-16,15000000.0,,-528458048.05000055,.
409000438620',2018-07-16,TRF TO  Indiaforensic SERVICES I,,2018-07-16,15000000.0,,-543458048.0500005,.
409000438620',2018-07-16,TRF TO  Indiaforensic SERVICES I,,2018-07-16,2000000.0,,-545458048.0500005,.
409000438620',2018-07-16,MAW/502964XXXXXX1047/Karu,,2018-07-16,,1700.0,-545456348.0500005,.
409000438620',2018-07-16,MAW/502964XXXXXX1310/Karu,,2018-07-16,,1700.0,-545454648.0500005,.
409000438620',2018-07-16,MAW/502964XXXXXX5053/Karu,,2018-07-16,,1700.0,-545452948.0500005,.
409000438620',2018-07-16,MAW/502964XXXXXX7075/Karu,,2018-07-16,,1700.0,-545451248.0500005,.
409000438620',2018-07-16,MAW/502964XXXXXX5532/Karu,,2018-07-16,,1700.0,-545449548.0500005,.
409000438620',2018-07-16,MAW/502964XXXXXX3475/Karu,,2018-07-16,,1700.0,-545447848.0500005,.
409000438620',2018-07-16,MAW/502964XXXXXX8727/Karu,,2018-07-16,,1700.0,-545446148.0500005,.
409000438620',2018-07-16,MAW/502964XXXXXX8715/Karu,,2018-07-16,,1700.0,-545444448.0500005,.
409000438620',2018-07-16,MAW/502964XXXXXX8005/Karu,,2018-07-16,,1700.0,-545442748.0500005,.
409000438620',2018-07-16,MAW/502964XXXXXX7705/Karu,,2018-07-16,,1700.0,-545441048.0500005,.
409000438620',2018-07-16,MAW/502964XXXXXX8041/Karu,,2018-07-16,,1700.0,-545439348.0500005,.
409000438620',2018-07-16,AEPS INCOME DT 13-07-2018,,2018-07-16,,48836.32,-545390511.7300005,.
409000438620',2018-07-16,AEPS GST INC DT 13-07-201,,2018-07-16,,9767.26,-545380744.4700005,.
409000438620',2018-07-16,AEPS INCOME DT 14-07-2018,,2018-07-16,,44515.6,-545336228.8700005,.
409000438620',2018-07-16,AEPS GST INC DT 14-07-201,,2018-07-16,,8903.12,-545327325.7500005,.
409000438620',2018-07-16,AEPS INCOME DT 15-07-2018,,2018-07-16,,31345.66,-545295980.0900005,.
409000438620',2018-07-16,AEPS GST INC DT 15-07-201,,2018-07-16,,6269.13,-545289710.9600005,.
409000438620',2018-07-16,AEPS ACQUIRING ADJ FEES 1,,2018-07-16,17.7,,-545289728.6600006,.
409000438620',2018-07-16,TRF TO  Indiaforensic SERVICES I,,2018-07-16,800000.0,,-546089728.6600006,.
409000438620',2018-07-17,MAW/502964XXXXXX7484/Karu,,2018-07-17,,1700.0,-546088028.6600006,.
409000438620',2018-07-17,MAW/502964XXXXXX1797/Karu,,2018-07-17,,1000.0,-546087028.6600006,.
409000438620',2018-07-17,Indiaforensic AEPS NPCI WDL SET,,2018-07-17,,17007300.0,-529079728.66000056,.
409000438620',2018-07-17,MAW/502964XXXXXX4420/Karu,,2018-07-17,,1700.0,-529078028.66000056,.
409000438620',2018-07-17,CB818910567761/RMCPL18971/0,,2018-07-17,10000.0,,-529088028.66000056,.
409000438620',2018-07-17,TRF TO  Indiaforensic SERVICES I,,2018-07-17,15000000.0,,-544088028.6600006,.
409000438620',2018-07-17,TRF TO  Indiaforensic SERVICES I,,2018-07-17,2200000.0,,-546288028.6600006,.
409000438620',2018-07-17,MAW/502964XXXXXX3285/Karu,,2018-07-17,,1800.0,-546286228.6600006,.
409000438620',2018-07-17,MAW/502964XXXXXX0600/Karu,,2018-07-17,,1800.0,-546284428.6600006,.
409000438620',2018-07-17,MAW/502964XXXXXX3780/Karu,,2018-07-17,,1800.0,-546282628.6600006,.
409000438620',2018-07-17,MAW/502964XXXXXX0872/Karu,,2018-07-17,,1500.0,-546281128.6600006,.
409000438620',2018-07-17,MAW/502964XXXXXX7106/Karu,,2018-07-17,,1500.0,-546279628.6600006,.
409000438620',2018-07-17,AEPS INCOME DT 16-07-2018,,2018-07-17,,44746.7,-546234881.9600005,.
409000438620',2018-07-17,AEPS GST INC DT 16-07-201,,2018-07-17,,8949.34,-546225932.6200005,.
409000438620',2018-07-17,AEPS ACQUIRING ADJ FEES 1,,2018-07-17,47.2,,-546225979.8200005,.
409000438620',2018-07-17,AEPS ACQ REP ADJ FEES 160,,2018-07-17,,8.85,-546225970.9700005,.
409000438620',2018-07-18,MAW/502964XXXXXX6739/Karu,,2018-07-18,,1700.0,-546224270.9700005,.
409000438620',2018-07-18,MAW/502964XXXXXX0731/Karu,,2018-07-18,,1500.0,-546222770.9700005,.
409000438620',2018-07-18,MAW/502964XXXXXX6389/Karu,,2018-07-18,,1500.0,-546221270.9700005,.
409000438620',2018-07-18,MAW/502964XXXXXX1195/Karu,,2018-07-18,,1500.0,-546219770.9700005,.
409000438620',2018-07-18,MAW/502964XXXXXX4640/Karu,,2018-07-18,,1700.0,-546218070.9700005,.
409000438620',2018-07-18,MAW/502964XXXXXX0192/Karu,,2018-07-18,,1700.0,-546216370.9700005,.
409000438620',2018-07-18,MAW/502964XXXXXX7622/Karu,,2018-07-18,,1700.0,-546214670.9700005,.
409000438620',2018-07-18,MAW/502964XXXXXX7721/Karu,,2018-07-18,,1700.0,-546212970.9700005,.
409000438620',2018-07-18,MAW/502964XXXXXX2057/Karu,,2018-07-18,,1700.0,-546211270.9700005,.
409000438620',2018-07-18,MAW/502964XXXXXX4274/Karu,,2018-07-18,,1700.0,-546209570.9700005,.
409000438620',2018-07-18,MAW/502964XXXXXX1054/Karu,,2018-07-18,,1700.0,-546207870.9700005,.
409000438620',2018-07-18,MAW/502964XXXXXX0617/Karu,,2018-07-18,,1500.0,-546206370.9700005,.
409000438620',2018-07-18,Indiaforensic AEPS NPCI WDL SET,,2018-07-18,,18409200.0,-527797170.9700005,.
409000438620',2018-07-18,MAW/502964XXXXXX4828/Karu,,2018-07-18,,1700.0,-527795470.9700005,.
409000438620',2018-07-18,MAW/502964XXXXXX3533/Karu,,2018-07-18,,1700.0,-527793770.9700005,.
409000438620',2018-07-18,MAW/502964XXXXXX7564/Karu,,2018-07-18,,1700.0,-527792070.9700005,.
409000438620',2018-07-18,MAW/502964XXXXXX3989/Karu,,2018-07-18,,1500.0,-527790570.9700005,.
409000438620',2018-07-18,MAW/502964XXXXXX9721/NAGA,,2018-07-18,,1800.0,-527788770.9700005,.
409000438620',2018-07-18,TRF TO  Indiaforensic SERVICES I,,2018-07-18,15000000.0,,-542788770.9700005,.
409000438620',2018-07-18,TRF TO  Indiaforensic SERVICES I,,2018-07-18,3500000.0,,-546288770.9700005,.
409000438620',2018-07-18,AEPS INCOME DT 17-07-2018,,2018-07-18,,49534.89,-546239236.0800005,.
409000438620',2018-07-18,AEPS GST INC DT 17-07-201,,2018-07-18,,9906.98,-546229329.1000005,.
409000438620',2018-07-18,AEPS ACQUIRING ADJ FEES 1,,2018-07-18,11.8,,-546229340.9000005,.
409000438620',2018-07-18,AEPS ACQ REP ADJ FEES 170,,2018-07-18,,64.9,-546229276.0000005,.
409000438620',2018-07-19,MAW/502964XXXXXX9008/Karu,,2018-07-19,,1700.0,-546227576.0000005,.
409000438620',2018-07-19,MAW/502964XXXXXX0487/Karu,,2018-07-19,,1700.0,-546225876.0000005,.
409000438620',2018-07-19,MAW/502964XXXXXX9802/Karu,,2018-07-19,,1700.0,-546224176.0000005,.
409000438620',2018-07-19,MAW/502964XXXXXX5596/Karu,,2018-07-19,,1700.0,-546222476.0000005,.
409000438620',2018-07-19,Indiaforensic AEPS NPCI WDL SET,,2018-07-19,,20714779.0,-525507697.0000005,.
409000438620',2018-07-19,MAW/502964XXXXXX8799/Karu,,2018-07-19,,1500.0,-525506197.0000005,.
409000438620',2018-07-19,MAW/502964XXXXXX4977/Karu,,2018-07-19,,1500.0,-525504697.0000005,.
409000438620',2018-07-19,MAW/502964XXXXXX8939/Karu,,2018-07-19,,1600.0,-525503097.0000005,.
409000438620',2018-07-19,MAW/502964XXXXXX3400/Karu,,2018-07-19,,1600.0,-525501497.0000005,.
409000438620',2018-07-19,MAW/502964XXXXXX4094/Karu,,2018-07-19,,1700.0,-525499797.0000005,.
409000438620',2018-07-19,MAW/502964XXXXXX4177/Karu,,2018-07-19,,1700.0,-525498097.0000005,.
409000438620',2018-07-19,MAW/502964XXXXXX2847/Karu,,2018-07-19,,1700.0,-525496397.0000005,.
409000438620',2018-07-19,MAW/502964XXXXXX2336/Karu,,2018-07-19,,1700.0,-525494697.0000005,.
409000438620',2018-07-19,MAW/502964XXXXXX5727/Karu,,2018-07-19,,1700.0,-525492997.0000005,.
409000438620',2018-07-19,TRF TO  Indiaforensic SERVICES I,,2018-07-19,15000000.0,,-540492997.0000005,.
409000438620',2018-07-19,TRF TO  Indiaforensic SERVICES I,,2018-07-19,5800000.0,,-546292997.0000005,.
409000438620',2018-07-19,CB819212371057/RMCPL12343/1,,2018-07-19,2000.0,,-546294997.0000005,.
409000438620',2018-07-19,TRF FROM  Indiaforensic SERVICES,,2018-07-19,,2400000.0,-543894997.0000005,.
409000438620',2018-07-19,AEPS INCOME DT 18-07-2018,,2018-07-19,,49165.27,-543845831.7300005,.
409000438620',2018-07-19,AEPS GST INC DT 18-07-201,,2018-07-19,,9833.05,-543835998.6800005,.
409000438620',2018-07-19,AEPS ACQUIRING ADJ FEES 1,,2018-07-19,102.66,,-543836101.3400005,.
409000438620',2018-07-19,TRF FROM  Indiaforensic SERVICES,,2018-07-19,,100000.0,-543736101.3400005,.
409000438620',2018-07-19,Indiaforensic AEPS NPCI WDL SET,,2018-07-19,,18216700.0,-525519401.3400005,.
409000438620',2018-07-19,Indiaforensic AEPS NPCI WDL SET,,2018-07-19,20714779.0,,-546234180.3400005,.
409000438620',2018-07-20,MAW/502964XXXXXX3027/Karu,,2018-07-20,,1800.0,-546232380.3400005,.
409000438620',2018-07-20,MAW/502964XXXXXX8058/Karu,,2018-07-20,,1700.0,-546230680.3400005,.
409000438620',2018-07-20,MAW/502964XXXXXX7499/Karu,,2018-07-20,,1800.0,-546228880.3400005,.
409000438620',2018-07-20,MAW/502964XXXXXX8784/Karu,,2018-07-20,,1800.0,-546227080.3400005,.
409000438620',2018-07-20,MAW/502964XXXXXX8146/Karu,,2018-07-20,,1800.0,-546225280.3400005,.
409000438620',2018-07-20,MAW/502964XXXXXX4799/Karu,,2018-07-20,,1700.0,-546223580.3400005,.
409000438620',2018-07-20,MAW/502964XXXXXX0932/Karu,,2018-07-20,,1700.0,-546221880.3400005,.
409000438620',2018-07-20,MAW/502964XXXXXX5046/Karu,,2018-07-20,,1700.0,-546220180.3400005,.
409000438620',2018-07-20,MAW/502964XXXXXX0924/Karu,,2018-07-20,,1700.0,-546218480.3400005,.
409000438620',2018-07-20,Indiaforensic AEPS NPCI WDL SET,,2018-07-20,,15327400.0,-530891080.3400005,.
409000438620',2018-07-20,MAW/502964XXXXXX3657/Karu,,2018-07-20,,1700.0,-530889380.3400005,.
409000438620',2018-07-20,CR819510057075/RMCPL09726/1,,2018-07-20,500.0,,-530889880.3400005,.
409000438620',2018-07-20,CR819512093323/RMCPL23438/1,,2018-07-20,10000.0,,-530899880.3400005,.
409000438620',2018-07-20,CR819512093335/RMCPL14829/1,,2018-07-20,1000.0,,-530900880.3400005,.
409000438620',2018-07-20,CR819409814638/RMCPL26284/1,,2018-07-20,6500.0,,-530907380.3400005,.
409000438620',2018-07-20,CR819410830329/RMCPL27513/1,,2018-07-20,4000.0,,-530911380.3400005,.
409000438620',2018-07-20,CR819410830344/RMCPL25071/1,,2018-07-20,7100.0,,-530918480.3400005,.
409000438620',2018-07-20,CR819412852130/RMCPL26215/1,,2018-07-20,1000.0,,-530919480.3400005,.
409000438620',2018-07-20,CR819412859792/RMCPL16684/1,,2018-07-20,3000.0,,-530922480.3400005,.
409000438620',2018-07-20,CR819408798450/RMCPL25277/1,,2018-07-20,3700.0,,-530926180.3400005,.
409000438620',2018-07-20,CR819408798465/RMCPL24836/1,,2018-07-20,2500.0,,-530928680.3400005,.
409000438620',2018-07-20,CR819410830328/RMCPL18734/1,,2018-07-20,1500.0,,-530930180.3400005,.
409000438620',2018-07-20,CR819414882749/RMCPL18017/1,,2018-07-20,2000.0,,-530932180.3400005,.
409000438620',2018-07-20,CR819413875089/RMCPL11151/1,,2018-07-20,500.0,,-530932680.3400005,.
409000438620',2018-07-20,CR819311603821/RMCPL25729/1,,2018-07-20,600.0,,-530933280.3400005,.
409000438620',2018-07-20,CR819310587519/RMCPL11613/1,,2018-07-20,5000.0,,-530938280.3400005,.
409000438620',2018-07-20,CR819311595569/RMCPL09211/1,,2018-07-20,10000.0,,-530948280.3400005,.
409000438620',2018-07-20,CR819314649580/RMCPL23084/1,,2018-07-20,1000.0,,-530949280.3400005,.
409000438620',2018-07-20,CR819311603822/RMCPL14751/1,,2018-07-20,1000.0,,-530950280.3400005,.
409000438620',2018-07-20,CR819314649584/RMCPL20628/1,,2018-07-20,1000.0,,-530951280.3400005,.
409000438620',2018-07-20,CR819312619019/RMCPL23821/1,,2018-07-20,500.0,,-530951780.3400005,.
409000438620',2018-07-20,CR819718578875/RMCPL20628/1,,2018-07-20,1000.0,,-530952780.3400005,.
409000438620',2018-07-20,CR819710457151/RMCPL25095/1,,2018-07-20,2000.0,,-530954780.3400005,.
409000438620',2018-07-20,CR819714518258/RMCPL26865/1,,2018-07-20,1000.0,,-530955780.3400005,.
409000438620',2018-07-20,CR819716554288/RMCPL23126/1,,2018-07-20,2500.0,,-530958280.3400005,.
409000438620',2018-07-20,CR819716547677/RMCPL24790/1,,2018-07-20,10000.0,,-530968280.3400005,.
409000438620',2018-07-20,CR819710457158/RMCPL19712/1,,2018-07-20,5000.0,,-530973280.3400005,.
409000438620',2018-07-20,CR819710457138/RMCPL19469/1,,2018-07-20,2000.0,,-530975280.3400005,.
409000438620',2018-07-20,CR819712485995/RMCPL18298/1,,2018-07-20,500.0,,-530975780.3400005,.
409000438620',2018-07-20,CR819714518249/RMCPL21642/1,,2018-07-20,2000.0,,-530977780.3400005,.
409000438620',2018-07-20,CR819715534653/RMCPL22303/1,,2018-07-20,500.0,,-530978280.3400005,.
409000438620',2018-07-20,CR819712494589/RMCPL18519/1,,2018-07-20,1200.0,,-530979480.3400005,.
409000438620',2018-07-20,CR819717566389/RMCPL24959/1,,2018-07-20,2300.0,,-530981780.3400005,.
409000438620',2018-07-20,CR819717572444/RMCPL14098/1,,2018-07-20,10000.0,,-530991780.3400005,.
409000438620',2018-07-20,CR819713509728/RMCPL19766/1,,2018-07-20,1000.0,,-530992780.3400005,.
409000438620',2018-07-20,CR819713509727/RMCPL11862/1,,2018-07-20,3500.0,,-530996280.3400005,.
409000438620',2018-07-20,CR819713509725/RMCPL22180/1,,2018-07-20,7100.0,,-531003380.3400005,.
409000438620',2018-07-20,CR819716547672/RMCPL19819/1,,2018-07-20,1000.0,,-531004380.3400005,.
409000438620',2018-07-20,CR819712486732/RMCPL24694/1,,2018-07-20,500.0,,-531004880.3400005,.
409000438620',2018-07-20,CR819711479665/RMCPL09588/1,,2018-07-20,5000.0,,-531009880.3400005,.
409000438620',2018-07-20,CR819712485939/RMCPL22963/1,,2018-07-20,2000.0,,-531011880.3400005,.
409000438620',2018-07-20,CR819712485906/RMCPL03659/1,,2018-07-20,2000.0,,-531013880.3400005,.
409000438620',2018-07-20,CR819718593662/RMCPL20869/1,,2018-07-20,5000.0,,-531018880.3400005,.
409000438620',2018-07-20,CR819711479657/RMCPL20773/1,,2018-07-20,1800.0,,-531020680.3400005,.
409000438620',2018-07-20,CR819713501886/RMCPL21354/1,,2018-07-20,1500.0,,-531022180.3400005,.
409000438620',2018-07-20,CR819711479670/RMCPL17957/1,,2018-07-20,3000.0,,-531025180.3400005,.
409000438620',2018-07-20,CR819213393965/RMCPL24568/1,,2018-07-20,2000.0,,-531027180.3400005,.
409000438620',2018-07-20,CR819213393949/RMCPL16075/1,,2018-07-20,2000.0,,-531029180.3400005,.
409000438620',2018-07-20,CR819216423774/RMCPL22522/1,,2018-07-20,5000.0,,-531034180.3400005,.
409000438620',2018-07-20,CR819212371097/RMCPL11784/1,,2018-07-20,1000.0,,-531035180.3400005,.
409000438620',2018-07-20,CR819216423768/RMCPL17349/1,,2018-07-20,500.0,,-531035680.3400005,.
409000438620',2018-07-20,CR819209325209/RMCPL15464/1,,2018-07-20,4000.0,,-531039680.3400005,.
409000438620',2018-07-20,CR819212371071/RMCPL16457/1,,2018-07-20,2500.0,,-531042180.3400005,.
409000438620',2018-07-20,MAW/502964XXXXXX0044/Karu,,2018-07-20,,1600.0,-531040580.3400005,.
409000438620',2018-07-20,MAW/502964XXXXXX0077/Karu,,2018-07-20,,1600.0,-531038980.3400005,.
409000438620',2018-07-20,MAW/502964XXXXXX8760/Karu,,2018-07-20,,1600.0,-531037380.3400005,.
409000438620',2018-07-20,MAW/502964XXXXXX3988/Karu,,2018-07-20,,1600.0,-531035780.3400005,.
409000438620',2018-07-20,TRF TO  Indiaforensic SERVICES I,,2018-07-20,4000000.0,,-535035780.3400005,.
409000438620',2018-07-20,TRF TO  Indiaforensic SERVICES I,,2018-07-20,3000000.0,,-538035780.3400005,.
409000438620',2018-07-20,TRF TO  Indiaforensic SERVICES I,,2018-07-20,3000000.0,,-541035780.3400005,.
409000438620',2018-07-20,TRF TO  Indiaforensic SERVICES I,,2018-07-20,3000000.0,,-544035780.3400005,.
409000438620',2018-07-20,TRF TO  Indiaforensic SERVICES I,,2018-07-20,2000000.0,,-546035780.3400005,.
409000438620',2018-07-20,MAW/502964XXXXXX7502/Akol,,2018-07-20,,500.0,-546035280.3400005,.
409000438620',2018-07-20,AEPS INCOME DT 19-07-2018,,2018-07-20,,40441.88,-545994838.4600005,.
409000438620',2018-07-20,AEPS GST INC DT 19-07-201,,2018-07-20,,8088.38,-545986750.0800005,.
409000438620',2018-07-20,AEPS ACQ CR ADJ FEES 1907,,2018-07-20,589.41,,-545987339.4900005,.
409000438620',2018-07-21,MAW/502964XXXXXX8138/Karu,,2018-07-21,,1700.0,-545985639.4900005,.
409000438620',2018-07-21,MAW/502964XXXXXX6797/Karu,,2018-07-21,,1600.0,-545984039.4900005,.
409000438620',2018-07-21,MAW/502964XXXXXX2325/Karu,,2018-07-21,,1600.0,-545982439.4900005,.
409000438620',2018-07-21,MAW/502964XXXXXX2473/Karu,,2018-07-21,,1600.0,-545980839.4900005,.
409000438620',2018-07-21,MAW/502964XXXXXX2355/Karu,,2018-07-21,,1700.0,-545979139.4900005,.
409000438620',2018-07-21,MAW/502964XXXXXX6461/Karu,,2018-07-21,,1500.0,-545977639.4900005,.
409000438620',2018-07-21,MAW/502964XXXXXX8776/Karu,,2018-07-21,,1700.0,-545975939.4900005,.
409000438620',2018-07-21,Indiaforensic AEPS NPCI WDL SET,,2018-07-21,,16702700.0,-529273239.4900005,.
409000438620',2018-07-21,MAW/502964XXXXXX4085/Karu,,2018-07-21,,1700.0,-529271539.4900005,.
409000438620',2018-07-21,MAW/502964XXXXXX4097/Karu,,2018-07-21,,1600.0,-529269939.4900005,.
409000438620',2018-07-21,MAW/502964XXXXXX0815/Akol,,2018-07-21,,900.0,-529269039.4900005,.
409000438620',2018-07-21,TRF TO  Indiaforensic SERVICES I,,2018-07-21,2000000.0,,-531269039.4900005,.
409000438620',2018-07-21,TRF TO  Indiaforensic SERVICES I,,2018-07-21,15000000.0,,-546269039.4900005,.
409000438620',2018-07-21,AEPS INCOME DT 20-07-2018,,2018-07-21,,44006.5,-546225032.9900005,.
409000438620',2018-07-21,AEPS GST INC DT 20-07-201,,2018-07-21,,8801.3,-546216231.6900005,.
409000438620',2018-07-23,MAW/502964XXXXXX1956/Karu,,2018-07-23,,1700.0,-546214531.6900005,.
409000438620',2018-07-23,MAW/502964XXXXXX7940/Karu,,2018-07-23,,1600.0,-546212931.6900005,.
409000438620',2018-07-23,MAW/502964XXXXXX5620/Karu,,2018-07-23,,1000.0,-546211931.6900005,.
409000438620',2018-07-23,MAW/502964XXXXXX4185/Karu,,2018-07-23,,1800.0,-546210131.6900005,.
409000438620',2018-07-23,Indiaforensic AEPS NPCI WDL SET,,2018-07-23,,12744100.0,-533466031.69000053,.
409000438620',2018-07-23,Indiaforensic AEPS NPCI WDL SET,,2018-07-23,,9462300.0,-524003731.69000053,.
409000438620',2018-07-23,MAW/502964XXXXXX7382/Karu,,2018-07-23,,1700.0,-524002031.69000053,.
409000438620',2018-07-23,MAW/502964XXXXXX4793/Karu,,2018-07-23,,1600.0,-524000431.69000053,.
409000438620',2018-07-23,MAW/502964XXXXXX3574/Karu,,2018-07-23,,1700.0,-523998731.69000053,.
409000438620',2018-07-23,TRF TO  Indiaforensic SERVICES I,,2018-07-23,15000000.0,,-538998731.6900005,.
409000438620',2018-07-23,TRF TO  Indiaforensic SERVICES I,,2018-07-23,7300000.0,,-546298731.6900005,.
409000438620',2018-07-23,MAW/502964XXXXXX4620/Karu,,2018-07-23,,1600.0,-546297131.6900005,.
409000438620',2018-07-23,AEPS INCOME DT 21-07-2018,,2018-07-23,,33659.8,-546263471.8900006,.
409000438620',2018-07-23,AEPS GST INC DT 21-07-201,,2018-07-23,,6731.96,-546256739.9300005,.
409000438620',2018-07-23,AEPS INCOME DT 22-07-2018,,2018-07-23,,25988.38,-546230751.5500005,.
409000438620',2018-07-23,AEPS GST INC DT 22-07-201,,2018-07-23,,5197.68,-546225553.8700006,.
409000438620',2018-07-23,AEPS ACQUIRING ADJ FEES 2,,2018-07-23,10.03,,-546225563.9000006,.
409000438620',2018-07-23,AEPS ACQ REP ADJ FEES 210,,2018-07-23,,38.35,-546225525.5500005,.
409000438620',2018-07-24,MAW/502964XXXXXX1253/Cudd,,2018-07-24,,1000.0,-546224525.5500005,.
409000438620',2018-07-24,MAW/502964XXXXXX7755/Karu,,2018-07-24,,1400.0,-546223125.5500005,.
409000438620',2018-07-24,MAW/502964XXXXXX8707/Karu,,2018-07-24,,1600.0,-546221525.5500005,.
409000438620',2018-07-24,MAW/502964XXXXXX0398/Karu,,2018-07-24,,1600.0,-546219925.5500005,.
409000438620',2018-07-24,Indiaforensic AEPS NPCI WDL SET,,2018-07-24,,16437300.0,-529782625.55000055,.
409000438620',2018-07-24,CB819415898854/RMCPL24383/1,,2018-07-24,2900.0,,-529785525.55000055,.
409000438620',2018-07-24,CB819211357541/RMCPL24646/1,,2018-07-24,6500.0,,-529792025.55000055,.
409000438620',2018-07-24,CB819311603799/RMCPL16763/1,,2018-07-24,2000.0,,-529794025.55000055,.
409000438620',2018-07-24,CB819418937654/RMCPL03043/1,,2018-07-24,10000.0,,-529804025.55000055,.
409000438620',2018-07-24,MAW/502964XXXXXX4740/Karu,,2018-07-24,,1600.0,-529802425.55000055,.
409000438620',2018-07-24,TRF TO  Indiaforensic SERVICES I,,2018-07-24,15000000.0,,-544802425.5500005,.
409000438620',2018-07-24,TRF TO  Indiaforensic SERVICES I,,2018-07-24,1000000.0,,-545802425.5500005,.
409000438620',2018-07-24,TRF TO  Indiaforensic SERVICES I,,2018-07-24,500000.0,,-546302425.5500005,.
409000438620',2018-07-24,MAW/502964XXXXXX6016/Akol,,2018-07-24,,1200.0,-546301225.5500005,.
409000438620',2018-07-24,AEPS INCOME DT 23-07-2018,,2018-07-24,,42863.77,-546258361.7800006,.
409000438620',2018-07-24,AEPS GST INC DT 23-07-201,,2018-07-24,,8572.75,-546249789.0300006,.
409000438620',2018-07-25,MAW/502964XXXXXX8905/Karu,,2018-07-25,,1700.0,-546248089.0300006,.
409000438620',2018-07-25,MAW/502964XXXXXX8560/Karu,,2018-07-25,,1700.0,-546246389.0300006,.
409000438620',2018-07-25,MAW/502964XXXXXX0532/Karu,,2018-07-25,,1900.0,-546244489.0300006,.
409000438620',2018-07-25,MAW/502964XXXXXX4234/Karu,,2018-07-25,,1800.0,-546242689.0300006,.
409000438620',2018-07-25,Indiaforensic AEPS NPCI WDL SET,,2018-07-25,,16227500.0,-530015189.03000057,.
409000438620',2018-07-25,CB819814785772/RMCPL12343/1,,2018-07-25,1000.0,,-530016189.03000057,.
409000438620',2018-07-25,CB819819868826/RMCPL12522/1,,2018-07-25,700.0,,-530016889.03000057,.
409000438620',2018-07-25,TRF TO  Indiaforensic SERVICES I,,2018-07-25,15000000.0,,-545016889.0300006,.
409000438620',2018-07-25,MAW/502964XXXXXX1898/NAGA,,2018-07-25,,300.0,-545016589.0300006,.
409000438620',2018-07-25,MAW/502964XXXXXX9772/Cudd,,2018-07-25,,2500.0,-545014089.0300006,.
409000438620',2018-07-25,TRF TO  Indiaforensic SERVICES I,,2018-07-25,1300000.0,,-546314089.0300006,.
409000438620',2018-07-25,AEPS INCOME DT 24-07-2018,,2018-07-25,,41884.37,-546272204.6600006,.
409000438620',2018-07-25,AEPS GST INC DT 24-07-201,,2018-07-25,,8376.87,-546263827.7900006,.
409000438620',2018-07-25,AEPS ACQUIRING ADJ FEES 2,,2018-07-25,64.9,,-546263892.6900005,.
409000438620',2018-07-26,MAW/502964XXXXXX6771/Karu,,2018-07-26,,1600.0,-546262292.6900005,.
409000438620',2018-07-26,MAW/502964XXXXXX0886/Karu,,2018-07-26,,1600.0,-546260692.6900005,.
409000438620',2018-07-26,MAW/502964XXXXXX7333/Karu,,2018-07-26,,1600.0,-546259092.6900005,.
409000438620',2018-07-26,MAW/502964XXXXXX1420/Karu,,2018-07-26,,1600.0,-546257492.6900005,.
409000438620',2018-07-26,MAW/502964XXXXXX2221/Karu,,2018-07-26,,1600.0,-546255892.6900005,.
409000438620',2018-07-26,MAW/502964XXXXXX3626/Karu,,2018-07-26,,1600.0,-546254292.6900005,.
409000438620',2018-07-26,MAW/502964XXXXXX0404/Karu,,2018-07-26,,1600.0,-546252692.6900005,.
409000438620',2018-07-26,MAW/502964XXXXXX7114/Karu,,2018-07-26,,1600.0,-546251092.6900005,.
409000438620',2018-07-26,MAW/502964XXXXXX3741/Karu,,2018-07-26,,1500.0,-546249592.6900005,.
409000438620',2018-07-26,MAW/502964XXXXXX0931/Karu,,2018-07-26,,1500.0,-546248092.6900005,.
409000438620',2018-07-26,MAW/502964XXXXXX5678/Karu,,2018-07-26,,1600.0,-546246492.6900005,.
409000438620',2018-07-26,MAW/502964XXXXXX5780/Karu,,2018-07-26,,1500.0,-546244992.6900005,.
409000438620',2018-07-26,MAW/502964XXXXXX1669/Karu,,2018-07-26,,1500.0,-546243492.6900005,.
409000438620',2018-07-26,MAW/502964XXXXXX0226/Karu,,2018-07-26,,1600.0,-546241892.6900005,.
409000438620',2018-07-26,MAW/502964XXXXXX5619/Karu,,2018-07-26,,1600.0,-546240292.6900005,.
409000438620',2018-07-26,MAW/502964XXXXXX1544/Karu,,2018-07-26,,1500.0,-546238792.6900005,.
409000438620',2018-07-26,MAW/502964XXXXXX8345/Karu,,2018-07-26,,1600.0,-546237192.6900005,.
409000438620',2018-07-26,MAW/502964XXXXXX3641/Karu,,2018-07-26,,1500.0,-546235692.6900005,.
409000438620',2018-07-26,MAW/502964XXXXXX2539/Karu,,2018-07-26,,1600.0,-546234092.6900005,.
409000438620',2018-07-26,Indiaforensic AEPS NPCI WDL SET,,2018-07-26,,14891800.0,-531342292.69000053,.
409000438620',2018-07-26,MAW/502964XXXXXX3058/Karu,,2018-07-26,,1600.0,-531340692.69000053,.
409000438620',2018-07-26,MAW/502964XXXXXX1160/Karu,,2018-07-26,,1700.0,-531338992.69000053,.
409000438620',2018-07-26,MAW/502964XXXXXX1728/Karu,,2018-07-26,,1500.0,-531337492.69000053,.
409000438620',2018-07-26,MAW/502964XXXXXX5815/Karu,,2018-07-26,,1600.0,-531335892.69000053,.
409000438620',2018-07-26,TRF TO  Indiaforensic SERVICES I,,2018-07-26,14900000.0,,-546235892.6900005,.
409000438620',2018-07-26,MAW/502964XXXXXX3649/Karu,,2018-07-26,,1600.0,-546234292.6900005,.
409000438620',2018-07-26,MAW/502964XXXXXX2994/Pand,,2018-07-26,,2800.0,-546231492.6900005,.
409000438620',2018-07-26,MAW/502964XXXXXX6318/Pand,,2018-07-26,,2000.0,-546229492.6900005,.
409000438620',2018-07-26,AEPS INCOME DT 25-07-2018,,2018-07-26,,37667.2,-546191825.4900005,.
409000438620',2018-07-26,AEPS GST INC DT 25-07-201,,2018-07-26,,7533.44,-546184292.0500004,.
409000438620',2018-07-26,AEPS ACQUIRING ADJ FEES 2,,2018-07-26,5.9,,-546184297.9500004,.
409000438620',2018-07-26,CB817812820575/RMCPL24646/2,,2018-07-26,5000.0,,-546189297.9500004,.
409000438620',2018-07-26,CB820109485569/RMCPL17015/2,,2018-07-26,2000.0,,-546191297.9500004,.
409000438620',2018-07-26,CB819910976249/RMCPL21990/1,,2018-07-26,500.0,,-546191797.9500004,.
409000438620',2018-07-26,CB819918110598/RMCPL18940/1,,2018-07-26,500.0,,-546192297.9500004,.
409000438620',2018-07-27,MAW/502964XXXXXX4158/Karu,,2018-07-27,,1600.0,-546190697.9500004,.
409000438620',2018-07-27,MAW/502964XXXXXX8723/Karu,,2018-07-27,,1700.0,-546188997.9500004,.
409000438620',2018-07-27,MAW/502964XXXXXX3402/Pand,,2018-07-27,,500.0,-546188497.9500004,.
409000438620',2018-07-27,Indiaforensic AEPS NPCI WDL SET,,2018-07-27,,14254200.0,-531934297.9500004,.
409000438620',2018-07-27,MAW/502964XXXXXX2937/Karu,,2018-07-27,,1900.0,-531932397.9500004,.
409000438620',2018-07-27,CR819917092607/RMCPL15334/1,,2018-07-27,5000.0,,-531937397.9500004,.
409000438620',2018-07-27,CR819912021310/RMCPL18408/1,,2018-07-27,10000.0,,-531947397.9500004,.
409000438620',2018-07-27,CR819912023938/RMCPL11949/1,,2018-07-27,600.0,,-531947997.9500004,.
409000438620',2018-07-27,CR819917098353/RMCPL22994/1,,2018-07-27,4000.0,,-531951997.9500004,.
409000438620',2018-07-27,CR819911007740/RMCPL00154/1,,2018-07-27,2000.0,,-531953997.9500004,.
409000438620',2018-07-27,CR819912021309/RMCPL11764/1,,2018-07-27,1000.0,,-531954997.9500004,.
409000438620',2018-07-27,CR819912021212/RMCPL24338/1,,2018-07-27,10000.0,,-531964997.9500004,.
409000438620',2018-07-27,CR819911000456/RMCPL22523/1,,2018-07-27,2500.0,,-531967497.9500004,.
409000438620',2018-07-27,CR819916085930/RMCPL23181/1,,2018-07-27,500.0,,-531967997.9500004,.
409000438620',2018-07-27,CR819912027846/RMCPL12052/1,,2018-07-27,500.0,,-531968497.9500004,.
409000438620',2018-07-27,CR819919141332/RMCPL26914/1,,2018-07-27,1000.0,,-531969497.9500004,.
409000438620',2018-07-27,CR819809690007/RMCPL25253/1,,2018-07-27,2000.0,,-531971497.9500004,.
409000438620',2018-07-27,CR820011264548/RMCPL25245/1,,2018-07-27,500.0,,-531971997.9500004,.
409000438620',2018-07-27,CR819917104584/RMCPL24821/1,,2018-07-27,3000.0,,-531974997.9500004,.
409000438620',2018-07-27,CR820018376246/RMCPL24794/1,,2018-07-27,3000.0,,-531977997.9500004,.
409000438620',2018-07-27,CR819909957303/RMCPL24589/1,,2018-07-27,2000.0,,-531979997.9500004,.
409000438620',2018-07-27,CR819909957301/RMCPL24302/1,,2018-07-27,1400.0,,-531981397.9500004,.
409000438620',2018-07-27,CR819813764444/RMCPL23898/1,,2018-07-27,2000.0,,-531983397.9500004,.
409000438620',2018-07-27,CR819819868804/RMCPL23305/1,,2018-07-27,1000.0,,-531984397.9500004,.
409000438620',2018-07-27,CR820011264539/RMCPL22461/1,,2018-07-27,1000.0,,-531985397.9500004,.
409000438620',2018-07-27,CR819817827428/RMCPL22427/1,,2018-07-27,10000.0,,-531995397.9500004,.
409000438620',2018-07-27,CR820112542092/RMCPL21598/2,,2018-07-27,1000.0,,-531996397.9500004,.
409000438620',2018-07-27,CR819810712087/RMCPL20826/1,,2018-07-27,5000.0,,-532001397.9500004,.
409000438620',2018-07-27,CR820010249908/RMCPL20736/1,,2018-07-27,1700.0,,-532003097.9500004,.
409000438620',2018-07-27,CR819918110644/RMCPL19898/1,,2018-07-27,2000.0,,-532005097.9500004,.
409000438620',2018-07-27,CR819918116966/RMCPL19748/1,,2018-07-27,1000.0,,-532006097.9500004,.
409000438620',2018-07-27,CR819817827434/RMCPL19235/1,,2018-07-27,800.0,,-532006897.9500004,.
409000438620',2018-07-27,CR819816820592/RMCPL18651/1,,2018-07-27,2100.0,,-532008997.9500004,.
409000438620',2018-07-27,CR820110511833/RMCPL17906/2,,2018-07-27,2000.0,,-532010997.9500004,.
409000438620',2018-07-27,CR819811738541/RMCPL17454/1,,2018-07-27,10000.0,,-532020997.9500004,.
409000438620',2018-07-27,CR820017355598/RMCPL16996/1,,2018-07-27,500.0,,-532021497.9500004,.
409000438620',2018-07-27,CR819817835126/RMCPL16659/1,,2018-07-27,1500.0,,-532022997.9500004,.
409000438620',2018-07-27,CR819813764458/RMCPL16314/1,,2018-07-27,5000.0,,-532027997.9500004,.
409000438620',2018-07-27,CR819816820588/RMCPL15326/1,,2018-07-27,2000.0,,-532029997.9500004,.
409000438620',2018-07-27,CR819818851513/RMCPL15233/1,,2018-07-27,2500.0,,-532032497.9500004,.
409000438620',2018-07-27,CR819816820600/RMCPL14354/1,,2018-07-27,4000.0,,-532036497.9500004,.
409000438620',2018-07-27,CR819813771396/RMCPL13026/1,,2018-07-27,1000.0,,-532037497.9500004,.
409000438620',2018-07-27,CR819810712096/RMCPL10339/1,,2018-07-27,1000.0,,-532038497.9500004,.
409000438620',2018-07-27,CR820018376224/RMCPL09982/1,,2018-07-27,3000.0,,-532041497.9500004,.
409000438620',2018-07-27,CR819813764441/RMCPL09615/1,,2018-07-27,1300.0,,-532042797.9500004,.
409000438620',2018-07-27,CR820112550800/RMCPL12509/2,,2018-07-27,10000.0,,-532052797.9500004,.
409000438620',2018-07-27,CR820117615481/RMCPL24066/2,,2018-07-27,500.0,,-532053297.9500004,.
409000438620',2018-07-27,CR820112550803/RMCPL18940/2,,2018-07-27,500.0,,-532053797.9500004,.
409000438620',2018-07-27,CR820017362351/RMCPL14820/1,,2018-07-27,2000.0,,-532055797.9500004,.
409000438620',2018-07-27,CR820010249848/RMCPL15451/1,,2018-07-27,3000.0,,-532058797.9500004,.
409000438620',2018-07-27,CR819918110622/RMCPL23450/1,,2018-07-27,2500.0,,-532061297.9500004,.
409000438620',2018-07-27,CR819917104554/RMCPL26845/1,,2018-07-27,2000.0,,-532063297.9500004,.
409000438620',2018-07-27,CR819919141306/RMCPL26454/1,,2018-07-27,900.0,,-532064197.9500004,.
409000438620',2018-07-27,CR819817835108/RMCPL20628/1,,2018-07-27,2000.0,,-532066197.9500004,.
409000438620',2018-07-27,CR819818843011/RMCPL15869/1,,2018-07-27,500.0,,-532066697.9500004,.
409000438620',2018-07-27,CR819818851500/RMCPL23652/1,,2018-07-27,1000.0,,-532067697.9500004,.
409000438620',2018-07-27,CR820511552400/RMCPL03657/2,,2018-07-27,10000.0,,-532077697.9500004,.
409000438620',2018-07-27,CR820515615254/RMCPL18236/2,,2018-07-27,1000.0,,-532078697.9500004,.
409000438620',2018-07-27,CR820511552417/RMCPL22050/2,,2018-07-27,2000.0,,-532080697.9500004,.
409000438620',2018-07-27,CR820513589977/RMCPL17454/2,,2018-07-27,1000.0,,-532081697.9500004,.
409000438620',2018-07-27,CR820514603451/RMCPL18042/2,,2018-07-27,2200.0,,-532083897.9500004,.
409000438620',2018-07-27,CR820519678429/RMCPL20122/2,,2018-07-27,1000.0,,-532084897.9500004,.
409000438620',2018-07-27,CR820514603463/RMCPL24698/2,,2018-07-27,2000.0,,-532086897.9500004,.
409000438620',2018-07-27,CR820510538018/RMCPL18600/2,,2018-07-27,1200.0,,-532088097.9500004,.
409000438620',2018-07-27,CR820511552405/RMCPL16043/2,,2018-07-27,3000.0,,-532091097.9500004,.
409000438620',2018-07-27,CR820511552402/RMCPL14954/2,,2018-07-27,500.0,,-532091597.9500004,.
409000438620',2018-07-27,CR820519678449/RMCPL20439/2,,2018-07-27,2600.0,,-532094197.9500004,.
409000438620',2018-07-27,CR820510538012/RMCPL22799/2,,2018-07-27,500.0,,-532094697.9500004,.
409000438620',2018-07-27,CR820510538031/RMCPL24011/2,,2018-07-27,1900.0,,-532096597.9500004,.
409000438620',2018-07-27,CR820513583031/RMCPL19037/2,,2018-07-27,1000.0,,-532097597.9500004,.
409000438620',2018-07-27,CR820513583032/RMCPL14558/2,,2018-07-27,2200.0,,-532099797.9500004,.
409000438620',2018-07-27,CR820511545636/RMCPL10976/2,,2018-07-27,5000.0,,-532104797.9500004,.
409000438620',2018-07-27,CR820512565280/RMCPL00045/2,,2018-07-27,3000.0,,-532107797.9500004,.
409000438620',2018-07-27,CR820514603448/RMCPL00225/2,,2018-07-27,3000.0,,-532110797.9500004,.
409000438620',2018-07-27,CR820515609674/RMCPL14558/2,,2018-07-27,5300.0,,-532116097.9500004,.
409000438620',2018-07-27,CR820514597013/RMCPL14954/2,,2018-07-27,1000.0,,-532117097.9500004,.
409000438620',2018-07-27,CR820416358819/RMCPL19298/2,,2018-07-27,1000.0,,-532118097.9500004,.
409000438620',2018-07-27,CR820417366291/RMCPL25532/2,,2018-07-27,1000.0,,-532119097.9500004,.
409000438620',2018-07-27,CR820414326397/RMCPL23013/2,,2018-07-27,1500.0,,-532120597.9500004,.
409000438620',2018-07-27,CR820415343604/RMCPL24439/2,,2018-07-27,2000.0,,-532122597.9500004,.
409000438620',2018-07-27,CR820410254654/RMCPL18138/2,,2018-07-27,10000.0,,-532132597.9500004,.
409000438620',2018-07-27,CR820411277633/RMCPL25977/2,,2018-07-27,1800.0,,-532134397.9500004,.
409000438620',2018-07-27,CR820418389325/RMCPL21832/2,,2018-07-27,1000.0,,-532135397.9500004,.
409000438620',2018-07-27,CR820415335095/RMCPL23870/2,,2018-07-27,500.0,,-532135897.9500004,.
409000438620',2018-07-27,CR820414317232/RMCPL10728/2,,2018-07-27,2000.0,,-532137897.9500004,.
409000438620',2018-07-27,CR820410246031/RMCPL16699/2,,2018-07-27,1000.0,,-532138897.9500004,.
409000438620',2018-07-27,CR820412291800/RMCPL18408/2,,2018-07-27,500.0,,-532139397.9500004,.
409000438620',2018-07-27,CR820412291853/RMCPL24777/2,,2018-07-27,5000.0,,-532144397.9500004,.
409000438620',2018-07-27,CR820311035130/RMCPL12838/2,,2018-07-27,10000.0,,-532154397.9500004,.
409000438620',2018-07-27,CR820315083550/RMCPL25969/2,,2018-07-27,500.0,,-532154897.9500004,.
409000438620',2018-07-27,CR820315083973/RMCPL25969/2,,2018-07-27,500.0,,-532155397.9500004,.
409000438620',2018-07-27,CR820211779160/RMCPL21524/2,,2018-07-27,1000.0,,-532156397.9500004,.
409000438620',2018-07-27,CR820213812201/RMCPL22318/2,,2018-07-27,2000.0,,-532158397.9500004,.
409000438620',2018-07-27,CR820111517597/RMCPL23096/2,,2018-07-27,5000.0,,-532163397.9500004,.
409000438620',2018-07-27,TRF TO  Indiaforensic SERVICES I,,2018-07-27,14100000.0,,-546263397.9500004,.
409000438620',2018-07-27,AEPS INCOME DT 26-07-2018,,2018-07-27,,36475.41,-546226922.5400004,.
409000438620',2018-07-27,AEPS GST INC DT 26-07-201,,2018-07-27,,7295.08,-546219627.4600004,.
409000438620',2018-07-27,AEPS ACQ CR ADJ FEES 2607,,2018-07-27,936.33,,-546220563.7900004,.
409000438620',2018-07-27,AEPS ACQ REP ADJ FEES 260,,2018-07-27,,29.5,-546220534.2900004,.
409000438620',2018-07-27,MICROATM SETTLEMNT DATED2,,2018-07-27,,100.0,-546220434.2900004,.
409000438620',2018-07-28,MAW/502964XXXXXX1287/Cudd,,2018-07-28,,1000.0,-546219434.2900004,.
409000438620',2018-07-28,MAW/502964XXXXXX7344/Karu,,2018-07-28,,1700.0,-546217734.2900004,.
409000438620',2018-07-28,MAW/502964XXXXXX6863/Akol,,2018-07-28,,7000.0,-546210734.2900004,.
409000438620',2018-07-28,MAW/502964XXXXXX6863/Akol,,2018-07-28,,400.0,-546210334.2900004,.
409000438620',2018-07-30,MAW/502964XXXXXX9275/Karu,,2018-07-30,,1500.0,-546208834.2900004,.
409000438620',2018-07-30,MAW/502964XXXXXX6805/Karu,,2018-07-30,,1800.0,-546207034.2900004,.
409000438620',2018-07-30,Indiaforensic AEPS NPCI WDL SET,,2018-07-30,,14060200.0,-532146834.29000044,.
409000438620',2018-07-30,Indiaforensic AEPS NPCI WDL SET,,2018-07-30,,12802800.0,-519344034.29000044,.
409000438620',2018-07-30,Indiaforensic AEPS NPCI WDL SET,,2018-07-30,,8355400.0,-510988634.29000044,.
409000438620',2018-07-30,TRF TO Indiaforensic SERVICES IN,,2018-07-30,15000000.0,,-525988634.29000044,.
409000438620',2018-07-30,TRF TO Indiaforensic SERVICES IN,,2018-07-30,15000000.0,,-540988634.2900004,.
409000438620',2018-07-30,TRF TO Indiaforensic SERVICES IN,,2018-07-30,5300000.0,,-546288634.2900004,.
409000438620',2018-07-30,MAW/502964XXXXXX1213/NAGA,,2018-07-30,,2300.0,-546286334.2900004,.
409000438620',2018-07-30,MAW/502964XXXXXX9796/NAGA,,2018-07-30,,1400.0,-546284934.2900004,.
409000438620',2018-07-30,AEPS INCOME DT 27-07-2018,,2018-07-30,,35695.19,-546249239.1000004,.
409000438620',2018-07-30,AEPS GST INC DT 27-07-201,,2018-07-30,,7139.04,-546242100.0600004,.
409000438620',2018-07-30,AEPS INCOME DT 28-07-2018,,2018-07-30,,32768.24,-546209331.8200004,.
409000438620',2018-07-30,AEPS GST INC DT 28-07-201,,2018-07-30,,6553.65,-546202778.1700004,.
409000438620',2018-07-30,AEPS INCOME DT 29-07-2018,,2018-07-30,,22221.41,-546180556.7600005,.
409000438620',2018-07-30,AEPS GST INC DT 29-07-201,,2018-07-30,,4444.28,-546176112.4800005,.
409000438620',2018-07-30,AEPS ACQ REP ADJ FEES 270,,2018-07-30,,5.9,-546176106.5800005,.
409000438620',2018-07-30,MAW/502964XXXXXX1592/Cudd,,2018-07-30,,1000.0,-546175106.5800005,.
409000438620',2018-07-31,MAW/502964XXXXXX0237/Karu,,2018-07-31,,1500.0,-546173606.5800005,.
409000438620',2018-07-31,MAW/502964XXXXXX0455/Karu,,2018-07-31,,1900.0,-546171706.5800005,.
409000438620',2018-07-31,MAW/502964XXXXXX8633/Karu,,2018-07-31,,1900.0,-546169806.5800005,.
409000438620',2018-07-31,Indiaforensic AEPS NPCI WDL SET,,2018-07-31,,13265300.0,-532904506.5800005,.
409000438620',2018-07-31,CR820710035611/RMCPL15981/2,,2018-07-31,1000.0,,-532905506.5800005,.
409000438620',2018-07-31,CR820712064599/RMCPL23887/2,,2018-07-31,2500.0,,-532908006.5800005,.
409000438620',2018-07-31,CR820712064604/RMCPL14558/2,,2018-07-31,1400.0,,-532909406.5800005,.
409000438620',2018-07-31,CR820616891506/RMCPL22488/2,,2018-07-31,2000.0,,-532911406.5800005,.
409000438620',2018-07-31,CR820617897946/RMCPL20680/2,,2018-07-31,600.0,,-532912006.5800005,.
409000438620',2018-07-31,CR820614865780/RMCPL15535/2,,2018-07-31,2000.0,,-532914006.5800005,.
409000438620',2018-07-31,CR820610787875/RMCPL20516/2,,2018-07-31,10000.0,,-532924006.5800005,.
409000438620',2018-07-31,CR820610787880/RMCPL25977/2,,2018-07-31,500.0,,-532924506.5800005,.
409000438620',2018-07-31,CR820611812837/RMCPL20827/2,,2018-07-31,7000.0,,-532931506.5800005,.
409000438620',2018-07-31,CR820618918372/RMCPL24928/2,,2018-07-31,500.0,,-532932006.5800005,.
409000438620',2018-07-31,CR820618918374/RMCPL26117/2,,2018-07-31,2000.0,,-532934006.5800005,.
409000438620',2018-07-31,MAW/502964XXXXXX2043/Karu,,2018-07-31,,2000.0,-532932006.5800005,.
409000438620',2018-07-31,MAW/502964XXXXXX4894/Karu,,2018-07-31,,1600.0,-532930406.5800005,.
409000438620',2018-07-31,TRF TO  Indiaforensic SERVICES I,,2018-07-31,13300000.0,,-546230406.5800005,.
409000438620',2018-07-31,AEPS INCOME DT 30-07-2018,,2018-07-31,,34013.25,-546196393.3300005,.
409000438620',2018-07-31,AEPS GST INC DT 30-07-201,,2018-07-31,,6802.65,-546189590.6800005,.
409000438620',2018-07-31,AEPS ACQUIRING ADJ FEES 3,,2018-07-31,38.35,,-546189629.0300006,.
409000438620',2018-07-31,AEPS ACQ CR ADJ FEES 3007,,2018-07-31,109.14,,-546189738.1700006,.
409000438620',2018-07-31,NPCI/PUNBR520180723127283,,2018-07-31,,24000000.0,-522189738.17000055,.
409000438620',2018-07-31,FDRL NEFT/RTGS CHARGS FORF,,2018-07-31,9455.0,,-522199193.17000055,.
409000438620',2018-07-31,MONTHLY SER GST FEB 18,,2018-07-31,1003.0,,-522200196.17000055,.
409000438620',2018-07-31,FDRL NEFT/RTGS CHARGS FOR,,2018-07-31,41113.16,,-522241309.3300006,.
409000438620',2018-07-31,MONTHLY SER GST MAR 18,,2018-07-31,9024.84,,-522250334.17000055,.
409000438620',2018-07-31,FDRL NEFT/RTGS CHARGS FOR,,2018-07-31,59988.74,,-522310322.91000056,.
409000438620',2018-07-31,MONTHLY SER GST APR 18,,2018-07-31,13168.26,,-522323491.17000055,.
409000438620',2018-07-31,FDRL NEFT/RTGS CHARGS FOR,,2018-07-31,62359.36,,-522385850.53000057,.
409000438620',2018-07-31,MONTHLY SER GST MAY 18,,2018-07-31,13688.64,,-522399539.17000055,.
409000438620',2018-07-31,NETWORK CHARGES/VISA/DEC,,2018-07-31,228609.95,,-522628149.12000054,.
409000438620',2018-07-31,NETWORK CHARGES/VISA/JAN,,2018-07-31,534789.13,,-523162938.25000054,.
409000438620',2018-07-31,NETWORK CHARGES/VISA/FEB,,2018-07-31,91075.13,,-523254013.38000053,.
409000438620',2018-07-31,NETWORK CHARGES/VISA/MAR,,2018-07-31,169259.98,,-523423273.36000055,.
409000438620',2018-07-31,NETWORK CHARGES/VISA/APR,,2018-07-31,215249.25,,-523638522.61000055,.
409000438620',2018-07-31,NETWORK CHARGES/VISA/MAY,,2018-07-31,150474.1,,-523788996.7100006,.
409000438620',2018-07-31,NETWORK CHARGES/VISA/JUN,,2018-07-31,386791.22,,-524175787.9300006,.
409000438620',2018-07-31,NETWORK CHARGES/VISA/JUL,,2018-07-31,182585.03,,-524358372.9600006,.
409000438620',2018-07-31,NETWORK CHARGES/VISA/AUG,,2018-07-31,109435.25,,-524467808.2100006,.
409000438620',2018-07-31,NETWORK CHARGES/VISA/SEPT,,2018-07-31,202168.56,,-524669976.7700006,.
409000438620',2018-07-31,NETWORK CHARGES/VISA/OCT,,2018-07-31,232241.02,,-524902217.79000056,.
409000438620',2018-07-31,NETWORK CHARGES/VISA/NOV,,2018-07-31,225454.73,,-525127672.5200006,.
409000438620',2018-07-31,NETWORK CHARGES/VISA/DEC,,2018-07-31,130671.6,,-525258344.1200006,.
409000438620',2018-07-31,NETWORK CHARGES/VISA/JAN,,2018-07-31,216098.66,,-525474442.7800006,.
409000438620',2018-07-31,NETWORK CHARGES/VISA/FEB,,2018-07-31,95336.98,,-525569779.76000065,.
409000438620',2018-07-31,NETWORK CHARGES/VISA/MAR,,2018-07-31,93875.5,,-525663655.26000065,.
409000438620',2018-07-31,NETWORK CHARGES/VISA/APR,,2018-07-31,134727.13,,-525798382.39000064,.
409000438620',2018-07-31,NETWORK CHARGES/VISA/MAY,,2018-07-31,32935.0,,-525831317.39000064,.
409000438620',2018-07-31,NETWORK CHARGES/VISA/JUNE,,2018-07-31,79170.36,,-525910487.75000066,.
409000438620',2018-07-31,NETWORK CHARGES/MASTER/AU,,2018-07-31,509579.88,,-526420067.63000065,.
409000438620',2018-07-31,NETWORK CHARGES/MASTER/SE,,2018-07-31,225418.14,,-526645485.77000064,.
409000438620',2018-07-31,NETWORK CHARGES/MASTER/OC,,2018-07-31,90780.8,,-526736266.57000065,.
409000438620',2018-07-31,NETWORK CHARGES/MASTER/NO,,2018-07-31,399930.0,,-527136196.57000065,.
409000438620',2018-07-31,NETWORK CHARGES/MASTER/DE,,2018-07-31,484640.98,,-527620837.55000067,.
409000438620',2018-07-31,NETWORK CHARGES/MASTER/JA,,2018-07-31,70058.55,,-527690896.1000007,.
409000438620',2018-07-31,NETWORK CHARGES/MASTER/FE,,2018-07-31,88288.78,,-527779184.88000065,.
409000438620',2018-07-31,NETWORK CHARGES/MASTER/MA,,2018-07-31,85779.25,,-527864964.13000065,.
409000438620',2018-07-31,NETWORK CHARGES/MASTER/AP,,2018-07-31,184449.4,,-528049413.5300006,.
409000438620',2018-07-31,NETWORK CHARGES/MASTER/MA,,2018-07-31,252989.09,,-528302402.6200006,.
409000438620',2018-07-31,NETWORK CHARGES/MASTER/JU,,2018-07-31,229329.0,,-528531731.6200006,.
409000438620',2018-08-01,MAW/502964XXXXXX2164/Karu,,2018-08-01,,1600.0,-528530131.6200006,.
409000438620',2018-08-01,MAW/502964XXXXXX0146/Karu,,2018-08-01,,1600.0,-528528531.6200006,.
409000438620',2018-08-01,MAW/502964XXXXXX7791/Karu,,2018-08-01,,1700.0,-528526831.6200006,.
409000438620',2018-08-01,Indiaforensic AEPS NPCI WDL SET,,2018-08-01,,14351900.0,-514174931.6200006,.
409000438620',2018-08-01,CR820912526016/RMCPL14643/2,,2018-08-01,500.0,,-514175431.6200006,.
409000438620',2018-08-01,CR820916589443/RMCPL19766/2,,2018-08-01,500.0,,-514175931.6200006,.
409000438620',2018-08-01,CR820811281905/RMCPL19298/2,,2018-08-01,500.0,,-514176431.6200006,.
409000438620',2018-08-01,CR820812296862/RMCPL14136/2,,2018-08-01,1500.0,,-514177931.6200006,.
409000438620',2018-08-01,CR820813311195/RMCPL15227/2,,2018-08-01,1700.0,,-514179631.6200006,.
409000438620',2018-08-01,CR820813303579/RMCPL18216/2,,2018-08-01,1500.0,,-514181131.6200006,.
409000438620',2018-08-01,CR820817363716/RMCPL16581/2,,2018-08-01,2000.0,,-514183131.6200006,.
409000438620',2018-08-01,CR820819397960/RMCPL25168/2,,2018-08-01,1000.0,,-514184131.6200006,.
409000438620',2018-08-01,CR820819397969/RMCPL13148/2,,2018-08-01,5000.0,,-514189131.6200006,.
409000438620',2018-08-01,CR820812289471/RMCPL14558/2,,2018-08-01,1200.0,,-514190331.6200006,.
409000438620',2018-08-01,CR820812289465/RMCPL18108/2,,2018-08-01,1000.0,,-514191331.6200006,.
409000438620',2018-08-01,CR820814318486/RMCPL20463/2,,2018-08-01,1000.0,,-514192331.6200006,.
409000438620',2018-08-01,CR820812296841/RMCPL11798/2,,2018-08-01,5000.0,,-514197331.6200006,.
409000438620',2018-08-01,CR820818371466/RMCPL22655/2,,2018-08-01,2000.0,,-514199331.6200006,.
409000438620',2018-08-01,MAW/502964XXXXXX6606/Karu,,2018-08-01,,1700.0,-514197631.6200006,.
409000438620',2018-08-01,MAW/502964XXXXXX6242/Pand,,2018-08-01,,900.0,-514196731.6200006,.
409000438620',2018-08-01,TRF TO  Indiaforensic SERVICES I,,2018-08-01,4000000.0,,-518196731.6200006,.
409000438620',2018-08-01,TRF TO  Indiaforensic SERVICES I,,2018-08-01,10000000.0,,-528196731.6200006,.
409000438620',2018-08-01,AEPS INCOME DT 31-07-2018,,2018-08-01,,37184.6,-528159547.0200006,.
409000438620',2018-08-01,AEPS GST INC DT 31-07-201,,2018-08-01,,7436.92,-528152110.10000056,.
409000438620',2018-08-01,AEPS ACQ CR ADJ FEES 3107,,2018-08-01,120.31,,-528152230.41000056,.
409000438620',2018-08-01,AEPS ACQ REP ADJ FEES 310,,2018-08-01,,38.35,-528152192.06000054,.
409000438620',2018-08-01,NFS MICRO ATM SETT DT 310,,2018-08-01,,400.0,-528151792.06000054,.
409000438620',2018-08-01,NFS MICRO ATM SETTLEMENT,,2018-08-01,,3000.0,-528148792.06000054,.
409000438620',2018-08-01,TRF TO  Indiaforensic SERVICES I,,2018-08-01,500000.0,,-528648792.06000054,.
409000438620',2018-08-02,MAW/502964XXXXXX0812/Karu,,2018-08-02,,1700.0,-528647092.06000054,.
409000438620',2018-08-02,MAW/502964XXXXXX0628/Karu,,2018-08-02,,1700.0,-528645392.06000054,.
409000438620',2018-08-02,MAW/502964XXXXXX4940/Karu,,2018-08-02,,1700.0,-528643692.06000054,.
409000438620',2018-08-02,MAW/502964XXXXXX6685/Karu,,2018-08-02,,1700.0,-528641992.06000054,.
409000438620',2018-08-02,Indiaforensic AEPS NPCI WDL SET,,2018-08-02,,14598400.0,-514043592.06000054,.
409000438620',2018-08-02,MAW/502964XXXXXX1302/Karu,,2018-08-02,,1700.0,-514041892.06000054,.
409000438620',2018-08-02,MAW/502964XXXXXX4464/Karu,,2018-08-02,,1700.0,-514040192.06000054,.
409000438620',2018-08-02,MAW/502964XXXXXX6052/Karu,,2018-08-02,,2000.0,-514038192.06000054,.
409000438620',2018-08-02,MAW/502964XXXXXX2945/NAGA,,2018-08-02,,600.0,-514037592.06000054,.
409000438620',2018-08-02,MAW/502964XXXXXX5604/Karu,,2018-08-02,,1700.0,-514035892.06000054,.
409000438620',2018-08-02,MAW/502964XXXXXX4275/Karu,,2018-08-02,,600.0,-514035292.06000054,.
409000438620',2018-08-02,TRF TO  Indiaforensic SERVICES I,,2018-08-02,14600000.0,,-528635292.06000054,.
409000438620',2018-08-02,MAW/502964XXXXXX9739/NAGA,,2018-08-02,,1800.0,-528633492.06000054,.
409000438620',2018-08-02,AEPS INCOME DT 01-08-2018,,2018-08-02,,36988.0,-528596504.06000054,.
409000438620',2018-08-02,AEPS GST INC DT 01-08-201,,2018-08-02,,7397.6,-528589106.4600005,.
409000438620',2018-08-02,AEPS ACQUIRING ADJ FEES 0,,2018-08-02,23.6,,-528589130.06000054,.
409000438620',2018-08-03,Indiaforensic AEPS NPCI WDL SET,,2018-08-03,,15348300.0,-513240830.06000054,.
409000438620',2018-08-03,CR821112966534/RMCPL2486930,,2018-08-03,1000.0,,-513241830.06000054,.
409000438620',2018-08-03,CR821111945364/RMCPL2659230,,2018-08-03,1000.0,,-513242830.06000054,.
409000438620',2018-08-03,CR821111938241/RMCPL0016630,,2018-08-03,500.0,,-513243330.06000054,.
409000438620',2018-08-03,CR821117035979/RMCPL2459130,,2018-08-03,1000.0,,-513244330.06000054,.
409000438620',2018-08-03,CR821113987840/RMCPL1522730,,2018-08-03,2000.0,,-513246330.06000054,.
409000438620',2018-08-03,CR821115016119/RMCPL2289730,,2018-08-03,1000.0,,-513247330.06000054,.
409000438620',2018-08-03,CR821110930443/RMCPL2123530,,2018-08-03,1000.0,,-513248330.06000054,.
409000438620',2018-08-03,CR821116029326/RMCPL2062830,,2018-08-03,10000.0,,-513258330.06000054,.
409000438620',2018-08-03,CR821118050110/RMCPL1234330,,2018-08-03,1000.0,,-513259330.06000054,.
409000438620',2018-08-03,CR821214263054/RMCPL2359231,,2018-08-03,2000.0,,-513261330.06000054,.
409000438620',2018-08-03,CR821211212373/RMCPL1495431,,2018-08-03,500.0,,-513261830.06000054,.
409000438620',2018-08-03,CR821217324453/RMCPL2684531,,2018-08-03,1800.0,,-513263630.06000054,.
409000438620',2018-08-03,CR821212234463/RMCPL2286631,,2018-08-03,1000.0,,-513264630.06000054,.
409000438620',2018-08-03,CR821212234471/RMCPL1846631,,2018-08-03,4000.0,,-513268630.06000054,.
409000438620',2018-08-03,CR821219351166/RMCPL1550331,,2018-08-03,1000.0,,-513269630.06000054,.
409000438620',2018-08-03,CR821216296910/RMCPL2390631,,2018-08-03,600.0,,-513270230.06000054,.
409000438620',2018-08-03,CR821215290412/RMCPL1113131,,2018-08-03,3500.0,,-513273730.06000054,.
409000438620',2018-08-03,TRFT O  Indiaforensic SERVICES I,,2018-08-03,15000000.0,,-528273730.06000054,.
409000438620',2018-08-03,MAW/502964XXXXXX1356/Karu,,2018-08-03,,1100.0,-528272630.06000054,.
409000438620',2018-08-03,MAW/502964XXXXXX3961/Karu,,2018-08-03,,1900.0,-528270730.06000054,.
409000438620',2018-08-03,MAW/502964XXXXXX4399/Karu,,2018-08-03,,1800.0,-528268930.06000054,.
409000438620',2018-08-03,MICRO ATM SETTLEMENT DT 0,,2018-08-03,,100.0,-528268830.06000054,.
409000438620',2018-08-03,TRF TO  Indiaforensic SERVICES I,,2018-08-03,300000.0,,-528568830.06000054,.
409000438620',2018-08-03,AEPS INCOME DT 02-08-2018,,2018-08-03,,38834.96,-528529995.10000056,.
409000438620',2018-08-03,AEPS GST INC DT 02-08-201,,2018-08-03,,7766.99,-528522228.11000055,.
409000438620',2018-08-03,AEPS ACQ CR ADJ FEES 0208,,2018-08-03,143.96,,-528522372.0700005,.
409000438620',2018-08-03,AEPS ACQ REP ADJ FEES 020,,2018-08-03,,23.6,-528522348.4700005,.
409000438620',2018-08-03,NFS MICROATMSETTLEMENTDT0,,2018-08-03,,100.0,-528522248.4700005,.
409000438620',2018-08-04,Indiaforensic AEPS NPCI WDL SET,,2018-08-04,,15358000.0,-513164248.4700005,.
409000438620',2018-08-04,TRF TO  Indiaforensic SERVICES I,,2018-08-04,15000000.0,,-528164248.4700005,.
409000438620',2018-08-04,NPCI SETT DIFF_030818_1,,2018-08-04,,100.0,-528164148.4700005,.
409000438620',2018-08-04,MICRO ATM SETTLEMENT DT 0,,2018-08-04,,200.0,-528163948.4700005,.
409000438620',2018-08-04,AEPS INCOME DT 03-08-2018,,2018-08-04,,38639.78,-528125308.69000053,.
409000438620',2018-08-04,AEPS GST INC DT 03-08-201,,2018-08-04,,7727.96,-528117580.73000056,.
409000438620',2018-08-04,AEPS ACQUIRING ADJ FEES 0,,2018-08-04,17.7,,-528117598.43000054,.
409000438620',2018-08-04,TRF TO  Indiaforensic SERVICES I,,2018-08-04,500000.0,,-528617598.43000054,.
409000438620',2018-08-06,MAW/502964XXXXXX4267/Karu,,2018-08-06,,1800.0,-528615798.43000054,.
409000438620',2018-08-06,MAW/502964XXXXXX3988/Karu,,2018-08-06,,1800.0,-528613998.43000054,.
409000438620',2018-08-06,MAW/502964XXXXXX2946/Karu,,2018-08-06,,1800.0,-528612198.43000054,.
409000438620',2018-08-06,MAW/502964XXXXXX2870/Karu,,2018-08-06,,1800.0,-528610398.43000054,.
409000438620',2018-08-06,MAW/502964XXXXXX6222/Karu,,2018-08-06,,1800.0,-528608598.43000054,.
409000438620',2018-08-06,MAW/502964XXXXXX3751/Karu,,2018-08-06,,1800.0,-528606798.43000054,.
409000438620',2018-08-06,MAW/502964XXXXXX5160/Karu,,2018-08-06,,1800.0,-528604998.43000054,.
409000438620',2018-08-06,MAW/502964XXXXXX2953/Karu,,2018-08-06,,1800.0,-528603198.43000054,.
409000438620',2018-08-06,MAW/502964XXXXXX4558/Karu,,2018-08-06,,1600.0,-528601598.43000054,.
409000438620',2018-08-06,MAW/502964XXXXXX2938/Karu,,2018-08-06,,1800.0,-528599798.43000054,.
409000438620',2018-08-06,MAW/502964XXXXXX1212/Cudd,,2018-08-06,,1000.0,-528598798.43000054,.
409000438620',2018-08-06,Indiaforensic AEPS NPCI WDL SET,,2018-08-06,,13440900.0,-515157898.43000054,.
409000438620',2018-08-06,Indiaforensic AEPS NPCI WDL SET,,2018-08-06,,9689800.0,-505468098.43000054,.
409000438620',2018-08-06,MAW/502964XXXXXX8477/Karu,,2018-08-06,,1800.0,-505466298.43000054,.
409000438620',2018-08-06,MAW/502964XXXXXX0485/Karu,,2018-08-06,,1800.0,-505464498.43000054,.
409000438620',2018-08-06,TRF TO  Indiaforensic SERVICES I,,2018-08-06,15000000.0,,-520464498.43000054,.
409000438620',2018-08-06,TRF TO  Indiaforensic SERVICES I,,2018-08-06,8100000.0,,-528564498.43000054,.
409000438620',2018-08-06,NPCI SETT DIFF_050818_1,,2018-08-06,,400.0,-528564098.43000054,.
409000438620',2018-08-06,MAW/502964XXXXXX9734/NAGA,,2018-08-06,,700.0,-528563398.43000054,.
409000438620',2018-08-06,AEPS INCOME DT 04-08-2018,,2018-08-06,,34620.46,-528528777.97000057,.
409000438620',2018-08-06,AEPS GST INC DT 04-08-201,,2018-08-06,,6924.09,-528521853.8800006,.
409000438620',2018-08-06,AEPS INCOME DT 05-08-2018,,2018-08-06,,25551.09,-528496302.7900006,.
409000438620',2018-08-06,AEPS GST INC DT 05-08-201,,2018-08-06,,5110.22,-528491192.5700006,.
409000438620',2018-08-07,MAW/502964XXXXXX4713/Karu,,2018-08-07,,1600.0,-528489592.5700006,.
409000438620',2018-08-07,MAW/502964XXXXXX7625/Karu,,2018-08-07,,5800.0,-528483792.5700006,.
409000438620',2018-08-07,MAW/502964XXXXXX7666/Karu,,2018-08-07,,2800.0,-528480992.5700006,.
409000438620',2018-08-07,Indiaforensic AEPS NPCI WDL SET,,2018-08-07,,14060800.0,-514420192.5700006,.
409000438620',2018-08-07,TRF TO  Indiaforensic SERVICES I,,2018-08-07,14200000.0,,-528620192.5700006,.
409000438620',2018-08-07,AEPS INCOME DT 06-08-2018,,2018-08-07,,36440.88,-528583751.6900006,.
409000438620',2018-08-07,AEPS GST INC DT 06-08-201,,2018-08-07,,7288.18,-528576463.5100006,.
409000438620',2018-08-07,AEPS ACQUIRING ADJ FEES 0,,2018-08-07,57.82,,-528576521.3300006,.
409000438620',2018-08-08,Indiaforensic AEPS NPCI WDL SET,,2018-08-08,,14792500.0,-513784021.3300006,.
409000438620',2018-08-08,TRF TO  Indiaforensic SERVICES I,,2018-08-08,10000000.0,,-523784021.3300006,.
409000438620',2018-08-08,TRF TO  Indiaforensic SERVICES I,,2018-08-08,4000000.0,,-527784021.3300006,.
409000438620',2018-08-08,TRF TO  Indiaforensic SERVICES I,,2018-08-08,500000.0,,-528284021.3300006,.
409000438620',2018-08-08,AEPS INCOME DT 07-08-2018,,2018-08-08,,39377.51,-528244643.8200006,.
409000438620',2018-08-08,AEPS GST INC DT 07-08-201,,2018-08-08,,7875.5,-528236768.3200006,.
409000438620',2018-08-08,AEPS ACQUIRING ADJ FEES 0,,2018-08-08,42.48,,-528236810.8000006,.
409000438620',2018-08-08,AEPS ACQ REP ADJ FEES 070,,2018-08-08,,17.7,-528236793.1000006,.
409000438620',2018-08-08,CB821415843979/RMCPL19766/0,,2018-08-08,1500.0,,-528238293.1000006,.
409000438620',2018-08-08,CB821410746099/RMCPL23513/0,,2018-08-08,3000.0,,-528241293.1000006,.
409000438620',2018-08-08,CB821412793337/RMCPL22583/0,,2018-08-08,2300.0,,-528243593.1000006,.
409000438620',2018-08-08,CB821512035170/RMCPL12343/0,,2018-08-08,2700.0,,-528246293.1000006,.
409000438620',2018-08-08,CB821513054925/RMCPL22148/0,,2018-08-08,1500.0,,-528247793.1000006,.
409000438620',2018-08-08,CB821617334805/RMCPL17395/0,,2018-08-08,6000.0,,-528253793.1000006,.
409000438620',2018-08-08,TRF TO  Indiaforensic SERVICES I,,2018-08-08,300000.0,,-528553793.1000006,.
409000438620',2018-08-09,MAW/502964XXXXXX4347/Karu,,2018-08-09,,1700.0,-528552093.1000006,.
409000438620',2018-08-09,Indiaforensic AEPS NPCI WDL SET,,2018-08-09,,16820200.0,-511731893.1000006,.
409000438620',2018-08-09,CR817815858416/RMCPL14406/2,,2018-08-09,5000.0,,-511736893.1000006,.
409000438620',2018-08-09,CR817815858350/RMCPL09619/2,,2018-08-09,4000.0,,-511740893.1000006,.
409000438620',2018-08-09,CR817815858354/RMCPL11966/2,,2018-08-09,3100.0,,-511743993.1000006,.
409000438620',2018-08-09,CR817817893314/RMCPL09768/2,,2018-08-09,1700.0,,-511745693.1000006,.
409000438620',2018-08-09,CR817812810359/RMCPL25450/2,,2018-08-09,500.0,,-511746193.1000006,.
409000438620',2018-08-09,CR817812810342/RMCPL26592/2,,2018-08-09,1500.0,,-511747693.1000006,.
409000438620',2018-08-09,CR817812810343/RMCPL18216/2,,2018-08-09,2000.0,,-511749693.1000006,.
409000438620',2018-08-09,CR817810782985/RMCPL18915/2,,2018-08-09,500.0,,-511750193.1000006,.
409000438620',2018-08-09,CR817818907786/RMCPL14700/2,,2018-08-09,500.0,,-511750693.1000006,.
409000438620',2018-08-09,CR817812819549/RMCPL09536/2,,2018-08-09,1000.0,,-511751693.1000006,.
409000438620',2018-08-09,CR817812819572/RMCPL11613/2,,2018-08-09,3000.0,,-511754693.1000006,.
409000438620',2018-08-09,CR817812819568/RMCPL25428/2,,2018-08-09,1000.0,,-511755693.1000006,.
409000438620',2018-08-09,CR817812811520/RMCPL21021/2,,2018-08-09,1800.0,,-511757493.1000006,.
409000438620',2018-08-09,CR817810782993/RMCPL12604/2,,2018-08-09,4000.0,,-511761493.1000006,.
409000438620',2018-08-09,CR817818904413/RMCPL21965/2,,2018-08-09,2000.0,,-511763493.1000006,.
409000438620',2018-08-09,CR817812811801/RMCPL13680/2,,2018-08-09,1000.0,,-511764493.1000006,.
409000438620',2018-08-09,CR817812811795/RMCPL18729/2,,2018-08-09,500.0,,-511764993.1000006,.
409000438620',2018-08-09,CR817810782975/RMCPL22488/2,,2018-08-09,1000.0,,-511765993.1000006,.
409000438620',2018-08-09,CR817710518442/RMCPL22799/2,,2018-08-09,500.0,,-511766493.1000006,.
409000438620',2018-08-09,CR817714579462/RMCPL09726/2,,2018-08-09,1000.0,,-511767493.1000006,.
409000438620',2018-08-09,CR817710511413/RMCPL16684/2,,2018-08-09,3600.0,,-511771093.1000006,.
409000438620',2018-08-09,CR817710518871/RMCPL12826/2,,2018-08-09,5000.0,,-511776093.1000006,.
409000438620',2018-08-09,CR817710518547/RMCPL16908/2,,2018-08-09,500.0,,-511776593.1000006,.
409000438620',2018-08-09,CR817710520808/RMCPL25095/2,,2018-08-09,4000.0,,-511780593.1000006,.
409000438620',2018-08-09,CR817710520804/RMCPL23968/2,,2018-08-09,1000.0,,-511781593.1000006,.
409000438620',2018-08-09,CR817710520779/RMCPL22038/2,,2018-08-09,5000.0,,-511786593.1000006,.
409000438620',2018-08-09,CR817716609893/RMCPL20143/2,,2018-08-09,1000.0,,-511787593.1000006,.
409000438620',2018-08-09,CR817716609868/RMCPL11611/2,,2018-08-09,1000.0,,-511788593.1000006,.
409000438620',2018-08-09,CR817716609869/RMCPL23345/2,,2018-08-09,1000.0,,-511789593.1000006,.
409000438620',2018-08-09,TRF TO  Indiaforensic SERVICES I,,2018-08-09,15000000.0,,-526789593.1000006,.
409000438620',2018-08-09,TRF TO  Indiaforensic SERVICES I,,2018-08-09,1800000.0,,-528589593.1000006,.
409000438620',2018-08-09,MAW/502964XXXXXX5347/Karu,,2018-08-09,,1700.0,-528587893.1000006,.
409000438620',2018-08-09,MAW/502964XXXXXX8487/Karu,,2018-08-09,,1700.0,-528586193.1000006,.
409000438620',2018-08-09,MAW/502964XXXXXX9291/Karu,,2018-08-09,,1700.0,-528584493.1000006,.
409000438620',2018-08-09,NFS MICRO ATM SETT DT 090,,2018-08-09,,100.0,-528584393.1000006,.
409000438620',2018-08-09,MAW/502964XXXXXX7808/Karu,,2018-08-09,,1700.0,-528582693.1000006,.
409000438620',2018-08-09,MAW/502964XXXXXX7269/Karu,,2018-08-09,,1700.0,-528580993.1000006,.
409000438620',2018-08-09,MAW/502964XXXXXX4893/Karu,,2018-08-09,,1700.0,-528579293.1000006,.
409000438620',2018-08-09,MAW/502964XXXXXX3499/Karu,,2018-08-09,,1700.0,-528577593.1000006,.
409000438620',2018-08-09,MAW/502964XXXXXX4901/Karu,,2018-08-09,,1700.0,-528575893.1000006,.
409000438620',2018-08-09,AEPS INCOME DT 08-08-2018,,2018-08-09,,43210.21,-528532682.89000064,.
409000438620',2018-08-09,AEPS GST INC DT 08-08-201,,2018-08-09,,8642.04,-528524040.8500006,.
409000438620',2018-08-09,AEPS ACQUIRING ADJ FEES 0,,2018-08-09,8.85,,-528524049.70000064,.
409000438620',2018-08-09,AEPS ACQ CR ADJ FEES 0808,,2018-08-09,253.7,,-528524303.40000063,.
409000438620',2018-08-09,AEPS ACQ REP ADJ FEES 080,,2018-08-09,,17.7,-528524285.70000064,.
409000438620',2018-08-10,MAW/502964XXXXXX3889/Karu,,2018-08-10,,1800.0,-528522485.70000064,.
409000438620',2018-08-10,MAW/502964XXXXXX8476/Vals,,2018-08-10,,4000.0,-528518485.70000064,.
409000438620',2018-08-10,MAW/502964XXXXXX8161/Karu,,2018-08-10,,1700.0,-528516785.70000064,.
409000438620',2018-08-10,Indiaforensic AEPS NPCI WDL SET,,2018-08-10,,15830300.0,-512686485.70000064,.
409000438620',2018-08-10,TRF T  Indiaforensic SERVICES IN,,2018-08-10,900000.0,,-513586485.70000064,.
409000438620',2018-08-10,TRF T  Indiaforensic SERVICES IN,,2018-08-10,15000000.0,,-528586485.70000064,.
409000438620',2018-08-10,NPCI SETT DIFF_090818_1,,2018-08-10,,100.0,-528586385.70000064,.
409000438620',2018-08-10,MAW/502964XXXXXX9200/Karu,,2018-08-10,,1700.0,-528584685.70000064,.
409000438620',2018-08-10,MAW/502964XXXXXX9226/Karu,,2018-08-10,,1700.0,-528582985.70000064,.
409000438620',2018-08-10,MAW/502964XXXXXX8252/Karu,,2018-08-10,,1700.0,-528581285.70000064,.
409000438620',2018-08-10,MAW/502964XXXXXX5206/Karu,,2018-08-10,,1700.0,-528579585.70000064,.
409000438620',2018-08-10,AEPS INCOME DT 09-08-2018,,2018-08-10,,40219.08,-528539366.62000066,.
409000438620',2018-08-10,AEPS GST INC DT 09-08-201,,2018-08-10,,8043.82,-528531322.80000067,.
409000438620',2018-08-10,MAW/502964XXXXXX9192/Karu,,2018-08-10,,1700.0,-528529622.80000067,.
409000438620',2018-08-10,MAW/502964XXXXXX5869/Karu,,2018-08-10,,1700.0,-528527922.80000067,.
409000438620',2018-08-10,MAW/502964XXXXXX8828/Karu,,2018-08-10,,1700.0,-528526222.80000067,.
409000438620',2018-08-10,MAW/502964XXXXXX5612/Karu,,2018-08-10,,1700.0,-528524522.80000067,.
409000438620',2018-08-10,MAW/502964XXXXXX0069/Karu,,2018-08-10,,1700.0,-528522822.80000067,.
409000438620',2018-08-10,MAW/502964XXXXXX8339/Karu,,2018-08-10,,1700.0,-528521122.80000067,.
409000438620',2018-08-10,Indfor-MICRO ATM INC DT 0908,,2018-08-10,,0.36,-528521122.44000065,.
409000438620',2018-08-10,Indfor-MICRO ATM WDL GST DT0,,2018-08-10,,0.07,-528521122.37000066,.
409000438620',2018-08-10,Indfor-MICRO ATM INC DT 3107,,2018-08-10,,0.72,-528521121.65000063,.
409000438620',2018-08-10,Indfor-MICRO ATM WDL GST DT3,,2018-08-10,,0.14,-528521121.51000065,.
409000438620',2018-08-10,Indfor-MICRO ATM INC DT 3107,,2018-08-10,,0.36,-528521121.15000063,.
409000438620',2018-08-10,Indfor-MICRO ATM WDL GST DT3,,2018-08-10,,0.07,-528521121.08000064,.
409000438620',2018-08-10,Indfor-MICRO ATM INC DT 3107,,2018-08-10,,0.36,-528521120.7200006,.
409000438620',2018-08-10,Indfor-MICRO ATM WDL GST DT3,,2018-08-10,,0.07,-528521120.65000063,.
409000438620',2018-08-10,Indfor-MICRO ATM INC DT 0108,,2018-08-10,,10.8,-528521109.8500006,.
409000438620',2018-08-10,Indfor-MICRO ATM WDL GST DT0,,2018-08-10,,2.16,-528521107.6900006,.
409000438620',2018-08-10,Indfor-MICRO ATM INC DT 0208,,2018-08-10,,0.36,-528521107.3300006,.
409000438620',2018-08-10,Indfor-MICRO ATM WDL GST DT0,,2018-08-10,,0.07,-528521107.2600006,.
409000438620',2018-08-10,Indfor-MICRO ATM INC DT 0308,,2018-08-10,,0.36,-528521106.9000006,.
409000438620',2018-08-10,Indfor-MICRO ATM WDL GST DT0,,2018-08-10,,0.07,-528521106.8300006,.
409000438620',2018-08-10,Indfor-MICRO ATM INC DT 0308,,2018-08-10,,0.36,-528521106.47000057,.
409000438620',2018-08-10,Indfor-MICRO ATM WDL GST DT0,,2018-08-10,,0.07,-528521106.4000006,.
409000438620',2018-08-10,Indfor-MICRO ATM INC DT 0308,,2018-08-10,,0.36,-528521106.04000056,.
409000438620',2018-08-10,Indfor-MICRO ATM WDL GST DT0,,2018-08-10,,0.07,-528521105.97000057,.
409000438620',2018-08-10,Indfor-MICRO ATM INC DT 0908,,2018-08-10,,0.36,-528521105.61000055,.
409000438620',2018-08-10,Indfor-MICRO ATM WDL GST DT0,,2018-08-10,,0.07,-528521105.54000056,.
409000438620',2018-08-11,MAW/502964XXXXXX9461/Akol,,2018-08-11,,900.0,-528520205.54000056,.
409000438620',2018-08-11,MAW/502964XXXXXX2374/Karu,,2018-08-11,,1700.0,-528518505.54000056,.
409000438620',2018-08-11,MAW/502964XXXXXX5745/Karu,,2018-08-11,,1700.0,-528516805.54000056,.
409000438620',2018-08-11,MAW/502964XXXXXX6499/Karu,,2018-08-11,,1700.0,-528515105.54000056,.
409000438620',2018-08-11,MAW/502964XXXXXX2291/Karu,,2018-08-11,,1700.0,-528513405.54000056,.
409000438620',2018-08-11,MAW/502964XXXXXX5115/Karu,,2018-08-11,,1700.0,-528511705.54000056,.
409000438620',2018-08-11,MAW/502964XXXXXX6531/Karu,,2018-08-11,,1700.0,-528510005.54000056,.
409000438620',2018-08-11,MAW/502964XXXXXX2723/Karu,,2018-08-11,,1700.0,-528508305.54000056,.
409000438620',2018-08-13,MAW/502964XXXXXX7634/Karu,,2018-08-13,,1700.0,-528506605.54000056,.
409000438620',2018-08-13,MAW/502964XXXXXX7973/Karu,,2018-08-13,,1700.0,-528504905.54000056,.
409000438620',2018-08-13,MAW/502964XXXXXX0718/Karu,,2018-08-13,,1600.0,-528503305.54000056,.
409000438620',2018-08-13,MAW/502964XXXXXX0385/Karu,,2018-08-13,,1500.0,-528501805.54000056,.
409000438620',2018-08-13,MAW/502964XXXXXX5466/Karu,,2018-08-13,,1500.0,-528500305.54000056,.
409000438620',2018-08-13,MAW/502964XXXXXX7313/Karu,,2018-08-13,,1700.0,-528498605.54000056,.
409000438620',2018-08-13,Indiaforensic AEPS NPCI WDL SET,,2018-08-13,,17341500.0,-511157105.54000056,.
409000438620',2018-08-13,MAW/502964XXXXXX3929/Karu,,2018-08-13,,1700.0,-511155405.54000056,.
409000438620',2018-08-13,MAW/502964XXXXXX0388/Karu,,2018-08-13,,1700.0,-511153705.54000056,.
409000438620',2018-08-13,MAW/502964XXXXXX6763/Karu,,2018-08-13,,1700.0,-511152005.54000056,.
409000438620',2018-08-13,Indiaforensic AEPS NPCI WDL SET,,2018-08-13,,14579700.0,-496572305.54000056,.
409000438620',2018-08-13,Indiaforensic AEPS NPCI WDL SET,,2018-08-13,,8626000.0,-487946305.54000056,.
409000438620',2018-08-13,CR821310480091/RMCPL19769/0,,2018-08-13,1000.0,,-487947305.54000056,.
409000438620',2018-08-13,CR821310476743/RMCPL23207/0,,2018-08-13,3400.0,,-487950705.54000056,.
409000438620',2018-08-13,CR821310476796/RMCPL25390/0,,2018-08-13,1000.0,,-487951705.54000056,.
409000438620',2018-08-13,CR821310481668/RMCPL11793/0,,2018-08-13,5000.0,,-487956705.54000056,.
409000438620',2018-08-13,CR821310482145/RMCPL25809/0,,2018-08-13,1000.0,,-487957705.54000056,.
409000438620',2018-08-13,CR821310482060/RMCPL15559/0,,2018-08-13,900.0,,-487958605.54000056,.
409000438620',2018-08-13,CR821310481791/RMCPL16659/0,,2018-08-13,1000.0,,-487959605.54000056,.
409000438620',2018-08-13,CR821310481689/RMCPL25729/0,,2018-08-13,3000.0,,-487962605.54000056,.
409000438620',2018-08-13,CR821312511477/RMCPL22235/0,,2018-08-13,2000.0,,-487964605.54000056,.
409000438620',2018-08-13,CR821309456931/RMCPL20620/0,,2018-08-13,1000.0,,-487965605.54000056,.
409000438620',2018-08-13,CR821310474527/RMCPL02810/0,,2018-08-13,1000.0,,-487966605.54000056,.
409000438620',2018-08-13,CR821310474533/RMCPL15438/0,,2018-08-13,5000.0,,-487971605.54000056,.
409000438620',2018-08-13,CR821310474542/RMCPL24866/0,,2018-08-13,2000.0,,-487973605.54000056,.
409000438620',2018-08-13,CR821312516490/RMCPL23268/0,,2018-08-13,4900.0,,-487978505.54000056,.
409000438620',2018-08-13,CR821309463804/RMCPL22867/0,,2018-08-13,1000.0,,-487979505.54000056,.
409000438620',2018-08-13,CR821309463807/RMCPL14382/0,,2018-08-13,2000.0,,-487981505.54000056,.
409000438620',2018-08-13,CR821311494351/RMCPL18547/0,,2018-08-13,4000.0,,-487985505.54000056,.
409000438620',2018-08-13,CR821316573894/RMCPL24425/0,,2018-08-13,2000.0,,-487987505.54000056,.
409000438620',2018-08-13,CR821317593082/RMCPL12121/0,,2018-08-13,1000.0,,-487988505.54000056,.
409000438620',2018-08-13,CR821417863056/RMCPL16622/0,,2018-08-13,2000.0,,-487990505.54000056,.
409000438620',2018-08-13,CR821411780146/RMCPL22397/0,,2018-08-13,10000.0,,-488000505.54000056,.
409000438620',2018-08-13,CR821415832923/RMCPL22499/0,,2018-08-13,2500.0,,-488003005.54000056,.
409000438620',2018-08-13,CR821415832935/RMCPL25229/0,,2018-08-13,1000.0,,-488004005.54000056,.
409000438620',2018-08-13,CR821410760028/RMCPL20987/0,,2018-08-13,10000.0,,-488014005.54000056,.
409000438620',2018-08-13,CR821409738106/RMCPL23810/0,,2018-08-13,500.0,,-488014505.54000056,.
409000438620',2018-08-13,CR821418882744/RMCPL19779/0,,2018-08-13,4000.0,,-488018505.54000056,.
409000438620',2018-08-13,CR821410760021/RMCPL24710/0,,2018-08-13,1500.0,,-488020005.54000056,.
409000438620',2018-08-13,CR821408722985/RMCPL19942/0,,2018-08-13,800.0,,-488020805.54000056,.
409000438620',2018-08-13,CR821419909370/RMCPL23880/0,,2018-08-13,2000.0,,-488022805.54000056,.
409000438620',2018-08-13,CR821412786895/RMCPL15696/0,,2018-08-13,1000.0,,-488023805.54000056,.
409000438620',2018-08-13,CR821410760016/RMCPL15388/0,,2018-08-13,1000.0,,-488024805.54000056,.
409000438620',2018-08-13,CR821413805629/RMCPL22628/0,,2018-08-13,2000.0,,-488026805.54000056,.
409000438620',2018-08-13,CR821413805632/RMCPL15794/0,,2018-08-13,1000.0,,-488027805.54000056,.
409000438620',2018-08-13,CR821412799046/RMCPL17234/0,,2018-08-13,500.0,,-488028305.54000056,.
409000438620',2018-08-13,CR821412786891/RMCPL19899/0,,2018-08-13,500.0,,-488028805.54000056,.
409000438620',2018-08-13,CR821416845346/RMCPL28105/0,,2018-08-13,3000.0,,-488031805.54000056,.
409000438620',2018-08-13,CR821419914338/RMCPL07093/0,,2018-08-13,500.0,,-488032305.54000056,.
409000438620',2018-08-13,CR821415838737/RMCPL18312/0,,2018-08-13,1200.0,,-488033505.54000056,.
409000438620',2018-08-13,CR821510002626/RMCPL21455/0,,2018-08-13,1000.0,,-488034505.54000056,.
409000438620',2018-08-13,CR821515087154/RMCPL22133/0,,2018-08-13,8000.0,,-488042505.54000056,.
409000438620',2018-08-13,CR821515087156/RMCPL15326/0,,2018-08-13,2000.0,,-488044505.54000056,.
409000438620',2018-08-13,CR821512035153/RMCPL14126/0,,2018-08-13,10000.0,,-488054505.54000056,.
409000438620',2018-08-13,CR821514068387/RMCPL24066/0,,2018-08-13,10000.0,,-488064505.54000056,.
409000438620',2018-08-13,CR821516096498/RMCPL23378/0,,2018-08-13,2000.0,,-488066505.54000056,.
409000438620',2018-08-13,CR821513054924/RMCPL07093/0,,2018-08-13,2000.0,,-488068505.54000056,.
409000438620',2018-08-13,CR821513054922/RMCPL11613/0,,2018-08-13,1500.0,,-488070005.54000056,.
409000438620',2018-08-13,CR821510001664/RMCPL25366/0,,2018-08-13,2000.0,,-488072005.54000056,.
409000438620',2018-08-13,CR821510003474/RMCPL21354/0,,2018-08-13,500.0,,-488072505.54000056,.
409000438620',2018-08-13,CR821511016141/RMCPL18859/0,,2018-08-13,10000.0,,-488082505.54000056,.
409000438620',2018-08-13,CR821516097248/RMCPL21455/0,,2018-08-13,2000.0,,-488084505.54000056,.
409000438620',2018-08-13,CR821517108841/RMCPL15602/0,,2018-08-13,500.0,,-488085005.54000056,.
409000438620',2018-08-13,CR821510015182/RMCPL19108/0,,2018-08-13,500.0,,-488085505.54000056,.
409000438620',2018-08-13,CR821917029973/RMCPL18303/0,,2018-08-13,1000.0,,-488086505.54000056,.
409000438620',2018-08-13,CR821916012845/RMCPL21454/0,,2018-08-13,5000.0,,-488091505.54000056,.
409000438620',2018-08-13,CR821917024565/RMCPL08225/0,,2018-08-13,4000.0,,-488095505.54000056,.
409000438620',2018-08-13,CR821916009021/RMCPL20404/0,,2018-08-13,1000.0,,-488096505.54000056,.
409000438620',2018-08-13,CR821916009025/RMCPL10073/0,,2018-08-13,1800.0,,-488098305.54000056,.
409000438620',2018-08-13,CR821916009022/RMCPL22133/0,,2018-08-13,2000.0,,-488100305.54000056,.
409000438620',2018-08-13,CR821812714768/RMCPL20871/0,,2018-08-13,1000.0,,-488101305.54000056,.
409000438620',2018-08-13,CR821910931765/RMCPL24605/0,,2018-08-13,2500.0,,-488103805.54000056,.
409000438620',2018-08-13,CR821911949429/RMCPL18380/0,,2018-08-13,500.0,,-488104305.54000056,.
409000438620',2018-08-13,CR821910931807/RMCPL00216/0,,2018-08-13,1000.0,,-488105305.54000056,.
409000438620',2018-08-13,CR821518121626/RMCPL16774/0,,2018-08-13,2000.0,,-488107305.54000056,.
409000438620',2018-08-13,CR821517108863/RMCPL18538/0,,2018-08-13,4000.0,,-488111305.54000056,.
409000438620',2018-08-13,CR821516103298/RMCPL18536/0,,2018-08-13,500.0,,-488111805.54000056,.
409000438620',2018-08-13,CR821518121634/RMCPL24066/0,,2018-08-13,500.0,,-488112305.54000056,.
409000438620',2018-08-13,CR821710455734/RMCPL05050/0,,2018-08-13,1000.0,,-488113305.54000056,.
409000438620',2018-08-13,CR821610252852/RMCPL23688/0,,2018-08-13,10000.0,,-488123305.54000056,.
409000438620',2018-08-13,CR821616322349/RMCPL20628/0,,2018-08-13,2000.0,,-488125305.54000056,.
409000438620',2018-08-13,CR821610252840/RMCPL10073/0,,2018-08-13,1800.0,,-488127105.54000056,.
409000438620',2018-08-13,CR821617327305/RMCPL05050/0,,2018-08-13,1000.0,,-488128105.54000056,.
409000438620',2018-08-13,CR821616322353/RMCPL20001/0,,2018-08-13,2300.0,,-488130405.54000056,.
409000438620',2018-08-13,CR821611258999/RMCPL25029/0,,2018-08-13,3000.0,,-488133405.54000056,.
409000438620',2018-08-13,CR821610239561/RMCPL15535/0,,2018-08-13,2000.0,,-488135405.54000056,.
409000438620',2018-08-13,CR821610239559/RMCPL22976/0,,2018-08-13,2000.0,,-488137405.54000056,.
409000438620',2018-08-13,CR821611271770/RMCPL23513/0,,2018-08-13,1000.0,,-488138405.54000056,.
409000438620',2018-08-13,CR821613298060/RMCPL26557/0,,2018-08-13,500.0,,-488138905.54000056,.
409000438620',2018-08-13,CR821818802319/RMCPL15326/0,,2018-08-13,1500.0,,-488140405.54000056,.
409000438620',2018-08-13,CR821809666818/RMCPL14884/0,,2018-08-13,500.0,,-488140905.54000056,.
409000438620',2018-08-13,CR821813735030/RMCPL07629/0,,2018-08-13,500.0,,-488141405.54000056,.
409000438620',2018-08-13,CR821814749289/RMCPL11131/0,,2018-08-13,500.0,,-488141905.54000056,.
409000438620',2018-08-13,CR821814749276/RMCPL15879/0,,2018-08-13,500.0,,-488142405.54000056,.
409000438620',2018-08-13,CR821811697526/RMCPL20136/0,,2018-08-13,800.0,,-488143205.54000056,.
409000438620',2018-08-13,CR821816781041/RMCPL27951/0,,2018-08-13,2000.0,,-488145205.54000056,.
409000438620',2018-08-13,CR821816781021/RMCPL08171/0,,2018-08-13,700.0,,-488145905.54000056,.
409000438620',2018-08-13,CR821911942153/RMCPL15388/0,,2018-08-13,1000.0,,-488146905.54000056,.
409000438620',2018-08-13,CR821910933655/RMCPL22284/0,,2018-08-13,1000.0,,-488147905.54000056,.
409000438620',2018-08-13,CR821914988746/RMCPL12343/0,,2018-08-13,6000.0,,-488153905.54000056,.
409000438620',2018-08-13,CR821910927437/RMCPL19418/0,,2018-08-13,1500.0,,-488155405.54000056,.
409000438620',2018-08-13,CR821913977913/RMCPL12796/0,,2018-08-13,1000.0,,-488156405.54000056,.
409000438620',2018-08-13,CR821913977915/RMCPL27447/0,,2018-08-13,500.0,,-488156905.54000056,.
409000438620',2018-08-13,CR821912957636/RMCPL02151/0,,2018-08-13,500.0,,-488157405.54000056,.
409000438620',2018-08-13,CR821914988764/RMCPL20182/0,,2018-08-13,2000.0,,-488159405.54000056,.
409000438620',2018-08-13,CR821618340924/RMCPL01394/0,,2018-08-13,500.0,,-488159905.54000056,.
409000438620',2018-08-13,CR821814752787/RMCPL00791/0,,2018-08-13,700.0,,-488160605.54000056,.
409000438620',2018-08-13,CR821814749247/RMCPL26549/0,,2018-08-13,500.0,,-488161105.54000056,.
409000438620',2018-08-13,CR821913968354/RMCPL16879/0,,2018-08-13,2000.0,,-488163105.54000056,.
409000438620',2018-08-13,CR821911937853/RMCPL19554/0,,2018-08-13,1000.0,,-488164105.54000056,.
409000438620',2018-08-13,CR821913969426/RMCPL24053/0,,2018-08-13,2500.0,,-488166605.54000056,.
409000438620',2018-08-13,CR822018290487/RMCPL15429/0,,2018-08-13,800.0,,-488167405.54000056,.
409000438620',2018-08-13,CR822015252635/RMCPL17788/0,,2018-08-13,500.0,,-488167905.54000056,.
409000438620',2018-08-13,CR822009144722/RMCPL27311/0,,2018-08-13,1000.0,,-488168905.54000056,.
409000438620',2018-08-13,CR822011196797/RMCPL23084/0,,2018-08-13,10000.0,,-488178905.54000056,.
409000438620',2018-08-13,CR822014243835/RMCPL24591/0,,2018-08-13,3500.0,,-488182405.54000056,.
409000438620',2018-08-13,CR822016260521/RMCPL15717/0,,2018-08-13,5000.0,,-488187405.54000056,.
409000438620',2018-08-13,CR822009144741/RMCPL16439/0,,2018-08-13,2000.0,,-488189405.54000056,.
409000438620',2018-08-13,CR822011184660/RMCPL12864/0,,2018-08-13,1100.0,,-488190505.54000056,.
409000438620',2018-08-13,CR822012211927/RMCPL16282/0,,2018-08-13,1000.0,,-488191505.54000056,.
409000438620',2018-08-13,CR822012222780/RMCPL23472/0,,2018-08-13,10000.0,,-488201505.54000056,.
409000438620',2018-08-13,CR822011180750/RMCPL19869/0,,2018-08-13,600.0,,-488202105.54000056,.
409000438620',2018-08-13,CR822011192709/RMCPL26747/0,,2018-08-13,600.0,,-488202705.54000056,.
409000438620',2018-08-13,CR822012217426/RMCPL18017/0,,2018-08-13,1000.0,,-488203705.54000056,.
409000438620',2018-08-13,CR822012217407/RMCPL22967/0,,2018-08-13,4000.0,,-488207705.54000056,.
409000438620',2018-08-13,CR822010166166/RMCPL14380/0,,2018-08-13,1000.0,,-488208705.54000056,.
409000438620',2018-08-13,CR822011197625/RMCPL23207/0,,2018-08-13,600.0,,-488209305.54000056,.
409000438620',2018-08-13,CR822013233320/RMCPL22628/0,,2018-08-13,2000.0,,-488211305.54000056,.
409000438620',2018-08-13,CR822011194168/RMCPL21556/0,,2018-08-13,1000.0,,-488212305.54000056,.
409000438620',2018-08-13,CR822011194066/RMCPL25136/0,,2018-08-13,1000.0,,-488213305.54000056,.
409000438620',2018-08-13,CR822011184573/RMCPL00857/0,,2018-08-13,10000.0,,-488223305.54000056,.
409000438620',2018-08-13,CR822011194124/RMCPL10943/0,,2018-08-13,1600.0,,-488224905.54000056,.
409000438620',2018-08-13,CR822017275969/RMCPL24294/0,,2018-08-13,2000.0,,-488226905.54000056,.
409000438620',2018-08-13,CR822011196135/RMCPL16221/0,,2018-08-13,8000.0,,-488234905.54000056,.
409000438620',2018-08-13,CR822014239139/RMCPL15998/0,,2018-08-13,500.0,,-488235405.54000056,.
409000438620',2018-08-13,CR822012207266/RMCPL17436/0,,2018-08-13,3000.0,,-488238405.54000056,.
409000438620',2018-08-13,CR822012211917/RMCPL27399/0,,2018-08-13,500.0,,-488238905.54000056,.
409000438620',2018-08-13,TRF TO  Indiaforensic SERVICES I,,2018-08-13,10000000.0,,-498238905.54000056,.
409000438620',2018-08-13,TRF TO  Indiaforensic SERVICES I,,2018-08-13,10000000.0,,-508238905.54000056,.
409000438620',2018-08-13,TRF TO  Indiaforensic SERVICES I,,2018-08-13,5000000.0,,-513238905.54000056,.
409000438620',2018-08-13,TRF TO  Indiaforensic SERVICES I,,2018-08-13,15000000.0,,-528238905.54000056,.
409000438620',2018-08-13,MAW/502964XXXXXX2205/Karu,,2018-08-13,,1700.0,-528237205.54000056,.
409000438620',2018-08-13,MAW/502964XXXXXX8671/Karu,,2018-08-13,,800.0,-528236405.54000056,.
409000438620',2018-08-13,CB821411780133/RMCPL24646/0,,2018-08-13,1000.0,,-528237405.54000056,.
409000438620',2018-08-13,CB821712484614/RMCPL15602/0,,2018-08-13,500.0,,-528237905.54000056,.
409000438620',2018-08-13,AEPS INCOME DT 10-08-2018,,2018-08-13,,43897.82,-528194007.72000057,.
409000438620',2018-08-13,AEPS GST INC DT 10-08-201,,2018-08-13,,8779.56,-528185228.16000056,.
409000438620',2018-08-13,AEPS INCOME DT 11-08-2018,,2018-08-13,,37338.6,-528147889.56000054,.
409000438620',2018-08-13,AEPS GST INC DT 11-08-201,,2018-08-13,,7467.72,-528140421.8400005,.
409000438620',2018-08-13,AEPS INCOME DT 12-08-2018,,2018-08-13,,22804.51,-528117617.3300005,.
409000438620',2018-08-13,AEPS GST INC DT 12-08-201,,2018-08-13,,4560.9,-528113056.43000054,.
409000438620',2018-08-13,AEPS ACQUIRING ADJ FEES 1,,2018-08-13,17.7,,-528113074.13000053,.
409000438620',2018-08-13,AEPS ACQ CR ADJ FEES 1008,,2018-08-13,1184.66,,-528114258.79000056,.
409000438620',2018-08-14,MAW/502964XXXXXX6046/Karu,,2018-08-14,,1800.0,-528112458.79000056,.
409000438620',2018-08-14,MAW/502964XXXXXX5059/Karu,,2018-08-14,,1800.0,-528110658.79000056,.
409000438620',2018-08-14,MAW/502964XXXXXX8295/Karu,,2018-08-14,,1700.0,-528108958.79000056,.
409000438620',2018-08-14,MAW/502964XXXXXX4672/Karu,,2018-08-14,,1800.0,-528107158.79000056,.
409000438620',2018-08-14,MAW/502964XXXXXX4046/Karu,,2018-08-14,,1800.0,-528105358.79000056,.
409000438620',2018-08-14,MAW/502964XXXXXX7166/Karu,,2018-08-14,,1700.0,-528103658.79000056,.
409000438620',2018-08-14,Indiaforensic AEPS NPCI WDL SET,,2018-08-14,,15837200.0,-512266458.79000056,.
409000438620',2018-08-14,MAW/502964XXXXXX7567/Karu,,2018-08-14,,3500.0,-512262958.79000056,.
409000438620',2018-08-14,MAW/502964XXXXXX7641/Karu,,2018-08-14,,4000.0,-512258958.79000056,.
409000438620',2018-08-14,MAW/502964XXXXXX9119/Karu,,2018-08-14,,1700.0,-512257258.79000056,.
409000438620',2018-08-14,TRF TO  Indiaforensic SERVICES I,,2018-08-14,15000000.0,,-527257258.79000056,.
409000438620',2018-08-14,TRF TO  Indiaforensic SERVICES I,,2018-08-14,1300000.0,,-528557258.79000056,.
409000438620',2018-08-14,AEPS INCOME DT 13-08-2018,,2018-08-14,,40268.85,-528516989.94000053,.
409000438620',2018-08-14,AEPS GST INC DT 13-08-201,,2018-08-14,,8053.77,-528508936.17000055,.
409000438620',2018-08-14,AEPS ACQUIRING ADJ FEES 1,,2018-08-14,29.5,,-528508965.67000055,.
409000438620',2018-08-16,MAW/502964XXXXXX3725/Karu,,2018-08-16,,1500.0,-528507465.67000055,.
409000438620',2018-08-16,MAW/502964XXXXXX0369/Karu,,2018-08-16,,1500.0,-528505965.67000055,.
409000438620',2018-08-16,MAW/502964XXXXXX9647/Karu,,2018-08-16,,1500.0,-528504465.67000055,.
409000438620',2018-08-16,MAW/502964XXXXXX2333/Karu,,2018-08-16,,1700.0,-528502765.67000055,.
409000438620',2018-08-16,Indiaforensic AEPS NPCI WDL SET,,2018-08-16,,15454900.0,-513047865.67000055,.
409000438620',2018-08-16,Indiaforensic AEPS NPCI WDL SET,,2018-08-16,,8543600.0,-504504265.67000055,.
409000438620',2018-08-16,CR822113472358/RMCPL25339/0,,2018-08-16,1000.0,,-504505265.67000055,.
409000438620',2018-08-16,CR822113472368/RMCPL10452/0,,2018-08-16,500.0,,-504505765.67000055,.
409000438620',2018-08-16,CR822108389493/RMCPL14522/0,,2018-08-16,2000.0,,-504507765.67000055,.
409000438620',2018-08-16,CR822108396086/RMCPL15763/0,,2018-08-16,3000.0,,-504510765.67000055,.
409000438620',2018-08-16,CR822113478231/RMCPL25450/0,,2018-08-16,600.0,,-504511365.67000055,.
409000438620',2018-08-16,CR822111439561/RMCPL14522/0,,2018-08-16,2000.0,,-504513365.67000055,.
409000438620',2018-08-16,CR822116508396/RMCPL20589/0,,2018-08-16,600.0,,-504513965.67000055,.
409000438620',2018-08-16,CR822117523315/RMCPL26038/0,,2018-08-16,800.0,,-504514765.67000055,.
409000438620',2018-08-16,CR822111445057/RMCPL11764/0,,2018-08-16,4000.0,,-504518765.67000055,.
409000438620',2018-08-16,CR822108396076/RMCPL25520/0,,2018-08-16,5000.0,,-504523765.67000055,.
409000438620',2018-08-16,CR822115494737/RMCPL22148/0,,2018-08-16,500.0,,-504524265.67000055,.
409000438620',2018-08-16,CR822113478232/RMCPL26217/0,,2018-08-16,10000.0,,-504534265.67000055,.
409000438620',2018-08-16,CR822115494743/RMCPL19766/0,,2018-08-16,800.0,,-504535065.67000055,.
409000438620',2018-08-16,CR822115494758/RMCPL16622/0,,2018-08-16,3100.0,,-504538165.67000055,.
409000438620',2018-08-16,CR822115499210/RMCPL09583/0,,2018-08-16,4000.0,,-504542165.67000055,.
409000438620',2018-08-16,CR822116508442/RMCPL24977/0,,2018-08-16,5000.0,,-504547165.67000055,.
409000438620',2018-08-16,TRF TO  Indiaforensic SERVICES I,,2018-08-16,2000000.0,,-506547165.67000055,.
409000438620',2018-08-16,TRF TO  Indiaforensic SERVICES I,,2018-08-16,10000000.0,,-516547165.67000055,.
409000438620',2018-08-16,TRF TO  Indiaforensic SERVICES I,,2018-08-16,10000000.0,,-526547165.67000055,.
409000438620',2018-08-16,MAW/502964XXXXXX8802/Karu,,2018-08-16,,1700.0,-526545465.67000055,.
409000438620',2018-08-16,MAW/502964XXXXXX8279/Karu,,2018-08-16,,1700.0,-526543765.67000055,.
409000438620',2018-08-16,MAW/502964XXXXXX8329/Karu,,2018-08-16,,1700.0,-526542065.67000055,.
409000438620',2018-08-16,MAW/502964XXXXXX6141/Karu,,2018-08-16,,1700.0,-526540365.67000055,.
409000438620',2018-08-16,MAW/502964XXXXXX1592/Cudd,,2018-08-16,,500.0,-526539865.67000055,.
409000438620',2018-08-16,MAW/502964XXXXXX6701/Karu,,2018-08-16,,1800.0,-526538065.67000055,.
409000438620',2018-08-16,AEPS INCOME DT 14-08-2018,,2018-08-16,,39041.03,-526499024.6400006,.
409000438620',2018-08-16,AEPS GST INC DT 14-08-201,,2018-08-16,,7808.21,-526491216.4300006,.
409000438620',2018-08-16,AEPS INCOME DT 15-08-2018,,2018-08-16,,21938.81,-526469277.6200006,.
409000438620',2018-08-16,AEPS GST INC DT 15-08-201,,2018-08-16,,4387.76,-526464889.8600006,.
409000438620',2018-08-16,AEPS ACQUIRING ADJ FEES 1,,2018-08-16,20.65,,-526464910.5100006,.
409000438620',2018-08-16,AEPS ACQ CR ADJ FEES 1408,,2018-08-16,175.82,,-526465086.3300006,.
409000438620',2018-08-16,AEPS ACQ REP ADJ FEES 140,,2018-08-16,,17.7,-526465068.6300006,.
409000438620',2018-08-16,MAW/502964XXXXXX2088/NAGA,,2018-08-16,,700.0,-526464368.6300006,.
409000438620',2018-08-16,TRF TO  Indiaforensic SERVICES I,,2018-08-16,1000000.0,,-527464368.6300006,.
409000438620',2018-08-16,TRF TO  Indiaforensic SERVICES I,,2018-08-16,1000000.0,,-528464368.6300006,.
409000438620',2018-08-16,MICRO ATM WDL FEE DATED 1,,2018-08-16,,100.0,-528464268.6300006,.
409000438620',2018-08-16,MICRO ATM WDL FEE DATED 1,,2018-08-16,,500.0,-528463768.6300006,.
409000438620',2018-08-16,NFS MICRO ATM GST DATED 1,,2018-08-16,,0.36,-528463768.2700006,.
409000438620',2018-08-16,NFS MICRO ATM INC DATED 1,,2018-08-16,,0.07,-528463768.2000006,.
409000438620',2018-08-16,NFS MICRO ATM GST DATED 1,,2018-08-16,,1.8,-528463766.4000006,.
409000438620',2018-08-16,NFS MICRO ATM INC DATED 1,,2018-08-16,,0.36,-528463766.04000056,.
409000438620',2018-08-17,MAW/502964XXXXXX8203/Karu,,2018-08-17,,1700.0,-528462066.04000056,.
409000438620',2018-08-17,MAW/502964XXXXXX1765/NAGA,,2018-08-17,,400.0,-528461666.04000056,.
409000438620',2018-08-17,MAW/502964XXXXXX7160/Karu,,2018-08-17,,1700.0,-528459966.04000056,.
409000438620',2018-08-17,MAW/502964XXXXXX3507/Karu,,2018-08-17,,1700.0,-528458266.04000056,.
409000438620',2018-08-17,MAW/502964XXXXXX7286/Karu,,2018-08-17,,1700.0,-528456566.04000056,.
409000438620',2018-08-17,Indiaforensic AEPS NPCI WDL SET,,2018-08-17,,14622300.0,-513834266.04000056,.
409000438620',2018-08-17,CB822510350607/RMCPL22469/1,,2018-08-17,1000.0,,-513835266.04000056,.
409000438620',2018-08-17,CB822513412053/RMCPL22133/1,,2018-08-17,3400.0,,-513838666.04000056,.
409000438620',2018-08-17,CB822516456061/RMCPL22038/1,,2018-08-17,600.0,,-513839266.04000056,.
409000438620',2018-08-17,CB822511383884/RMCPL20827/1,,2018-08-17,2000.0,,-513841266.04000056,.
409000438620',2018-08-17,CB822515443583/RMCPL20628/1,,2018-08-17,4000.0,,-513845266.04000056,.
409000438620',2018-08-17,CB822515446244/RMCPL26809/1,,2018-08-17,500.0,,-513845766.04000056,.
409000438620',2018-08-17,CB822509342226/RMCPL21549/1,,2018-08-17,700.0,,-513846466.04000056,.
409000438620',2018-08-17,CB822512405900/RMCPL27013/1,,2018-08-17,10000.0,,-513856466.04000056,.
409000438620',2018-08-17,CB822512391894/RMCPL19782/1,,2018-08-17,3000.0,,-513859466.04000056,.
409000438620',2018-08-17,CB822511383950/RMCPL26747/1,,2018-08-17,1000.0,,-513860466.04000056,.
409000438620',2018-08-17,CB822512391786/RMCPL22469/1,,2018-08-17,500.0,,-513860966.04000056,.
409000438620',2018-08-17,CB822513418056/RMCPL10677/1,,2018-08-17,500.0,,-513861466.04000056,.
409000438620',2018-08-17,CB822515447805/RMCPL19298/1,,2018-08-17,2000.0,,-513863466.04000056,.
409000438620',2018-08-17,CB822511371870/RMCPL15382/1,,2018-08-17,1000.0,,-513864466.04000056,.
409000438620',2018-08-17,CB822516467483/RMCPL23184/1,,2018-08-17,500.0,,-513864966.04000056,.
409000438620',2018-08-17,CB822512394146/RMCPL24427/1,,2018-08-17,1000.0,,-513865966.04000056,.
409000438620',2018-08-17,CB822512405848/RMCPL18216/1,,2018-08-17,1200.0,,-513867166.04000056,.
409000438620',2018-08-17,CB822512399903/RMCPL11814/1,,2018-08-17,1500.0,,-513868666.04000056,.
409000438620',2018-08-17,CB822510359049/RMCPL16119/1,,2018-08-17,3000.0,,-513871666.04000056,.
409000438620',2018-08-17,CB822512394080/RMCPL20722/1,,2018-08-17,5000.0,,-513876666.04000056,.
409000438620',2018-08-17,CB822512394141/RMCPL19441/1,,2018-08-17,1500.0,,-513878166.04000056,.
409000438620',2018-08-17,CB822512394147/RMCPL14558/1,,2018-08-17,500.0,,-513878666.04000056,.
409000438620',2018-08-17,CB822515447523/RMCPL21533/1,,2018-08-17,6000.0,,-513884666.04000056,.
409000438620',2018-08-17,CB822510365473/RMCPL20874/1,,2018-08-17,4000.0,,-513888666.04000056,.
409000438620',2018-08-17,CB822515444448/RMCPL24591/1,,2018-08-17,3000.0,,-513891666.04000056,.
409000438620',2018-08-17,CB822517472729/RMCPL20482/1,,2018-08-17,2500.0,,-513894166.04000056,.
409000438620',2018-08-17,CB822312942465/RMCPL20088/1,,2018-08-17,1000.0,,-513895166.04000056,.
409000438620',2018-08-17,CB822309894665/RMCPL18974/1,,2018-08-17,10000.0,,-513905166.04000056,.
409000438620',2018-08-17,CB822312942476/RMCPL11794/1,,2018-08-17,1000.0,,-513906166.04000056,.
409000438620',2018-08-17,CB822309894013/RMCPL11405/1,,2018-08-17,700.0,,-513906866.04000056,.
409000438620',2018-08-17,CB822311918510/RMCPL20937/1,,2018-08-17,500.0,,-513907366.04000056,.
409000438620',2018-08-17,CB822310908796/RMCPL25186/1,,2018-08-17,1700.0,,-513909066.04000056,.
409000438620',2018-08-17,CB822313954638/RMCPL26215/1,,2018-08-17,1000.0,,-513910066.04000056,.
409000438620',2018-08-17,CB822317009929/RMCPL13501/1,,2018-08-17,10000.0,,-513920066.04000056,.
409000438620',2018-08-17,CB822212702779/RMCPL23821/1,,2018-08-17,1000.0,,-513921066.04000056,.
409000438620',2018-08-17,CB822215750398/RMCPL18216/1,,2018-08-17,2000.0,,-513923066.04000056,.
409000438620',2018-08-17,CB822213722595/RMCPL20827/1,,2018-08-17,7000.0,,-513930066.04000056,.
409000438620',2018-08-17,CB822213722612/RMCPL21336/1,,2018-08-17,1500.0,,-513931566.04000056,.
409000438620',2018-08-17,CB822217774856/RMCPL22130/1,,2018-08-17,4500.0,,-513936066.04000056,.
409000438620',2018-08-17,CB822218797405/RMCPL19474/1,,2018-08-17,1000.0,,-513937066.04000056,.
409000438620',2018-08-17,CB822208642955/RMCPL17405/1,,2018-08-17,10000.0,,-513947066.04000056,.
409000438620',2018-08-17,CB822212701654/RMCPL26560/1,,2018-08-17,2000.0,,-513949066.04000056,.
409000438620',2018-08-17,CB822212701720/RMCPL09588/1,,2018-08-17,8000.0,,-513957066.04000056,.
409000438620',2018-08-17,CB822217769366/RMCPL18216/1,,2018-08-17,700.0,,-513957766.04000056,.
409000438620',2018-08-17,CB822217769348/RMCPL17454/1,,2018-08-17,500.0,,-513958266.04000056,.
409000438620',2018-08-17,CB822213716841/RMCPL25243/1,,2018-08-17,4000.0,,-513962266.04000056,.
409000438620',2018-08-17,MAW/502964XXXXXX5674/Karu,,2018-08-17,,1700.0,-513960566.04000056,.
409000438620',2018-08-17,AEPS INCOME DT 16-08-2018,,2018-08-17,,37085.29,-513923480.75000054,.
409000438620',2018-08-17,AEPS GST INC DT 16-08-201,,2018-08-17,,7417.06,-513916063.69000053,.
409000438620',2018-08-17,AEPS ACQUIRING ADJ FEES 1,,2018-08-17,5.9,,-513916069.5900005,.
409000438620',2018-08-17,AEPS ACQ CR ADJ FEES 1608,,2018-08-17,478.49,,-513916548.0800005,.
409000438620',2018-08-17,AEPS ACQ REP ADJ FEES 160,,2018-08-17,,11.8,-513916536.2800005,.
409000438620',2018-08-17,TRF TO  Indiaforensic SERVICES I,,2018-08-17,14600000.0,,-528516536.2800005,.
409000438620',2018-08-18,MAW/502964XXXXXX6125/Karu,,2018-08-18,,1700.0,-528514836.2800005,.
409000438620',2018-08-18,Indiaforensic AEPS NPCI WDL SET,,2018-08-18,,13022400.0,-515492436.2800005,.
409000438620',2018-08-18,MAW/502964XXXXXX8595/NAGA,,2018-08-18,,200.0,-515492236.2800005,.
409000438620',2018-08-18,TRF TO  Indiaforensic SERVICES I,,2018-08-18,3000000.0,,-518492236.2800005,.
409000438620',2018-08-18,TRF TO  Indiaforensic SERVICES I,,2018-08-18,10000000.0,,-528492236.2800005,.
409000438620',2018-08-18,MAW/502964XXXXXX7770/Karu,,2018-08-18,,1700.0,-528490536.2800005,.
409000438620',2018-08-18,MAW/502964XXXXXX8073/Pand,,2018-08-18,,2000.0,-528488536.2800005,.
409000438620',2018-08-18,MAW/502964XXXXXX8303/Karu,,2018-08-18,,1700.0,-528486836.2800005,.
409000438620',2018-08-18,MAW/502964XXXXXX4638/Karu,,2018-08-18,,1700.0,-528485136.2800005,.
409000438620',2018-08-18,MAW/502964XXXXXX9077/Karu,,2018-08-18,,1700.0,-528483436.2800005,.
409000438620',2018-08-18,MAW/502964XXXXXX6224/Karu,,2018-08-18,,1700.0,-528481736.2800005,.
409000438620',2018-08-18,MAW/502964XXXXXX7020/Karu,,2018-08-18,,1700.0,-528480036.2800005,.
409000438620',2018-08-18,MAW/502964XXXXXX9036/Karu,,2018-08-18,,1700.0,-528478336.2800005,.
409000438620',2018-08-18,MAW/502964XXXXXX7358/Karu,,2018-08-18,,1700.0,-528476636.2800005,.
409000438620',2018-08-18,AEPS INCOME DT 17-08-2018,,2018-08-18,,32685.84,-528443950.44000053,.
409000438620',2018-08-18,AEPS GST INC DT 17-08-201,,2018-08-18,,6537.17,-528437413.2700005,.
409000438620',2018-08-20,MAW/502964XXXXXX0568/Karu,,2018-08-20,,1800.0,-528435613.2700005,.
409000438620',2018-08-20,MAW/502964XXXXXX1930/NAGA,,2018-08-20,,500.0,-528435113.2700005,.
409000438620',2018-08-20,MAW/502964XXXXXX3590/Karu,,2018-08-20,,1700.0,-528433413.2700005,.
409000438620',2018-08-20,MAW/502964XXXXXX7117/Karu,,2018-08-20,,1600.0,-528431813.2700005,.
409000438620',2018-08-20,Indiaforensic AEPS NPCI WDL SET,,2018-08-20,,11543300.0,-516888513.2700005,.
409000438620',2018-08-20,Indiaforensic AEPS NPCI WDL SET,,2018-08-20,,9093300.0,-507795213.2700005,.
409000438620',2018-08-20,MAW/502964XXXXXX6016/Akol,,2018-08-20,,1200.0,-507794013.2700005,.
409000438620',2018-08-20,CR822717990279/RMCPL15035/1,,2018-08-20,500.0,,-507794513.2700005,.
409000438620',2018-08-20,CR822611659234/RMCPL19298/1,,2018-08-20,1000.0,,-507795513.2700005,.
409000438620',2018-08-20,CR822611659240/RMCPL09617/1,,2018-08-20,3000.0,,-507798513.2700005,.
409000438620',2018-08-20,CR822616737151/RMCPL19298/1,,2018-08-20,500.0,,-507799013.2700005,.
409000438620',2018-08-20,CR822608596182/RMCPL25186/1,,2018-08-20,3600.0,,-507802613.2700005,.
409000438620',2018-08-20,CR822610623049/RMCPL09735/1,,2018-08-20,500.0,,-507803113.2700005,.
409000438620',2018-08-20,CR822612669139/RMCPL22607/1,,2018-08-20,1100.0,,-507804213.2700005,.
409000438620',2018-08-20,CR822612669129/RMCPL22310/1,,2018-08-20,700.0,,-507804913.2700005,.
409000438620',2018-08-20,CR822618768834/RMCPL14511/1,,2018-08-20,4000.0,,-507808913.2700005,.
409000438620',2018-08-20,CR822618775048/RMCPL10943/1,,2018-08-20,500.0,,-507809413.2700005,.
409000438620',2018-08-20,CR822611647486/RMCPL26747/1,,2018-08-20,10000.0,,-507819413.2700005,.
409000438620',2018-08-20,CR822611647423/RMCPL12164/1,,2018-08-20,2500.0,,-507821913.2700005,.
409000438620',2018-08-20,CR822610635451/RMCPL15559/1,,2018-08-20,10000.0,,-507831913.2700005,.
409000438620',2018-08-20,CR822616737139/RMCPL25071/1,,2018-08-20,500.0,,-507832413.2700005,.
409000438620',2018-08-20,CR822617752478/RMCPL24821/1,,2018-08-20,500.0,,-507832913.2700005,.
409000438620',2018-08-20,CR822617752469/RMCPL11793/1,,2018-08-20,4000.0,,-507836913.2700005,.
409000438620',2018-08-20,CR822617752464/RMCPL14724/1,,2018-08-20,7000.0,,-507843913.2700005,.
409000438620',2018-08-20,CR822617757589/RMCPL11949/1,,2018-08-20,6500.0,,-507850413.2700005,.
409000438620',2018-08-20,CR822614709871/RMCPL11019/1,,2018-08-20,500.0,,-507850913.2700005,.
409000438620',2018-08-20,CR822614709846/RMCPL23810/1,,2018-08-20,2000.0,,-507852913.2700005,.
409000438620',2018-08-20,CR822616737134/RMCPL09409/1,,2018-08-20,3500.0,,-507856413.2700005,.
409000438620',2018-08-20,CR822616737152/RMCPL12393/1,,2018-08-20,5000.0,,-507861413.2700005,.
409000438620',2018-08-20,CR822611659248/RMCPL22022/1,,2018-08-20,1500.0,,-507862913.2700005,.
409000438620',2018-08-20,CR822717990279/RMCPL15035/1,,2018-08-20,500.0,,-507863413.2700005,.
409000438620',2018-08-20,CR822611659234/RMCPL19298/1,,2018-08-20,1000.0,,-507864413.2700005,.
409000438620',2018-08-20,CR822611659240/RMCPL09617/1,,2018-08-20,3000.0,,-507867413.2700005,.
409000438620',2018-08-20,CR822616737151/RMCPL19298/1,,2018-08-20,500.0,,-507867913.2700005,.
409000438620',2018-08-20,CR822608596182/RMCPL25186/1,,2018-08-20,3600.0,,-507871513.2700005,.
409000438620',2018-08-20,CR822610623049/RMCPL09735/1,,2018-08-20,500.0,,-507872013.2700005,.
409000438620',2018-08-20,CR822612669139/RMCPL22607/1,,2018-08-20,1100.0,,-507873113.2700005,.
409000438620',2018-08-20,CR822612669129/RMCPL22310/1,,2018-08-20,700.0,,-507873813.2700005,.
409000438620',2018-08-20,CR822618768834/RMCPL14511/1,,2018-08-20,4000.0,,-507877813.2700005,.
409000438620',2018-08-20,CR822618775048/RMCPL10943/1,,2018-08-20,500.0,,-507878313.2700005,.
409000438620',2018-08-20,CR822611647486/RMCPL26747/1,,2018-08-20,10000.0,,-507888313.2700005,.
409000438620',2018-08-20,CR822611647423/RMCPL12164/1,,2018-08-20,2500.0,,-507890813.2700005,.
409000438620',2018-08-20,CR822610635451/RMCPL15559/1,,2018-08-20,10000.0,,-507900813.2700005,.
409000438620',2018-08-20,CR822616737139/RMCPL25071/1,,2018-08-20,500.0,,-507901313.2700005,.
409000438620',2018-08-20,CR822617752478/RMCPL24821/1,,2018-08-20,500.0,,-507901813.2700005,.
409000438620',2018-08-20,CR822617752469/RMCPL11793/1,,2018-08-20,4000.0,,-507905813.2700005,.
409000438620',2018-08-20,CR822617752464/RMCPL14724/1,,2018-08-20,7000.0,,-507912813.2700005,.
409000438620',2018-08-20,CR822617757589/RMCPL11949/1,,2018-08-20,6500.0,,-507919313.2700005,.
409000438620',2018-08-20,CR822614709871/RMCPL11019/1,,2018-08-20,500.0,,-507919813.2700005,.
409000438620',2018-08-20,CR822614709846/RMCPL23810/1,,2018-08-20,2000.0,,-507921813.2700005,.
409000438620',2018-08-20,CR822616737134/RMCPL09409/1,,2018-08-20,3500.0,,-507925313.2700005,.
409000438620',2018-08-20,CR822616737152/RMCPL12393/1,,2018-08-20,5000.0,,-507930313.2700005,.
409000438620',2018-08-20,CR822611659248/RMCPL22022/1,,2018-08-20,1500.0,,-507931813.2700005,.
409000438620',2018-08-20,TRF TO  Indiaforensic SERVICES I,,2018-08-20,14800000.0,,-522731813.2700005,.
409000438620',2018-08-20,TRF TO  Indiaforensic SERVICES I,,2018-08-20,5800000.0,,-528531813.2700005,.
409000438620',2018-08-20,CR822717990279/RMCPL15035/1,,2018-08-20,,500.0,-528531313.2700005,.
409000438620',2018-08-20,CR822611659234/RMCPL19298/1,,2018-08-20,,1000.0,-528530313.2700005,.
409000438620',2018-08-20,CR822611659240/RMCPL09617/1,,2018-08-20,,3000.0,-528527313.2700005,.
409000438620',2018-08-20,CR822616737151/RMCPL19298/1,,2018-08-20,,500.0,-528526813.2700005,.
409000438620',2018-08-20,CR822608596182/RMCPL25186/1,,2018-08-20,,3600.0,-528523213.2700005,.
409000438620',2018-08-20,CR822610623049/RMCPL09735/1,,2018-08-20,,500.0,-528522713.2700005,.
409000438620',2018-08-20,CR822612669139/RMCPL22607/1,,2018-08-20,,1100.0,-528521613.2700005,.
409000438620',2018-08-20,CR822612669129/RMCPL22310/1,,2018-08-20,,700.0,-528520913.2700005,.
409000438620',2018-08-20,CR822618768834/RMCPL14511/1,,2018-08-20,,4000.0,-528516913.2700005,.
409000438620',2018-08-20,CR822618775048/RMCPL10943/1,,2018-08-20,,500.0,-528516413.2700005,.
409000438620',2018-08-20,CR822611647486/RMCPL26747/1,,2018-08-20,,10000.0,-528506413.2700005,.
409000438620',2018-08-20,CR822611647423/RMCPL12164/1,,2018-08-20,,2500.0,-528503913.2700005,.
409000438620',2018-08-20,CR822610635451/RMCPL15559/1,,2018-08-20,,10000.0,-528493913.2700005,.
409000438620',2018-08-20,CR822616737139/RMCPL25071/1,,2018-08-20,,500.0,-528493413.2700005,.
409000438620',2018-08-20,CR822617752478/RMCPL24821/1,,2018-08-20,,500.0,-528492913.2700005,.
409000438620',2018-08-20,CR822617752469/RMCPL11793/1,,2018-08-20,,4000.0,-528488913.2700005,.
409000438620',2018-08-20,CR822617752464/RMCPL14724/1,,2018-08-20,,7000.0,-528481913.2700005,.
409000438620',2018-08-20,CR822617757589/RMCPL11949/1,,2018-08-20,,6500.0,-528475413.2700005,.
409000438620',2018-08-20,CR822614709871/RMCPL11019/1,,2018-08-20,,500.0,-528474913.2700005,.
409000438620',2018-08-20,CR822614709846/RMCPL23810/1,,2018-08-20,,2000.0,-528472913.2700005,.
409000438620',2018-08-20,CR822616737134/RMCPL09409/1,,2018-08-20,,3500.0,-528469413.2700005,.
409000438620',2018-08-20,CR822616737152/RMCPL12393/1,,2018-08-20,,5000.0,-528464413.2700005,.
409000438620',2018-08-20,CR822611659248/RMCPL22022/1,,2018-08-20,,1500.0,-528462913.2700005,.
409000438620',2018-08-20,AEPS INCOME DT 18-08-2018,,2018-08-20,,29995.1,-528432918.1700005,.
409000438620',2018-08-20,AEPS GST INC DT 18-08-201,,2018-08-20,,5999.02,-528426919.1500005,.
409000438620',2018-08-20,AEPS INCOME DT 19-18-2018,,2018-08-20,,24515.78,-528402403.37000054,.
409000438620',2018-08-20,AEPS GST INC DT 19-18-201,,2018-08-20,,4903.16,-528397500.2100005,.
409000438620',2018-08-20,AEPS ACQ CR ADJ FEES 1808,,2018-08-20,249.57,,-528397749.7800005,.
409000438620',2018-08-20,AEPS ACQ REP ADJ FEES 180,,2018-08-20,,26.55,-528397723.2300005,.
409000438620',2018-08-20,AEPS PAY SPICE DIGITAL 18,,2018-08-20,,298.93,-528397424.3000005,.
409000438620',2018-08-20,AEPS PAY SPICE DIGITAL 19,,2018-08-20,,848.31,-528396575.9900005,.
409000438620',2018-08-21,MAW/502964XXXXXX3522/NAGA,,2018-08-21,,900.0,-528395675.9900005,.
409000438620',2018-08-21,MAW/502964XXXXXX0634/Karu,,2018-08-21,,1700.0,-528393975.9900005,.
409000438620',2018-08-21,MAW/502964XXXXXX3506/NAGA,,2018-08-21,,800.0,-528393175.9900005,.
409000438620',2018-08-21,MAW/502964XXXXXX7840/Karu,,2018-08-21,,1700.0,-528391475.9900005,.
409000438620',2018-08-21,MAW/502964XXXXXX2000/Karu,,2018-08-21,,1700.0,-528389775.9900005,.
409000438620',2018-08-21,MAW/502964XXXXXX6125/Karu,,2018-08-21,,1700.0,-528388075.9900005,.
409000438620',2018-08-21,CB822218790836/RMCPL21107/1,,2018-08-21,9400.0,,-528397475.9900005,.
409000438620',2018-08-21,Indiaforensic AEPS NPCI WDL SET,,2018-08-21,,9962200.0,-518435275.9900005,.
409000438620',2018-08-21,CR822909383503/RMCPL02155/1,,2018-08-21,3000.0,,-518438275.9900005,.
409000438620',2018-08-21,CR822912440795/RMCPL19348/1,,2018-08-21,2500.0,,-518440775.9900005,.
409000438620',2018-08-21,CR822917495069/RMCPL22133/1,,2018-08-21,1500.0,,-518442275.9900005,.
409000438620',2018-08-21,CR822914468844/RMCPL13026/1,,2018-08-21,4000.0,,-518446275.9900005,.
409000438620',2018-08-21,CR822909375712/RMCPL17229/1,,2018-08-21,500.0,,-518446775.9900005,.
409000438620',2018-08-21,CR822910390579/RMCPL21549/1,,2018-08-21,4000.0,,-518450775.9900005,.
409000438620',2018-08-21,TRF TO  Indiaforensic SERVICES I,,2018-08-21,10000000.0,,-528450775.9900005,.
409000438620',2018-08-21,MAW/502964XXXXXX0234/Karu,,2018-08-21,,1700.0,-528449075.9900005,.
409000438620',2018-08-21,MAW/502964XXXXXX5164/Karu,,2018-08-21,,1700.0,-528447375.9900005,.
409000438620',2018-08-21,MAW/502964XXXXXX6255/Karu,,2018-08-21,,1900.0,-528445475.9900005,.
409000438620',2018-08-21,AEPS PAY Indiaforensic 2008,,2018-08-21,,408.57,-528445067.4200005,.
409000438620',2018-08-21,AEPS INCOME DT 20-08-2018,,2018-08-21,,25884.34,-528419183.0800005,.
409000438620',2018-08-21,AEPS GST INC DT 20-08-201,,2018-08-21,,5176.87,-528414006.2100005,.
409000438620',2018-08-21,AEPS ACQUIRING ADJ FEES 2,,2018-08-21,17.7,,-528414023.9100005,.
409000438620',2018-08-21,AEPS ACQ CR ADJ FEES 2008,,2018-08-21,79.65,,-528414103.5600005,.
409000438620',2018-08-21,TRF TO  Indiaforensic SERVICES I,,2018-08-21,200000.0,,-528614103.5600005,.
409000438620',2018-08-23,Indiaforensic AEPS NPCI WDL SET,,2018-08-23,,14982100.0,-513632003.5600005,.
409000438620',2018-08-23,TRF TO  Indiaforensic SERVICES I,,2018-08-23,15000000.0,,-528632003.5600005,.
409000438620',2018-08-23,Indiaforensic AEPS NPCI WDL SET,,2018-08-23,,8678400.0,-519953603.5600005,.
409000438620',2018-08-23,MAW/502964XXXXXX1906/NAGA,,2018-08-23,,600.0,-519953003.5600005,.
409000438620',2018-08-23,NPCI SETELEMENT DIFF_2208,,2018-08-23,,500.0,-519952503.5600005,.
409000438620',2018-08-23,NPCI SETELEMENT DIFF_2108,,2018-08-23,,500.0,-519952003.5600005,.
409000438620',2018-08-23,TRF TO  Indiaforensic SERVICES I,,2018-08-23,8700000.0,,-528652003.5600005,.
409000438620',2018-08-23,AEPS PAY Indiaforensic 2108,,2018-08-23,,897.99,-528651105.57000047,.
409000438620',2018-08-23,AEPS PAY Indiaforensic 2208,,2018-08-23,,697.82,-528650407.7500005,.
409000438620',2018-08-23,MICRO ATM WDL FEE DATED 2,,2018-08-23,,5600.0,-528644807.7500005,.
409000438620',2018-08-23,AEPS ACQUIRING ADJ FEES 2,,2018-08-23,23.01,,-528644830.76000047,.
409000438620',2018-08-23,AEPS INCOME DT 21-08-2018,,2018-08-23,,39138.53,-528605692.2300005,.
409000438620',2018-08-23,AEPS GST INC DT 21-08-201,,2018-08-23,,7827.71,-528597864.5200005,.
409000438620',2018-08-23,AEPS INCOME DT 22-08-2018,,2018-08-23,,22739.0,-528575125.5200005,.
409000438620',2018-08-23,AEPS GST INC DT 22-08-201,,2018-08-23,,4547.8,-528570577.7200005,.
409000438620',2018-08-23,MICRO ATM WDL FEE DATED 2,,2018-08-23,,39300.0,-528531277.7200005,.
409000438620',2018-08-23,MICRO ATM WDL FEE DATED 2,,2018-08-23,,8500.0,-528522777.7200005,.
409000438620',2018-08-23,NFS MICRO ATM INC DATED 2,,2018-08-23,,20.16,-528522757.5600005,.
409000438620',2018-08-23,NFS MICRO ATM GST DATED 2,,2018-08-23,,4.03,-528522753.5300005,.
409000438620',2018-08-23,NFS MICRO ATM INC DATED 2,,2018-08-23,,30.6,-528522722.9300005,.
409000438620',2018-08-23,NFS MICRO ATM GST DATED 2,,2018-08-23,,6.12,-528522716.8100005,.
409000438620',2018-08-24,Indiaforensic AEPS NPCI WDL SET,,2018-08-24,,11450800.0,-517071916.8100005,.
409000438620',2018-08-24,MAW/502964XXXXXX9780/Karu,,2018-08-24,,1700.0,-517070216.8100005,.
409000438620',2018-08-24,TRF TO  Indiaforensic SERVICES I,,2018-08-24,11500000.0,,-528570216.8100005,.
409000438620',2018-08-24,MICRO ATM WDL FEE DATED 2,,2018-08-24,,35200.0,-528535016.8100005,.
409000438620',2018-08-24,AEPS PAY Indiaforensic 2308,,2018-08-24,,199.29,-528534817.52000046,.
409000438620',2018-08-24,MICRO ATM WDL FEE DATED 2,,2018-08-24,,42200.0,-528492617.52000046,.
409000438620',2018-08-24,AEPS INCOME DT 23-08-2018,,2018-08-24,,29882.63,-528462734.89000046,.
409000438620',2018-08-24,AEPS GST INC DT 23-08-201,,2018-08-24,,5976.53,-528456758.3600005,.
409000438620',2018-08-24,AEPS ACQ REP ADJ FEES 230,,2018-08-24,,17.7,-528456740.6600005,.
409000438620',2018-08-24,NFS MICRO ATM INC DT 2308,,2018-08-24,,123.48,-528456617.1800005,.
409000438620',2018-08-24,NFS MICRO ATM GST DT 2308,,2018-08-24,,24.7,-528456592.4800005,.
409000438620',2018-08-24,NFS MICRO ATM INC DT 2308,,2018-08-24,,72.0,-528456520.4800005,.
409000438620',2018-08-24,NFS MICRO ATM GST DT 2308,,2018-08-24,,14.4,-528456506.0800005,.
409000438620',2018-08-24,NFS MICRO ATM INC DT 2408,,2018-08-24,,94.32,-528456411.7600005,.
409000438620',2018-08-24,NFS MICRO ATM GST DT 2408,,2018-08-24,,18.87,-528456392.8900005,.
409000438620',2018-08-25,MAW/502964XXXXXX0102/Vals,,2018-08-25,,500.0,-528455892.8900005,.
409000438620',2018-08-27,MAW/502964XXXXXX2319/Karu,,2018-08-27,,1600.0,-528454292.8900005,.
409000438620',2018-08-27,MAW/502964XXXXXX7609/Karu,,2018-08-27,,1600.0,-528452692.8900005,.
409000438620',2018-08-27,MAW/502964XXXXXX2685/Karu,,2018-08-27,,1600.0,-528451092.8900005,.
409000438620',2018-08-27,MAW/502964XXXXXX1369/Karu,,2018-08-27,,1700.0,-528449392.8900005,.
409000438620',2018-08-27,Indiaforensic AEPS NPCI WDL SET,,2018-08-27,,12078100.0,-516371292.8900005,.
409000438620',2018-08-27,CR823409642388/RMCPL25604/2,,2018-08-27,1200.0,,-516372492.8900005,.
409000438620',2018-08-27,CR823409642385/RMCPL24364/2,,2018-08-27,1100.0,,-516373592.8900005,.
409000438620',2018-08-27,CR823410651153/RMCPL21169/2,,2018-08-27,2100.0,,-516375692.8900005,.
409000438620',2018-08-27,CR823410651170/RMCPL12251/2,,2018-08-27,1000.0,,-516376692.8900005,.
409000438620',2018-08-27,CR823412689161/RMCPL19555/2,,2018-08-27,1000.0,,-516377692.8900005,.
409000438620',2018-08-27,CR823311376480/RMCPL11592/2,,2018-08-27,2000.0,,-516379692.8900005,.
409000438620',2018-08-27,CR823309325597/RMCPL19474/2,,2018-08-27,1100.0,,-516380792.8900005,.
409000438620',2018-08-27,CR823309325596/RMCPL25038/2,,2018-08-27,1800.0,,-516382592.8900005,.
409000438620',2018-08-27,CR823309325690/RMCPL19515/2,,2018-08-27,3000.0,,-516385592.8900005,.
409000438620',2018-08-27,CR823310359043/RMCPL09585/2,,2018-08-27,1500.0,,-516387092.8900005,.
409000438620',2018-08-27,CR823308318429/RMCPL12739/2,,2018-08-27,2500.0,,-516389592.8900005,.
409000438620',2018-08-27,CR823308323007/RMCPL26809/2,,2018-08-27,10000.0,,-516399592.8900005,.
409000438620',2018-08-27,CR823308318968/RMCPL19369/2,,2018-08-27,1000.0,,-516400592.8900005,.
409000438620',2018-08-27,CR823308318958/RMCPL13536/2,,2018-08-27,2000.0,,-516402592.8900005,.
409000438620',2018-08-27,CR823308319000/RMCPL26845/2,,2018-08-27,2000.0,,-516404592.8900005,.
409000438620',2018-08-27,CR823308319008/RMCPL23562/2,,2018-08-27,3000.0,,-516407592.8900005,.
409000438620',2018-08-27,CR823308319794/RMCPL24786/2,,2018-08-27,3700.0,,-516411292.8900005,.
409000438620',2018-08-27,CR823314437810/RMCPL13369/2,,2018-08-27,4000.0,,-516415292.8900005,.
409000438620',2018-08-27,CR823315447904/RMCPL20307/2,,2018-08-27,1000.0,,-516416292.8900005,.
409000438620',2018-08-27,CR823316461664/RMCPL19369/2,,2018-08-27,2000.0,,-516418292.8900005,.
409000438620',2018-08-27,CR823316461689/RMCPL19701/2,,2018-08-27,2000.0,,-516420292.8900005,.
409000438620',2018-08-27,CR823316461684/RMCPL19173/2,,2018-08-27,1000.0,,-516421292.8900005,.
409000438620',2018-08-27,CR823316457185/RMCPL11793/2,,2018-08-27,2000.0,,-516423292.8900005,.
409000438620',2018-08-27,CR823311381415/RMCPL25987/2,,2018-08-27,4000.0,,-516427292.8900005,.
409000438620',2018-08-27,CR823312385910/RMCPL16968/2,,2018-08-27,1000.0,,-516428292.8900005,.
409000438620',2018-08-27,CR823309334001/RMCPL14751/2,,2018-08-27,2600.0,,-516430892.8900005,.
409000438620',2018-08-27,CR823309334004/RMCPL11996/2,,2018-08-27,4500.0,,-516435392.8900005,.
409000438620',2018-08-27,CR823309333984/RMCPL25311/2,,2018-08-27,1000.0,,-516436392.8900005,.
409000438620',2018-08-27,CR823311381404/RMCPL25390/2,,2018-08-27,1000.0,,-516437392.8900005,.
409000438620',2018-08-27,CR823308318191/RMCPL19793/2,,2018-08-27,1300.0,,-516438692.8900005,.
409000438620',2018-08-27,CR823308322948/RMCPL19369/2,,2018-08-27,500.0,,-516439192.8900005,.
409000438620',2018-08-27,CR823308323045/RMCPL20893/2,,2018-08-27,500.0,,-516439692.8900005,.
409000438620',2018-08-27,CR823308322995/RMCPL23967/2,,2018-08-27,5000.0,,-516444692.8900005,.
409000438620',2018-08-27,CR823309333995/RMCPL03220/2,,2018-08-27,500.0,,-516445192.8900005,.
409000438620',2018-08-27,CR823312385923/RMCPL19782/2,,2018-08-27,4000.0,,-516449192.8900005,.
409000438620',2018-08-27,CR823309326745/RMCPL19181/2,,2018-08-27,3500.0,,-516452692.8900005,.
409000438620',2018-08-27,CR823310352252/RMCPL20736/2,,2018-08-27,500.0,,-516453192.8900005,.
409000438620',2018-08-27,CR823309325692/RMCPL25397/2,,2018-08-27,1200.0,,-516454392.8900005,.
409000438620',2018-08-27,CR823309326134/RMCPL13888/2,,2018-08-27,500.0,,-516454892.8900005,.
409000438620',2018-08-27,CR823309326281/RMCPL25346/2,,2018-08-27,1400.0,,-516456292.8900005,.
409000438620',2018-08-27,CR823309326275/RMCPL15524/2,,2018-08-27,1000.0,,-516457292.8900005,.
409000438620',2018-08-27,CR823309326266/RMCPL22856/2,,2018-08-27,1000.0,,-516458292.8900005,.
409000438620',2018-08-27,CR823309326576/RMCPL26695/2,,2018-08-27,2000.0,,-516460292.8900005,.
409000438620',2018-08-27,CR823309326378/RMCPL22264/2,,2018-08-27,7200.0,,-516467492.8900005,.
409000438620',2018-08-27,CR823309326747/RMCPL15326/2,,2018-08-27,2000.0,,-516469492.8900005,.
409000438620',2018-08-27,CR823308316722/RMCPL12739/2,,2018-08-27,2000.0,,-516471492.8900005,.
409000438620',2018-08-27,CR823308316700/RMCPL12805/2,,2018-08-27,700.0,,-516472192.8900005,.
409000438620',2018-08-27,CR823308316658/RMCPL21855/2,,2018-08-27,1500.0,,-516473692.8900005,.
409000438620',2018-08-27,CR823315447901/RMCPL09617/2,,2018-08-27,1000.0,,-516474692.8900005,.
409000438620',2018-08-27,Indiaforensic AEPS NPCI WDL SET,,2018-08-27,,12473800.0,-504000892.8900005,.
409000438620',2018-08-27,Indiaforensic AEPS NPCI WDL SET,,2018-08-27,,4943400.0,-499057492.8900005,.
409000438620',2018-08-27,MAW/502964XXXXXX7609/Karu,,2018-08-27,,1400.0,-499056092.8900005,.
409000438620',2018-08-27,CR822815216318/RMCPL25821/1,,2018-08-27,7000.0,,-499063092.8900005,.
409000438620',2018-08-27,CR822815216308/RMCPL23584/1,,2018-08-27,3300.0,,-499066392.8900005,.
409000438620',2018-08-27,CR822811159473/RMCPL16917/1,,2018-08-27,1500.0,,-499067892.8900005,.
409000438620',2018-08-27,CR822816227899/RMCPL24804/1,,2018-08-27,1000.0,,-499068892.8900005,.
409000438620',2018-08-27,CR822814203586/RMCPL11949/1,,2018-08-27,500.0,,-499069392.8900005,.
409000438620',2018-08-27,CR822814203599/RMCPL25729/1,,2018-08-27,4000.0,,-499073392.8900005,.
409000438620',2018-08-27,CR822816238878/RMCPL09506/1,,2018-08-27,2000.0,,-499075392.8900005,.
409000438620',2018-08-27,CR822812165398/RMCPL16204/1,,2018-08-27,1500.0,,-499076892.8900005,.
409000438620',2018-08-27,CR822811146697/RMCPL24578/1,,2018-08-27,5000.0,,-499081892.8900005,.
409000438620',2018-08-27,CR822811157886/RMCPL24427/1,,2018-08-27,3000.0,,-499084892.8900005,.
409000438620',2018-08-27,CR822809111076/RMCPL18789/1,,2018-08-27,3000.0,,-499087892.8900005,.
409000438620',2018-08-27,CR822811156558/RMCPL11794/1,,2018-08-27,500.0,,-499088392.8900005,.
409000438620',2018-08-27,CR822809111058/RMCPL17831/1,,2018-08-27,2100.0,,-499090492.8900005,.
409000438620',2018-08-27,CR822814196766/RMCPL26141/1,,2018-08-27,3500.0,,-499093992.8900005,.
409000438620',2018-08-27,CR822811153304/RMCPL24790/1,,2018-08-27,500.0,,-499094492.8900005,.
409000438620',2018-08-27,CR822818263327/RMCPL13776/1,,2018-08-27,4000.0,,-499098492.8900005,.
409000438620',2018-08-27,CR822817256526/RMCPL17244/1,,2018-08-27,1000.0,,-499099492.8900005,.
409000438620',2018-08-27,CR822817256593/RMCPL19721/1,,2018-08-27,500.0,,-499099992.8900005,.
409000438620',2018-08-27,CR822816233178/RMCPL21524/1,,2018-08-27,1000.0,,-499100992.8900005,.
409000438620',2018-08-27,CR822816233200/RMCPL20772/1,,2018-08-27,1300.0,,-499102292.8900005,.
409000438620',2018-08-27,CR823117951432/RMCPL20463/1,,2018-08-27,4000.0,,-499106292.8900005,.
409000438620',2018-08-27,CR823116945787/RMCPL12343/1,,2018-08-27,700.0,,-499106992.8900005,.
409000438620',2018-08-27,CR823012674488/RMCPL11486/1,,2018-08-27,500.0,,-499107492.8900005,.
409000438620',2018-08-27,CR823017747230/RMCPL11131/1,,2018-08-27,4000.0,,-499111492.8900005,.
409000438620',2018-08-27,CR823017747237/RMCPL26650/1,,2018-08-27,2000.0,,-499113492.8900005,.
409000438620',2018-08-27,CR823010630488/RMCPL24692/1,,2018-08-27,2000.0,,-499115492.8900005,.
409000438620',2018-08-27,CR823010638304/RMCPL23164/1,,2018-08-27,3000.0,,-499118492.8900005,.
409000438620',2018-08-27,CR823010638281/RMCPL18267/1,,2018-08-27,2000.0,,-499120492.8900005,.
409000438620',2018-08-27,CR823011648086/RMCPL18789/1,,2018-08-27,2000.0,,-499122492.8900005,.
409000438620',2018-08-27,CR823010638227/RMCPL22367/1,,2018-08-27,10000.0,,-499132492.8900005,.
409000438620',2018-08-27,CR823010637801/RMCPL22700/1,,2018-08-27,500.0,,-499132992.8900005,.
409000438620',2018-08-27,CR823010638344/RMCPL23721/1,,2018-08-27,1000.0,,-499133992.8900005,.
409000438620',2018-08-27,CR823013685701/RMCPL23228/1,,2018-08-27,1000.0,,-499134992.8900005,.
409000438620',2018-08-27,CR823011652425/RMCPL23888/1,,2018-08-27,3000.0,,-499137992.8900005,.
409000438620',2018-08-27,CR823016727908/RMCPL18519/1,,2018-08-27,500.0,,-499138492.8900005,.
409000438620',2018-08-27,CR823017742300/RMCPL21990/1,,2018-08-27,1800.0,,-499140292.8900005,.
409000438620',2018-08-27,CR823010638095/RMCPL26384/1,,2018-08-27,1000.0,,-499141292.8900005,.
409000438620',2018-08-27,CR823010630973/RMCPL19631/1,,2018-08-27,2000.0,,-499143292.8900005,.
409000438620',2018-08-27,CR823010630974/RMCPL21463/1,,2018-08-27,10000.0,,-499153292.8900005,.
409000438620',2018-08-27,CR823017742304/RMCPL21565/1,,2018-08-27,500.0,,-499153792.8900005,.
409000438620',2018-08-27,CR823017742293/RMCPL16407/1,,2018-08-27,700.0,,-499154492.8900005,.
409000438620',2018-08-27,CR823012680055/RMCPL15580/1,,2018-08-27,500.0,,-499154992.8900005,.
409000438620',2018-08-27,CR823010638065/RMCPL11699/1,,2018-08-27,2000.0,,-499156992.8900005,.
409000438620',2018-08-27,CR823010638049/RMCPL18488/1,,2018-08-27,1000.0,,-499157992.8900005,.
409000438620',2018-08-27,CR823010642191/RMCPL11019/1,,2018-08-27,6000.0,,-499163992.8900005,.
409000438620',2018-08-27,CR823011652432/RMCPL11945/1,,2018-08-27,5000.0,,-499168992.8900005,.
409000438620',2018-08-27,CR823010637808/RMCPL20773/1,,2018-08-27,1800.0,,-499170792.8900005,.
409000438620',2018-08-27,CR823010638345/RMCPL21282/1,,2018-08-27,7500.0,,-499178292.8900005,.
409000438620',2018-08-27,CR823010638030/RMCPL16917/1,,2018-08-27,500.0,,-499178792.8900005,.
409000438620',2018-08-27,CR823012674482/RMCPL14483/1,,2018-08-27,1000.0,,-499179792.8900005,.
409000438620',2018-08-27,CR823010642217/RMCPL24648/1,,2018-08-27,1000.0,,-499180792.8900005,.
409000438620',2018-08-27,CR823010638186/RMCPL14751/1,,2018-08-27,10000.0,,-499190792.8900005,.
409000438620',2018-08-27,CR823010638026/RMCPL21990/1,,2018-08-27,1800.0,,-499192592.8900005,.
409000438620',2018-08-27,CR823010637709/RMCPL13166/1,,2018-08-27,2000.0,,-499194592.8900005,.
409000438620',2018-08-27,CR823010638308/RMCPL13166/1,,2018-08-27,2000.0,,-499196592.8900005,.
409000438620',2018-08-27,CR823011652455/RMCPL24195/1,,2018-08-27,3500.0,,-499200092.8900005,.
409000438620',2018-08-27,CR823010642203/RMCPL18519/1,,2018-08-27,1900.0,,-499201992.8900005,.
409000438620',2018-08-27,CR823010642261/RMCPL25247/1,,2018-08-27,5000.0,,-499206992.8900005,.
409000438620',2018-08-27,CR823011652418/RMCPL24066/1,,2018-08-27,10000.0,,-499216992.8900005,.
409000438620',2018-08-27,CR823010637948/RMCPL09590/1,,2018-08-27,10000.0,,-499226992.8900005,.
409000438620',2018-08-27,CR823210073323/RMCPL22022/2,,2018-08-27,1500.0,,-499228492.8900005,.
409000438620',2018-08-27,CR823209066681/RMCPL13619/2,,2018-08-27,4000.0,,-499232492.8900005,.
409000438620',2018-08-27,CR823214141177/RMCPL11523/2,,2018-08-27,3000.0,,-499235492.8900005,.
409000438620',2018-08-27,CR823214152456/RMCPL18519/2,,2018-08-27,3000.0,,-499238492.8900005,.
409000438620',2018-08-27,CR823214146448/RMCPL20628/2,,2018-08-27,1000.0,,-499239492.8900005,.
409000438620',2018-08-27,CR823210068009/RMCPL24151/2,,2018-08-27,2000.0,,-499241492.8900005,.
409000438620',2018-08-27,CR823214141190/RMCPL27346/2,,2018-08-27,5000.0,,-499246492.8900005,.
409000438620',2018-08-27,CR823211101146/RMCPL22022/2,,2018-08-27,1500.0,,-499247992.8900005,.
409000438620',2018-08-27,CR823211105901/RMCPL15391/2,,2018-08-27,500.0,,-499248492.8900005,.
409000438620',2018-08-27,CR823209060071/RMCPL23895/2,,2018-08-27,1000.0,,-499249492.8900005,.
409000438620',2018-08-27,CR823209066686/RMCPL22581/2,,2018-08-27,1200.0,,-499250692.8900005,.
409000438620',2018-08-27,CR823212120375/RMCPL14786/2,,2018-08-27,500.0,,-499251192.8900005,.
409000438620',2018-08-27,CR823211105889/RMCPL18108/2,,2018-08-27,1200.0,,-499252392.8900005,.
409000438620',2018-08-27,CR823213136217/RMCPL09511/2,,2018-08-27,1000.0,,-499253392.8900005,.
409000438620',2018-08-27,CR823211096191/RMCPL17567/2,,2018-08-27,10000.0,,-499263392.8900005,.
409000438620',2018-08-27,CR823211096198/RMCPL12794/2,,2018-08-27,5000.0,,-499268392.8900005,.
409000438620',2018-08-27,CR823212106797/RMCPL15391/2,,2018-08-27,500.0,,-499268892.8900005,.
409000438620',2018-08-27,CR823211105886/RMCPL25366/2,,2018-08-27,700.0,,-499269592.8900005,.
409000438620',2018-08-27,CR822821324572/RMCPL27560/1,,2018-08-27,100.0,,-499269692.8900005,.
409000438620',2018-08-27,CR822821322998/RMCPL27560/1,,2018-08-27,100.0,,-499269792.8900005,.
409000438620',2018-08-27,CR823209060026/RMCPL19744/2,,2018-08-27,7500.0,,-499277292.8900005,.
409000438620',2018-08-27,MAW/502964XXXXXX9772/Cudd,,2018-08-27,,1000.0,-499276292.8900005,.
409000438620',2018-08-27,TRF TO  Indiaforensic SERVICES I,,2018-08-27,15000000.0,,-514276292.8900005,.
409000438620',2018-08-27,TRF TO  Indiaforensic SERVICES I,,2018-08-27,14300000.0,,-528576292.8900005,.
409000438620',2018-08-27,MAW/502964XXXXXX7575/Karu,,2018-08-27,,1700.0,-528574592.8900005,.
409000438620',2018-08-27,MICRO ATM WDL FEE DATED 2,,2018-08-27,,20700.0,-528553892.8900005,.
409000438620',2018-08-27,MICRO ATM WDL FEE DATED 2,,2018-08-27,,56700.0,-528497192.8900005,.
409000438620',2018-08-27,MICRO ATM WDL FEE DATED 2,,2018-08-27,,7000.0,-528490192.8900005,.
409000438620',2018-08-27,NFS MICRO ATM INC DT 2408,,2018-08-27,,49.32,-528490143.5700005,.
409000438620',2018-08-27,NFS MICRO ATM GST DT 2408,,2018-08-27,,9.86,-528490133.7100005,.
409000438620',2018-08-27,NFS MICRO ATM INC DT 2508,,2018-08-27,,109.8,-528490023.9100005,.
409000438620',2018-08-27,NFS MICRO ATM GST DT 2508,,2018-08-27,,21.96,-528490001.9500005,.
409000438620',2018-08-27,AEPS PAY Indiaforensic 2408,,2018-08-27,,449.0,-528489552.9500005,.
409000438620',2018-08-27,AEPS PAY Indiaforensic 2508,,2018-08-27,,298.21,-528489254.74000055,.
409000438620',2018-08-27,AEPS PAY Indiaforensic 2608,,2018-08-27,,598.73,-528488656.0100005,.
409000438620',2018-08-27,AEPS INCOME DT 24-08-2018,,2018-08-27,,32338.88,-528456317.13000053,.
409000438620',2018-08-27,AEPS GST INC DT 24-08-201,,2018-08-27,,6467.78,-528449849.35000056,.
409000438620',2018-08-27,AEPS INCOME DT 25-08-2018,,2018-08-27,,33287.46,-528416561.8900006,.
409000438620',2018-08-27,AEPS GST INC DT 25-08-201,,2018-08-27,,6657.49,-528409904.4000006,.
409000438620',2018-08-27,AEPS INCOME DT 26-08-2018,,2018-08-27,,13780.6,-528396123.80000055,.
409000438620',2018-08-27,AEPS GST INC DT 26-08-201,,2018-08-27,,2756.12,-528393367.68000054,.
409000438620',2018-08-27,AEPS ACQ CR ADJ FEES 2408,,2018-08-27,1365.22,,-528394732.9000006,.
409000438620',2018-08-27,AEPS ACQ REP ADJ FEES 240,,2018-08-27,,5.31,-528394727.59000057,.
409000438620',2018-08-27,NEFT/000048051021/SUBSID,,2018-08-27,4500.0,,-528399227.59000057,.
409000438620',2018-08-27,MICRO ATM INC DATED 27081,,2018-08-27,,18.0,-528399209.59000057,.
409000438620',2018-08-27,MICRO ATM GST DATED 27081,,2018-08-27,,3.6,-528399205.99000055,.
409000438620',2018-08-28,Indiaforensic AEPS NPCI WDL SET,,2018-08-28,,9853700.0,-518545505.99000055,.
409000438620',2018-08-28,CR823518045615/RMCPL23994/2,,2018-08-28,500.0,,-518546005.99000055,.
409000438620',2018-08-28,TRF TO  Indiaforensic SERVICES I,,2018-08-28,5000000.0,,-523546005.99000055,.
409000438620',2018-08-28,TRF TO  Indiaforensic SERVICES I,,2018-08-28,5000000.0,,-528546005.99000055,.
409000438620',2018-08-28,MICRO ATM WDL FEE DATED 2,,2018-08-28,,6100.0,-528539905.99000055,.
409000438620',2018-08-28,AEPS PAY Indiaforensic 2408,,2018-08-28,449.0,,-528540354.99000055,.
409000438620',2018-08-28,AEPS PAY Indiaforensic 2408,,2018-08-28,,539.09,-528539815.9000006,.
409000438620',2018-08-28,AEPS INCOME DT 27-08-2018,,2018-08-28,,25472.78,-528514343.1200006,.
409000438620',2018-08-28,AEPS GST INC DT 27-08-201,,2018-08-28,,5094.56,-528509248.5600006,.
409000438620',2018-08-28,AEPS ACQUIRING ADJ FEES 2,,2018-08-28,39.53,,-528509288.09000057,.
409000438620',2018-08-28,AEPS ACQ CR ADJ FEES 2708,,2018-08-28,2.95,,-528509291.04000056,.
409000438620',2018-08-28,MICRO ATM INC DATED 27081,,2018-08-28,,21.96,-528509269.0800006,.
409000438620',2018-08-28,MICRO ATM GST DATED 27081,,2018-08-28,,4.39,-528509264.6900006,.
409000438620',2018-08-29,Indiaforensic AEPS NPCI WDL SET,,2018-08-29,,10893600.0,-517615664.6900006,.
409000438620',2018-08-29,CB823015717554/RMCPL10943/1,,2018-08-29,10000.0,,-517625664.6900006,.
409000438620',2018-08-29,TRF TO  Indiaforensic SERVICES I,,2018-08-29,5000000.0,,-522625664.6900006,.
409000438620',2018-08-29,TRF TO  Indiaforensic SERVICES I,,2018-08-29,5000000.0,,-527625664.6900006,.
409000438620',2018-08-29,TRF TO  Indiaforensic SERVICES I,,2018-08-29,1000000.0,,-528625664.6900006,.
409000438620',2018-08-29,AEPS INCOME DT 28-08-2018,,2018-08-29,,28044.41,-528597620.28000057,.
409000438620',2018-08-29,AEPS GST INC DT 28-08-201,,2018-08-29,,5608.88,-528592011.4000006,.
409000438620',2018-08-30,MAW/502964XXXXXX5863/Karu,,2018-08-30,,1700.0,-528590311.4000006,.
409000438620',2018-08-30,Indiaforensic AEPS NPCI WDL SET,,2018-08-30,,10587800.0,-518002511.4000006,.
409000438620',2018-08-30,MAW/502964XXXXXX1833/NAGA,,2018-08-30,,800.0,-518001711.4000006,.
409000438620',2018-08-30,MICRO ATM WDL FEE DATED 2,,2018-08-30,,47800.0,-517953911.4000006,.
409000438620',2018-08-30,TRF TO  Indiaforensic SERVICES I,,2018-08-30,10600000.0,,-528553911.4000006,.
409000438620',2018-08-30,MICRO ATM WDL FEE DT30081,,2018-08-30,,17500.0,-528536411.4000006,.
409000438620',2018-08-30,AEPS INCOME DT 29-08-2018,,2018-08-30,,27995.03,-528508416.3700006,.
409000438620',2018-08-30,AEPS GST INC DT 29-08-201,,2018-08-30,,5599.01,-528502817.3600006,.
409000438620',2018-08-30,AEPS ACQUIRING ADJ FEES 2,,2018-08-30,46.61,,-528502863.9700006,.
409000438620',2018-08-30,AEPS ACQ REP ADJ FEES 290,,2018-08-30,,35.4,-528502828.57000065,.
409000438620',2018-08-30,NFS MICRO ATM INC DATED 2,,2018-08-30,,116.28,-528502712.2900007,.
409000438620',2018-08-30,NFS MICRO ATM GST DATED 2,,2018-08-30,,23.26,-528502689.0300007,.
409000438620',2018-08-30,NFS MICRO ATM INC DATED 3,,2018-08-30,,37.8,-528502651.2300007,.
409000438620',2018-08-30,NFS MICRO ATM GST DATED 3,,2018-08-30,,7.56,-528502643.6700007,.
409000438620',2018-08-31,MAW/502964XXXXXX9692/Karu,,2018-08-31,,1700.0,-528500943.6700007,.
409000438620',2018-08-31,Indiaforensic AEPS NPCI WDL SET,,2018-08-31,,11184700.0,-517316243.6700007,.
409000438620',2018-08-31,TRF TO  Indiaforensic SERVICES I,,2018-08-31,11300000.0,,-528616243.6700007,.
409000438620',2018-08-31,MICRO ATM WDL FEE DT30081,,2018-08-31,,34900.0,-528581343.6700007,.
409000438620',2018-08-31,NPCI SETELEMENT DIFF_3008,,2018-08-31,,500.0,-528580843.6700007,.
409000438620',2018-08-31,AEPS PAY Indiaforensic 3008,,2018-08-31,,1188.39,-528579655.2800007,.
409000438620',2018-08-31,MICRO ATM WDL FEE DT31081,,2018-08-31,,41000.0,-528538655.2800007,.
409000438620',2018-08-31,MICRO ATM INC DATED 30081,,2018-08-31,,98.64,-528538556.6400007,.
409000438620',2018-08-31,MICROATM GST DATED 300818,,2018-08-31,,19.73,-528538536.9100007,.
409000438620',2018-08-31,AEPS INCOME DT 30-08-2018,,2018-08-31,,29030.02,-528509506.8900007,.
409000438620',2018-08-31,AEPS GST INC DT 30-08-201,,2018-08-31,,5806.0,-528503700.8900007,.
409000438620',2018-08-31,AEPS ACQUIRING ADJ FEES 3,,2018-08-31,67.85,,-528503768.7400007,.
409000438620',2018-08-31,MICRO ATM INC DATED 31081,,2018-08-31,,64.8,-528503703.9400007,.
409000438620',2018-08-31,MICRO ATM GST DATED 31081,,2018-08-31,,12.96,-528503690.98000073,.
409000438620',2018-09-01,Indiaforensic AEPS NPCI WDL SET,,2018-09-01,,11148300.0,-517355390.98000073,.
409000438620',2018-09-01,CR823518045609/RMCPL23207/2,,2018-09-01,500.0,,-517355890.98000073,.
409000438620',2018-09-01,CR823513976917/RMCPL09592/2,,2018-09-01,3000.0,,-517358890.98000073,.
409000438620',2018-09-01,CR823511927139/RMCPL17333/2,,2018-09-01,1000.0,,-517359890.98000073,.
409000438620',2018-09-01,CR823513976943/RMCPL11131/2,,2018-09-01,500.0,,-517360390.98000073,.
409000438620',2018-09-01,CR823513976918/RMCPL20650/2,,2018-09-01,2500.0,,-517362890.98000073,.
409000438620',2018-09-01,CR823513976897/RMCPL28457/2,,2018-09-01,1000.0,,-517363890.98000073,.
409000438620',2018-09-01,CR823516016429/RMCPL22344/2,,2018-09-01,10000.0,,-517373890.98000073,.
409000438620',2018-09-01,CR823512956345/RMCPL23829/2,,2018-09-01,2600.0,,-517376490.98000073,.
409000438620',2018-09-01,CR823512956337/RMCPL11018/2,,2018-09-01,1000.0,,-517377490.98000073,.
409000438620',2018-09-01,CR823511938871/RMCPL07955/2,,2018-09-01,2500.0,,-517379990.98000073,.
409000438620',2018-09-01,CR823517020223/RMCPL22994/2,,2018-09-01,2200.0,,-517382190.98000073,.
409000438620',2018-09-01,CR823518036160/RMCPL14542/2,,2018-09-01,800.0,,-517382990.98000073,.
409000438620',2018-09-01,CR823512947797/RMCPL22994/2,,2018-09-01,3000.0,,-517385990.98000073,.
409000438620',2018-09-01,CR823516016438/RMCPL12283/2,,2018-09-01,3000.0,,-517388990.98000073,.
409000438620',2018-09-01,CR823518031866/RMCPL25522/2,,2018-09-01,4000.0,,-517392990.98000073,.
409000438620',2018-09-01,CR823518031893/RMCPL07044/2,,2018-09-01,1000.0,,-517393990.98000073,.
409000438620',2018-09-01,CR823518031865/RMCPL18796/2,,2018-09-01,1200.0,,-517395190.98000073,.
409000438620',2018-09-01,CR823507876926/RMCPL24601/2,,2018-09-01,3000.0,,-517398190.98000073,.
409000438620',2018-09-01,CR823512960793/RMCPL26238/2,,2018-09-01,3500.0,,-517401690.98000073,.
409000438620',2018-09-01,CR823914996150/RMCPL22522/2,,2018-09-01,500.0,,-517402190.98000073,.
409000438620',2018-09-01,CR823916021935/RMCPL16020/2,,2018-09-01,2000.0,,-517404190.98000073,.
409000438620',2018-09-01,CR823911948016/RMCPL22273/2,,2018-09-01,1000.0,,-517405190.98000073,.
409000438620',2018-09-01,CR823911941089/RMCPL22184/2,,2018-09-01,10000.0,,-517415190.98000073,.
409000438620',2018-09-01,CR823911941111/RMCPL22595/2,,2018-09-01,1000.0,,-517416190.98000073,.
409000438620',2018-09-01,CR823911941094/RMCPL25478/2,,2018-09-01,2500.0,,-517418690.98000073,.
409000438620',2018-09-01,CR823911941118/RMCPL21661/2,,2018-09-01,500.0,,-517419190.98000073,.
409000438620',2018-09-01,CR823916030824/RMCPL25261/2,,2018-09-01,1100.0,,-517420290.98000073,.
409000438620',2018-09-01,CR823918060532/RMCPL23207/2,,2018-09-01,2100.0,,-517422390.98000073,.
409000438620',2018-09-01,CR823911952800/RMCPL18312/2,,2018-09-01,900.0,,-517423290.98000073,.
409000438620',2018-09-01,CR823711450422/RMCPL19766/2,,2018-09-01,2000.0,,-517425290.98000073,.
409000438620',2018-09-01,CR823711453658/RMCPL21943/2,,2018-09-01,4000.0,,-517429290.98000073,.
409000438620',2018-09-01,CR823710421563/RMCPL25071/2,,2018-09-01,1300.0,,-517430590.98000073,.
409000438620',2018-09-01,CR823712463895/RMCPL16645/2,,2018-09-01,1500.0,,-517432090.98000073,.
409000438620',2018-09-01,CR823713477054/RMCPL09595/2,,2018-09-01,5000.0,,-517437090.98000073,.
409000438620',2018-09-01,CR823712472806/RMCPL12384/2,,2018-09-01,2000.0,,-517439090.98000073,.
409000438620',2018-09-01,CR823715512468/RMCPL20178/2,,2018-09-01,1000.0,,-517440090.98000073,.
409000438620',2018-09-01,CR823715517046/RMCPL25854/2,,2018-09-01,1000.0,,-517441090.98000073,.
409000438620',2018-09-01,CR823715517049/RMCPL18085/2,,2018-09-01,500.0,,-517441590.98000073,.
409000438620',2018-09-01,CR823711442489/RMCPL09593/2,,2018-09-01,1000.0,,-517442590.98000073,.
409000438620',2018-09-01,CR823712465303/RMCPL26560/2,,2018-09-01,500.0,,-517443090.98000073,.
409000438620',2018-09-01,CR823712465299/RMCPL15290/2,,2018-09-01,10000.0,,-517453090.98000073,.
409000438620',2018-09-01,CR823712465315/RMCPL19849/2,,2018-09-01,1000.0,,-517454090.98000073,.
409000438620',2018-09-01,CR823713486078/RMCPL25854/2,,2018-09-01,2000.0,,-517456090.98000073,.
409000438620',2018-09-01,CR823714508095/RMCPL21313/2,,2018-09-01,1000.0,,-517457090.98000073,.
409000438620',2018-09-01,CR823610149259/RMCPL24446/2,,2018-09-01,700.0,,-517457790.98000073,.
409000438620',2018-09-01,CR823611165550/RMCPL15176/2,,2018-09-01,2500.0,,-517460290.98000073,.
409000438620',2018-09-01,CR823613199098/RMCPL09827/2,,2018-09-01,600.0,,-517460890.98000073,.
409000438620',2018-09-01,CR823615229413/RMCPL10425/2,,2018-09-01,2000.0,,-517462890.98000073,.
409000438620',2018-09-01,CR823613197541/RMCPL21107/2,,2018-09-01,1200.0,,-517464090.98000073,.
409000438620',2018-09-01,CR823610153396/RMCPL20518/2,,2018-09-01,2000.0,,-517466090.98000073,.
409000438620',2018-09-01,CR823613197533/RMCPL21943/2,,2018-09-01,10000.0,,-517476090.98000073,.
409000438620',2018-09-01,CR823616247513/RMCPL25813/2,,2018-09-01,500.0,,-517476590.98000073,.
409000438620',2018-09-01,CR823612184497/RMCPL00154/2,,2018-09-01,2000.0,,-517478590.98000073,.
409000438620',2018-09-01,CR823611165511/RMCPL24605/2,,2018-09-01,500.0,,-517479090.98000073,.
409000438620',2018-09-01,CR823611165547/RMCPL17636/2,,2018-09-01,2200.0,,-517481290.98000073,.
409000438620',2018-09-01,CR823616249677/RMCPL23000/2,,2018-09-01,1000.0,,-517482290.98000073,.
409000438620',2018-09-01,CR823617256532/RMCPL25071/2,,2018-09-01,5500.0,,-517487790.98000073,.
409000438620',2018-09-01,CR823617256547/RMCPL09794/2,,2018-09-01,500.0,,-517488290.98000073,.
409000438620',2018-09-01,CR823614216207/RMCPL22293/2,,2018-09-01,2000.0,,-517490290.98000073,.
409000438620',2018-09-01,CR823616242585/RMCPL24589/2,,2018-09-01,500.0,,-517490790.98000073,.
409000438620',2018-09-01,CR824010201553/RMCPL14542/2,,2018-09-01,5000.0,,-517495790.98000073,.
409000438620',2018-09-01,CR824013256623/RMCPL20978/2,,2018-09-01,9000.0,,-517504790.98000073,.
409000438620',2018-09-01,CR824011213435/RMCPL21832/2,,2018-09-01,1500.0,,-517506290.98000073,.
409000438620',2018-09-01,CR824011213447/RMCPL21824/2,,2018-09-01,1200.0,,-517507490.98000073,.
409000438620',2018-09-01,CR824013249229/RMCPL22278/2,,2018-09-01,1800.0,,-517509290.98000073,.
409000438620',2018-09-01,CR824014267517/RMCPL26217/2,,2018-09-01,10000.0,,-517519290.98000073,.
409000438620',2018-09-01,CR824010196738/RMCPL12394/2,,2018-09-01,500.0,,-517519790.98000073,.
409000438620',2018-09-01,CR824015284584/RMCPL21533/2,,2018-09-01,1000.0,,-517520790.98000073,.
409000438620',2018-09-01,CR824010191912/RMCPL24303/2,,2018-09-01,2000.0,,-517522790.98000073,.
409000438620',2018-09-01,CR824009171240/RMCPL23569/2,,2018-09-01,1500.0,,-517524290.98000073,.
409000438620',2018-09-01,TRF TO  Indiaforensic SERVICES I,,2018-09-01,10000000.0,,-527524290.98000073,.
409000438620',2018-09-01,TRF TO  Indiaforensic SERVICES I,,2018-09-01,1000000.0,,-528524290.98000073,.
409000438620',2018-09-01,AEPS INCOME DT 31-08-2018,,2018-09-01,,29191.23,-528495099.7500007,.
409000438620',2018-09-01,AEPS GST INC DT 31-08-201,,2018-09-01,,5838.25,-528489261.5000007,.
409000438620',2018-09-01,AEPS ACQ CR ADJ FEES 3108,,2018-09-01,701.51,,-528489963.0100007,.
409000438620',2018-09-01,NPCI SETELEMENT DIFF_3108,,2018-09-01,,500.0,-528489463.0100007,.
409000438620',2018-09-01,MICRO ATM WDL FEE DT01091,,2018-09-01,,20700.0,-528468763.0100007,.
409000438620',2018-09-01,MICRO ATM INC DATED 01091,,2018-09-01,,49.32,-528468713.6900007,.
409000438620',2018-09-01,MICRO ATM GST DATED 01091,,2018-09-01,,9.86,-528468703.8300007,.
409000438620',2018-09-01,MICRO ATM WDL FEE DT31081,,2018-09-01,,41700.0,-528427003.8300007,.
409000438620',2018-09-01,MICRO ATM INC DATED 31081,,2018-09-01,,101.52,-528426902.3100007,.
409000438620',2018-09-01,MICRO ATM GST DATED 31081,,2018-09-01,,20.3,-528426882.0100007,.
409000438620',2018-09-03,MAW/502964XXXXXX4307/Karu,,2018-09-03,,1700.0,-528425182.0100007,.
409000438620',2018-09-03,Indiaforensic AEPS NPCI WDL SET,,2018-09-03,,10862000.0,-517563182.0100007,.
409000438620',2018-09-03,Indiaforensic AEPS NPCI WDL SET,,2018-09-03,,7837500.0,-509725682.0100007,.
409000438620',2018-09-03,CB819418940693/RMCPL16717/1,,2018-09-03,700.0,,-509726382.0100007,.
409000438620',2018-09-03,TRF TO  Indiaforensic SERVICES I,,2018-09-03,10000000.0,,-519726382.0100007,.
409000438620',2018-09-03,TRF TO  Indiaforensic SERVICES I,,2018-09-03,1000000.0,,-520726382.0100007,.
409000438620',2018-09-03,TRF TO  Indiaforensic SERVICES I,,2018-09-03,7800000.0,,-528526382.0100007,.
409000438620',2018-09-03,MAW/502964XXXXXX7658/Karu,,2018-09-03,,1200.0,-528525182.0100007,.
409000438620',2018-09-03,MICRO ATM WDL FEE DT01091,,2018-09-03,,62700.0,-528462482.0100007,.
409000438620',2018-09-03,MICRO ATM INC DATED 01091,,2018-09-03,,114.12,-528462367.8900007,.
409000438620',2018-09-03,MICRO ATM GST DATED 01091,,2018-09-03,,22.82,-528462345.0700007,.
409000438620',2018-09-03,MICRO ATM WDL FEE DT02091,,2018-09-03,,148000.0,-528314345.0700007,.
409000438620',2018-09-03,MICRO ATM WDL FEE DT03091,,2018-09-03,,53800.0,-528260545.0700007,.
409000438620',2018-09-03,MICRO ATM INC DATED 03091,,2018-09-03,,109.8,-528260435.2700007,.
409000438620',2018-09-03,MICRO ATM GST DATED 03091,,2018-09-03,,21.96,-528260413.3100007,.
409000438620',2018-09-03,AEPS INCOME DT 01-09-2018,,2018-09-03,,28462.19,-528231951.1200007,.
409000438620',2018-09-03,AEPS GST INC DT 01-09-201,,2018-09-03,,5692.44,-528226258.6800007,.
409000438620',2018-09-03,AEPS INCOME DT 02-09-2018,,2018-09-03,,20682.67,-528205576.0100007,.
409000438620',2018-09-03,AEPS GST INC DT 02-09-201,,2018-09-03,,4136.53,-528201439.48000073,.
409000438620',2018-09-03,AEPS ACQUIRING ADJ FEES 0,,2018-09-03,20.06,,-528201459.54000074,.
409000438620',2018-09-04,MAW/502964XXXXXX3430/Karu,,2018-09-04,,2000.0,-528199459.54000074,.
409000438620',2018-09-04,MAW/502964XXXXXX7517/NAGA,,2018-09-04,,700.0,-528198759.54000074,.
409000438620',2018-09-04,Indiaforensic AEPS NPCI WDL SET,,2018-09-04,,11183700.0,-517015059.54000074,.
409000438620',2018-09-04,CR824310995528/RMCPL14572/3,,2018-09-04,1000.0,,-517016059.54000074,.
409000438620',2018-09-04,CR824319127866/RMCPL15696/3,,2018-09-04,10000.0,,-517026059.54000074,.
409000438620',2018-09-04,CR824309984275/RMCPL23387/3,,2018-09-04,4000.0,,-517030059.54000074,.
409000438620',2018-09-04,CR824309984323/RMCPL23345/3,,2018-09-04,1000.0,,-517031059.54000074,.
409000438620',2018-09-04,CR824309979998/RMCPL24446/3,,2018-09-04,700.0,,-517031759.54000074,.
409000438620',2018-09-04,CR824309979995/RMCPL16755/3,,2018-09-04,1200.0,,-517032959.54000074,.
409000438620',2018-09-04,CR824309979982/RMCPL11699/3,,2018-09-04,1000.0,,-517033959.54000074,.
409000438620',2018-09-04,CR824317102915/RMCPL16250/3,,2018-09-04,1000.0,,-517034959.54000074,.
409000438620',2018-09-04,CR824308970329/RMCPL15326/3,,2018-09-04,800.0,,-517035759.54000074,.
409000438620',2018-09-04,CR824308970324/RMCPL18858/3,,2018-09-04,1000.0,,-517036759.54000074,.
409000438620',2018-09-04,CR824312018914/RMCPL21313/3,,2018-09-04,2000.0,,-517038759.54000074,.
409000438620',2018-09-04,CR824310995435/RMCPL15326/3,,2018-09-04,2000.0,,-517040759.54000074,.
409000438620',2018-09-04,CR824317097322/RMCPL26695/3,,2018-09-04,10000.0,,-517050759.54000074,.
409000438620',2018-09-04,CR824309979976/RMCPL24066/3,,2018-09-04,1000.0,,-517051759.54000074,.
409000438620',2018-09-04,CR824310991201/RMCPL23561/3,,2018-09-04,3500.0,,-517055259.54000074,.
409000438620',2018-09-04,CR824311005493/RMCPL25499/3,,2018-09-04,600.0,,-517055859.54000074,.
409000438620',2018-09-04,CR824311011054/RMCPL18466/3,,2018-09-04,5000.0,,-517060859.54000074,.
409000438620',2018-09-04,CR824318121405/RMCPL11592/3,,2018-09-04,2600.0,,-517063459.54000074,.
409000438620',2018-09-04,CR824311005477/RMCPL24364/3,,2018-09-04,1700.0,,-517065159.54000074,.
409000438620',2018-09-04,CR824311008538/RMCPL07903/3,,2018-09-04,1000.0,,-517066159.54000074,.
409000438620',2018-09-04,CR824311009492/RMCPL17729/3,,2018-09-04,2000.0,,-517068159.54000074,.
409000438620',2018-09-04,CR824312022540/RMCPL22489/3,,2018-09-04,3600.0,,-517071759.54000074,.
409000438620',2018-09-04,CR824318114147/RMCPL19805/3,,2018-09-04,8000.0,,-517079759.54000074,.
409000438620',2018-09-04,CR824311014176/RMCPL28330/3,,2018-09-04,500.0,,-517080259.54000074,.
409000438620',2018-09-04,CR824311004289/RMCPL12219/3,,2018-09-04,500.0,,-517080759.54000074,.
409000438620',2018-09-04,MAW/502964XXXXXX6016/Akol,,2018-09-04,,2100.0,-517078659.54000074,.
409000438620',2018-09-04,TRF TO  Indiaforensic SERVICES I,,2018-09-04,10000000.0,,-527078659.54000074,.
409000438620',2018-09-04,TRF TO  Indiaforensic SERVICES I,,2018-09-04,1000000.0,,-528078659.54000074,.
409000438620',2018-09-04,MAW/502964XXXXXX2262/Karu,,2018-09-04,,1800.0,-528076859.54000074,.
409000438620',2018-09-04,MICRO ATM WDL FEE DT03091,,2018-09-04,,108300.0,-527968559.54000074,.
409000438620',2018-09-04,MICRO ATM INC DATED 03091,,2018-09-04,,249.48,-527968310.0600007,.
409000438620',2018-09-04,MICRO ATM GST DATED 03091,,2018-09-04,,49.9,-527968260.16000074,.
409000438620',2018-09-04,CB823716534065/RMCPL24609/2,,2018-09-04,3500.0,,-527971760.16000074,.
409000438620',2018-09-04,CB823613210175/RMCPL09615/2,,2018-09-04,500.0,,-527972260.16000074,.
409000438620',2018-09-04,CB823611175202/RMCPL22042/2,,2018-09-04,10000.0,,-527982260.16000074,.
409000438620',2018-09-04,CB823612184507/RMCPL19298/2,,2018-09-04,3000.0,,-527985260.16000074,.
409000438620',2018-09-04,TRF TO  Indiaforensic SERVICES I,,2018-09-04,500000.0,,-528485260.16000074,.
409000438620',2018-09-04,AEPS PAY Indiaforensic 0309,,2018-09-04,,199.58,-528485060.58000076,.
409000438620',2018-09-04,AEPS PAY Indiaforensic 0109,,2018-09-04,,548.57,-528484512.01000077,.
409000438620',2018-09-04,AEPS PAY Indiaforensic 3108,,2018-09-04,,100.64,-528484411.3700008,.
409000438620',2018-09-04,MICRO ATM WDL FEE DT04091,,2018-09-04,,124800.0,-528359611.3700008,.
409000438620',2018-09-04,AEPS INCOME DT 03-09-2018,,2018-09-04,,29912.45,-528329698.9200008,.
409000438620',2018-09-04,AEPS GST INC DT 03-09-201,,2018-09-04,,5982.49,-528323716.4300008,.
409000438620',2018-09-04,AEPS ACQ CR ADJ FEES 0309,,2018-09-04,251.34,,-528323967.77000076,.
409000438620',2018-09-04,AEPS ACQ REP ADJ FEES 030,,2018-09-04,,58.41,-528323909.3600007,.
409000438620',2018-09-04,MICROATM INC DATED040918_,,2018-09-04,,229.68,-528323679.6800007,.
409000438620',2018-09-04,MICROATM GST DATED040918_,,2018-09-04,,45.94,-528323633.7400007,.
409000438620',2018-09-05,MAW/502964XXXXXX1825/NAGA,,2018-09-05,,800.0,-528322833.7400007,.
409000438620',2018-09-05,MAW/502964XXXXXX2475/Karu,,2018-09-05,,1700.0,-528321133.7400007,.
409000438620',2018-09-05,Indiaforensic AEPS NPCI WDL SET,,2018-09-05,,11870700.0,-516450433.7400007,.
409000438620',2018-09-05,CR824415350479/RMCPL17511/0,,2018-09-05,2100.0,,-516452533.7400007,.
409000438620',2018-09-05,CR824411288703/RMCPL16831/0,,2018-09-05,1000.0,,-516453533.7400007,.
409000438620',2018-09-05,CR824417372409/RMCPL23861/0,,2018-09-05,1300.0,,-516454833.7400007,.
409000438620',2018-09-05,CR824417372414/RMCPL13888/0,,2018-09-05,2600.0,,-516457433.7400007,.
409000438620',2018-09-05,CR824410261581/RMCPL16660/0,,2018-09-05,4000.0,,-516461433.7400007,.
409000438620',2018-09-05,CR824410261780/RMCPL16774/0,,2018-09-05,1500.0,,-516462933.7400007,.
409000438620',2018-09-05,CR824410276617/RMCPL14573/0,,2018-09-05,500.0,,-516463433.7400007,.
409000438620',2018-09-05,CR824411293186/RMCPL21339/0,,2018-09-05,10000.0,,-516473433.7400007,.
409000438620',2018-09-05,TRF TO  Indiaforensic SERVICES I,,2018-09-05,12100000.0,,-528573433.7400007,.
409000438620',2018-09-05,AEPS ACQUIRING ADJ FEES 0,,2018-09-05,2.95,,-528573436.6900007,.
409000438620',2018-09-05,AEPS ACQ CR ADJ FEES 0409,,2018-09-05,88.5,,-528573525.1900007,.
409000438620',2018-09-05,AEPS ACQ REP ADJ FEES 040,,2018-09-05,,20.06,-528573505.1300007,.
409000438620',2018-09-05,MICRO ATM WDL FEE DT04091,,2018-09-05,,98300.0,-528475205.1300007,.
409000438620',2018-09-05,MICROATM INCDATED040918_1,,2018-09-05,,250.92,-528474954.2100007,.
409000438620',2018-09-05,MICROATM GST DATED040918_,,2018-09-05,,50.18,-528474904.0300007,.
409000438620',2018-09-05,AEPS INCOME DT 04-09-2018,,2018-09-05,,30950.0,-528443954.0300007,.
409000438620',2018-09-05,AEPS GST INC DT 04-09-201,,2018-09-05,,6190.0,-528437764.0300007,.
409000438620',2018-09-05,MICRO ATM WDL FEE DT05091,,2018-09-05,,54400.0,-528383364.0300007,.
409000438620',2018-09-05,MICRO ATM INC DATED 05091,,2018-09-05,,113.04,-528383250.99000067,.
409000438620',2018-09-05,MICRO ATM GST DATED 05091,,2018-09-05,,22.61,-528383228.38000065,.
409000438620',2018-09-06,MAW/502964XXXXXX1989/NAGA,,2018-09-06,,900.0,-528382328.38000065,.
409000438620',2018-09-06,Indiaforensic AEPS NPCI WDL SET,,2018-09-06,,11126400.0,-517255928.38000065,.
409000438620',2018-09-06,CR824611720052/RMCPL05229/0,,2018-09-06,2000.0,,-517257928.38000065,.
409000438620',2018-09-06,CR824611720069/RMCPL22640/0,,2018-09-06,1000.0,,-517258928.38000065,.
409000438620',2018-09-06,CR824610700151/RMCPL17766/0,,2018-09-06,1000.0,,-517259928.38000065,.
409000438620',2018-09-06,CR824610710829/RMCPL19251/0,,2018-09-06,1200.0,,-517261128.38000065,.
409000438620',2018-09-06,CR824611728573/RMCPL15429/0,,2018-09-06,500.0,,-517261628.38000065,.
409000438620',2018-09-06,CR824614767105/RMCPL24098/0,,2018-09-06,2000.0,,-517263628.38000065,.
409000438620',2018-09-06,CR824617800610/RMCPL12739/0,,2018-09-06,1400.0,,-517265028.38000065,.
409000438620',2018-09-06,CR824612744613/RMCPL16204/0,,2018-09-06,2500.0,,-517267528.38000065,.
409000438620',2018-09-06,CR824612744619/RMCPL20757/0,,2018-09-06,700.0,,-517268228.38000065,.
409000438620',2018-09-06,CR824612744620/RMCPL26216/0,,2018-09-06,500.0,,-517268728.38000065,.
409000438620',2018-09-06,CR824612744617/RMCPL18214/0,,2018-09-06,500.0,,-517269228.38000065,.
409000438620',2018-09-06,CR824113527057/RMCPL27717/2,,2018-09-06,2000.0,,-517271228.38000065,.
409000438620',2018-09-06,CR824109459591/RMCPL25478/2,,2018-09-06,800.0,,-517272028.38000065,.
409000438620',2018-09-06,CR824109453068/RMCPL21235/2,,2018-09-06,10000.0,,-517282028.38000065,.
409000438620',2018-09-06,CR824117592543/RMCPL25689/2,,2018-09-06,5000.0,,-517287028.38000065,.
409000438620',2018-09-06,CR824115564885/RMCPL16204/2,,2018-09-06,500.0,,-517287528.38000065,.
409000438620',2018-09-06,CR824111490964/RMCPL16430/2,,2018-09-06,2500.0,,-517290028.38000065,.
409000438620',2018-09-06,CR824113541270/RMCPL17417/2,,2018-09-06,1000.0,,-517291028.38000065,.
409000438620',2018-09-06,CR824111500621/RMCPL26112/2,,2018-09-06,10000.0,,-517301028.38000065,.
409000438620',2018-09-06,CR824110480790/RMCPL20610/2,,2018-09-06,2200.0,,-517303228.38000065,.
409000438620',2018-09-06,CR824110480784/RMCPL17641/2,,2018-09-06,1300.0,,-517304528.38000065,.
409000438620',2018-09-06,CR824115559927/RMCPL11838/2,,2018-09-06,10000.0,,-517314528.38000065,.
409000438620',2018-09-06,CR824116580810/RMCPL23323/2,,2018-09-06,500.0,,-517315028.38000065,.
409000438620',2018-09-06,CR824112510230/RMCPL22133/2,,2018-09-06,1000.0,,-517316028.38000065,.
409000438620',2018-09-06,CR824112510209/RMCPL24552/2,,2018-09-06,5200.0,,-517321228.38000065,.
409000438620',2018-09-06,CR824117596300/RMCPL22588/2,,2018-09-06,2500.0,,-517323728.38000065,.
409000438620',2018-09-06,CR824109459569/RMCPL20307/2,,2018-09-06,10000.0,,-517333728.38000065,.
409000438620',2018-09-06,CR824215837579/RMCPL23034/3,,2018-09-06,1000.0,,-517334728.38000065,.
409000438620',2018-09-06,CR824210750155/RMCPL22489/3,,2018-09-06,3600.0,,-517338328.38000065,.
409000438620',2018-09-06,CR824210750143/RMCPL26808/3,,2018-09-06,600.0,,-517338928.38000065,.
409000438620',2018-09-06,CR824212775778/RMCPL20057/3,,2018-09-06,3000.0,,-517341928.38000065,.
409000438620',2018-09-06,CR824211766673/RMCPL23688/3,,2018-09-06,10000.0,,-517351928.38000065,.
409000438620',2018-09-06,CR824213795302/RMCPL22640/3,,2018-09-06,2000.0,,-517353928.38000065,.
409000438620',2018-09-06,CR824208718148/RMCPL13815/3,,2018-09-06,5100.0,,-517359028.38000065,.
409000438620',2018-09-06,CR824208718149/RMCPL21810/3,,2018-09-06,500.0,,-517359528.38000065,.
409000438620',2018-09-06,CR824217856842/RMCPL11793/3,,2018-09-06,500.0,,-517360028.38000065,.
409000438620',2018-09-06,CR824210741048/RMCPL19766/3,,2018-09-06,8900.0,,-517368928.38000065,.
409000438620',2018-09-06,TRF TO  Indiaforensic SERVICES I,,2018-09-06,11200000.0,,-528568928.38000065,.
409000438620',2018-09-06,MAW/502964XXXXXX3513/Karu,,2018-09-06,,2000.0,-528566928.38000065,.
409000438620',2018-09-06,MICRO ATM WDL FEE DT05091,,2018-09-06,,74300.0,-528492628.38000065,.
409000438620',2018-09-06,MICRO ATM INC DATED 05091,,2018-09-06,,198.72,-528492429.6600006,.
409000438620',2018-09-06,MICRO ATM GST DATED 05091,,2018-09-06,,39.74,-528492389.9200006,.
409000438620',2018-09-06,MICRO ATM WDL FEE DT06091,,2018-09-06,,88200.0,-528404189.9200006,.
409000438620',2018-09-06,AEPS INCOME DT 05-09-2018,,2018-09-06,,29020.73,-528375169.1900006,.
409000438620',2018-09-06,AEPS GST INC DT 05-09-201,,2018-09-06,,5804.15,-528369365.0400006,.
409000438620',2018-09-06,AEPS ACQ CR ADJ FEES 0509,,2018-09-06,384.68,,-528369749.7200006,.
409000438620',2018-09-06,MICRO ATM INC DATED 06091,,2018-09-06,,187.92,-528369561.8000006,.
409000438620',2018-09-06,MICRO ATM GST DATED 06091,,2018-09-06,,37.58,-528369524.2200006,.
409000438620',2018-09-07,Indiaforensic AEPS NPCI WDL SET,,2018-09-07,,8840500.0,-519529024.2200006,.
409000438620',2018-09-07,MAW/502964XXXXXX6863/Akol,,2018-09-07,,7000.0,-519522024.2200006,.
409000438620',2018-09-07,TRF TO  Indiaforensic SERVICES I,,2018-09-07,9000000.0,,-528522024.2200006,.
409000438620',2018-09-07,MICRO ATM WDL FEE DT06091,,2018-09-07,,144700.0,-528377324.2200006,.
409000438620',2018-09-07,MICRO ATM INC DATED 06091,,2018-09-07,,342.0,-528376982.2200006,.
409000438620',2018-09-07,MICRO ATM GST DATED 06091,,2018-09-07,,68.4,-528376913.82000065,.
409000438620',2018-09-07,MICRO ATM WDL FEE DT07091,,2018-09-07,,91300.0,-528285613.82000065,.
409000438620',2018-09-07,MICRO ATM INC DATED 07091,,2018-09-07,,202.32,-528285411.50000066,.
409000438620',2018-09-07,MICRO ATM GST DATED 07091,,2018-09-07,,40.46,-528285371.0400007,.
409000438620',2018-09-07,AEPS INCOME DT 06-09-2018,,2018-09-07,,23325.35,-528262045.69000065,.
409000438620',2018-09-07,AEPS GST INC DT 06-09-201,,2018-09-07,,4665.07,-528257380.62000066,.
409000438620',2018-09-07,AEPS ACQUIRING ADJ FEES 0,,2018-09-07,35.4,,-528257416.02000064,.
409000438620',2018-09-07,AEPS ACQ REP ADJ FEES 060,,2018-09-07,,2.95,-528257413.07000065,.
409000438620',2018-09-07,AEPS PAY Indiaforensic 0609,,2018-09-07,,148.62,-528257264.45000064,.
409000438620',2018-09-07,TRF TO  Indiaforensic SERVICES I,,2018-09-07,300000.0,,-528557264.45000064,.
409000438620',2018-09-08,MAW/502964XXXXXX4820/Karu,,2018-09-08,,1700.0,-528555564.45000064,.
409000438620',2018-09-10,MAW/502964XXXXXX8257/Karu,,2018-09-10,,1700.0,-528553864.45000064,.
409000438620',2018-09-10,Indiaforensic AEPS NPCI WDL SET,,2018-09-10,,10038000.0,-518515864.45000064,.
409000438620',2018-09-10,MICRO ATM WDL FEE DT07091,,2018-09-10,,208900.0,-518306964.45000064,.
409000438620',2018-09-10,MICRO ATM INC DATED 07091,,2018-09-10,,520.56,-518306443.89000064,.
409000438620',2018-09-10,MICRO ATM GST DATED 07091,,2018-09-10,,104.11,-518306339.7800006,.
409000438620',2018-09-10,TRF TO  Indiaforensic SERVICES I,,2018-09-10,2000000.0,,-520306339.7800006,.
409000438620',2018-09-10,TRF TO  Indiaforensic SERVICES I,,2018-09-10,4000000.0,,-524306339.7800006,.
409000438620',2018-09-10,TRF TO  Indiaforensic SERVICES I,,2018-09-10,4000000.0,,-528306339.7800006,.
409000438620',2018-09-10,Indiaforensic AEPS NPCI WDL SET,,2018-09-10,,11184700.0,-517121639.7800006,.
409000438620',2018-09-10,Indiaforensic AEPS NPCI WDL SET,,2018-09-10,,6852900.0,-510268739.7800006,.
409000438620',2018-09-10,TRF TO  Indiaforensic SERVICES I,,2018-09-10,3000000.0,,-513268739.7800006,.
409000438620',2018-09-10,TRF TO  Indiaforensic SERVICES I,,2018-09-10,15000000.0,,-528268739.7800006,.
409000438620',2018-09-10,MICRO ATM WDL FEE DT10091,,2018-09-10,,217300.0,-528051439.7800006,.
409000438620',2018-09-10,MICRO ATM INC DATED 10091,,2018-09-10,,448.92,-528050990.8600006,.
409000438620',2018-09-10,MICRO ATM GST DATED 10091,,2018-09-10,,89.78,-528050901.08000064,.
409000438620',2018-09-10,AEPS PAY Indiaforensic 0709,,2018-09-10,,398.46,-528050502.62000066,.
409000438620',2018-09-10,MICRO ATM WDL FEE DT08091,,2018-09-10,,384100.0,-527666402.62000066,.
409000438620',2018-09-10,MICRO ATM INC DATED 08091,,2018-09-10,,861.84,-527665540.7800007,.
409000438620',2018-09-10,MICRO ATM GST DATED 08091,,2018-09-10,,172.37,-527665368.4100007,.
409000438620',2018-09-10,MICRO ATM WDL FEE DT09091,,2018-09-10,,456900.0,-527208468.4100007,.
409000438620',2018-09-10,MICRO ATM INC DATED 09091,,2018-09-10,,927.0,-527207541.4100007,.
409000438620',2018-09-10,MICRO ATM GST DATED 09091,,2018-09-10,,185.4,-527207356.0100007,.
409000438620',2018-09-10,AEPS INCOME DT 07-09-2018,,2018-09-10,,26112.81,-527181243.2000007,.
409000438620',2018-09-10,AEPS GST INC DT 07-09-201,,2018-09-10,,5222.56,-527176020.6400007,.
409000438620',2018-09-10,AEPS INCOME DT 08-09-2018,,2018-09-10,,29379.12,-527146641.5200007,.
409000438620',2018-09-10,AEPS GST INC DT 08-09-201,,2018-09-10,,5875.82,-527140765.7000007,.
409000438620',2018-09-10,AEPS INCOME DT 09-09-2018,,2018-09-10,,17798.99,-527122966.7100007,.
409000438620',2018-09-10,AEPS GST INC DT 09-09-201,,2018-09-10,,3559.8,-527119406.9100007,.
409000438620',2018-09-10,TRF TO  Indiaforensic SERVICES I,,2018-09-10,500000.0,,-527619406.9100007,.
409000438620',2018-09-11,Indiaforensic AEPS NPCI WDL SET,,2018-09-11,,9000600.0,-518618806.9100007,.
409000438620',2018-09-11,CR824915504362/RMCPL13597/0,,2018-09-11,3000.0,,-518621806.9100007,.
409000438620',2018-09-11,CR824914481588/RMCPL22184/0,,2018-09-11,1900.0,,-518623706.9100007,.
409000438620',2018-09-11,CR824911443269/RMCPL14047/0,,2018-09-11,1500.0,,-518625206.9100007,.
409000438620',2018-09-11,CR824918539773/RMCPL24700/0,,2018-09-11,1000.0,,-518626206.9100007,.
409000438620',2018-09-11,CR824911431110/RMCPL22700/0,,2018-09-11,4000.0,,-518630206.9100007,.
409000438620',2018-09-11,CR824911431137/RMCPL23936/0,,2018-09-11,1500.0,,-518631706.9100007,.
409000438620',2018-09-11,CR824918539790/RMCPL14382/0,,2018-09-11,500.0,,-518632206.9100007,.
409000438620',2018-09-11,CR824918539781/RMCPL22362/0,,2018-09-11,4500.0,,-518636706.9100007,.
409000438620',2018-09-11,CR824911438777/RMCPL24255/0,,2018-09-11,500.0,,-518637206.9100007,.
409000438620',2018-09-11,CR824915497356/RMCPL18216/0,,2018-09-11,1000.0,,-518638206.9100007,.
409000438620',2018-09-11,CR824917524814/RMCPL24821/0,,2018-09-11,500.0,,-518638706.9100007,.
409000438620',2018-09-11,CR824913464067/RMCPL18569/0,,2018-09-11,2000.0,,-518640706.9100007,.
409000438620',2018-09-11,CR824913464073/RMCPL16256/0,,2018-09-11,5000.0,,-518645706.9100007,.
409000438620',2018-09-11,CR824913464079/RMCPL19691/0,,2018-09-11,500.0,,-518646206.9100007,.
409000438620',2018-09-11,CR824913468174/RMCPL15500/0,,2018-09-11,6000.0,,-518652206.9100007,.
409000438620',2018-09-11,CR824917521115/RMCPL26552/0,,2018-09-11,1000.0,,-518653206.9100007,.
409000438620',2018-09-11,CR824915497383/RMCPL25341/0,,2018-09-11,1500.0,,-518654706.9100007,.
409000438620',2018-09-11,CR824916504630/RMCPL22344/0,,2018-09-11,1000.0,,-518655706.9100007,.
409000438620',2018-09-11,TRF TO  Indiaforensic SERVICES I,,2018-09-11,1000000.0,,-519655706.9100007,.
409000438620',2018-09-11,TRF TO  Indiaforensic SERVICES I,,2018-09-11,5000000.0,,-524655706.9100007,.
409000438620',2018-09-11,TRF TO  Indiaforensic SERVICES I,,2018-09-11,4000000.0,,-528655706.9100007,.
409000438620',2018-09-11,AEPS PAY Indiaforensic 1009,,2018-09-11,,1718.4,-528653988.5100007,.
409000438620',2018-09-11,MICRO ATM WDL FEE DT11091,,2018-09-11,,250500.0,-528403488.5100007,.
409000438620',2018-09-11,MICRO ATM INC DATED 11091,,2018-09-11,,610.56,-528402877.9500007,.
409000438620',2018-09-11,MICRO ATM GST DATED 11091,,2018-09-11,,122.11,-528402755.8400007,.
409000438620',2018-09-11,MICRO ATM WDL FEE DT10091,,2018-09-11,,235400.0,-528167355.8400007,.
409000438620',2018-09-11,MICRO ATM INC DATED 10091,,2018-09-11,,600.12,-528166755.7200007,.
409000438620',2018-09-11,MICRO ATM GST DATED 10091,,2018-09-11,,120.02,-528166635.7000007,.
409000438620',2018-09-11,MICRO ATM INC DATED 02091,,2018-09-11,,344.88,-528166290.8200007,.
409000438620',2018-09-11,MICRO ATM GST DATED 02091,,2018-09-11,,68.98,-528166221.8400007,.
409000438620',2018-09-11,AEPS INCOME DT 10-09-2018,,2018-09-11,,22974.55,-528143247.2900007,.
409000438620',2018-09-11,AEPS GST INC DT 10-09-201,,2018-09-11,,4594.91,-528138652.38000065,.
409000438620',2018-09-11,AEPS ACQCR ADJ FEES 10091,,2018-09-11,173.46,,-528138825.8400006,.
409000438620',2018-09-11,TRF TO  Indiaforensic SERVICES I,,2018-09-11,500000.0,,-528638825.8400006,.
409000438620',2018-09-12,MAW/502964XXXXXX8587/NAGA,,2018-09-12,,600.0,-528638225.8400006,.
409000438620',2018-09-12,MAW/502964XXXXXX8983/NAGA,,2018-09-12,,900.0,-528637325.8400006,.
409000438620',2018-09-12,MAW/502964XXXXXX0502/NAGA,,2018-09-12,,2500.0,-528634825.8400006,.
409000438620',2018-09-12,Indiaforensic AEPS NPCI WDL SET,,2018-09-12,,8415100.0,-520219725.8400006,.
409000438620',2018-09-12,CR824713976638/RMCPL23823/0,,2018-09-12,1500.0,,-520221225.8400006,.
409000438620',2018-09-12,CR824710918547/RMCPL24066/0,,2018-09-12,500.0,,-520221725.8400006,.
409000438620',2018-09-12,CR824710918534/RMCPL16228/0,,2018-09-12,3200.0,,-520224925.8400006,.
409000438620',2018-09-12,CR824713968403/RMCPL24804/0,,2018-09-12,6000.0,,-520230925.8400006,.
409000438620',2018-09-12,CR824716016023/RMCPL19639/0,,2018-09-12,1000.0,,-520231925.8400006,.
409000438620',2018-09-12,CR824711936476/RMCPL28029/0,,2018-09-12,2000.0,,-520233925.8400006,.
409000438620',2018-09-12,CR824717028874/RMCPL24195/0,,2018-09-12,4100.0,,-520238025.8400006,.
409000438620',2018-09-12,CR824711949645/RMCPL22284/0,,2018-09-12,900.0,,-520238925.8400006,.
409000438620',2018-09-12,CR824712953180/RMCPL21720/0,,2018-09-12,1000.0,,-520239925.8400006,.
409000438620',2018-09-12,CR824711945406/RMCPL24213/0,,2018-09-12,1000.0,,-520240925.8400006,.
409000438620',2018-09-12,CR824714985636/RMCPL22800/0,,2018-09-12,1000.0,,-520241925.8400006,.
409000438620',2018-09-12,CR824712953200/RMCPL27487/0,,2018-09-12,1000.0,,-520242925.8400006,.
409000438620',2018-09-12,CR824719058609/RMCPL14219/0,,2018-09-12,5000.0,,-520247925.8400006,.
409000438620',2018-09-12,CR824812211920/RMCPL20815/0,,2018-09-12,1000.0,,-520248925.8400006,.
409000438620',2018-09-12,CR824810176271/RMCPL22523/0,,2018-09-12,4000.0,,-520252925.8400006,.
409000438620',2018-09-12,CR824813220351/RMCPL21720/0,,2018-09-12,500.0,,-520253425.8400006,.
409000438620',2018-09-12,CR824813220346/RMCPL27285/0,,2018-09-12,600.0,,-520254025.8400006,.
409000438620',2018-09-12,CR824810170921/RMCPL15297/0,,2018-09-12,1300.0,,-520255325.8400006,.
409000438620',2018-09-12,CR824818289600/RMCPL16006/0,,2018-09-12,500.0,,-520255825.8400006,.
409000438620',2018-09-12,CR824812211933/RMCPL27368/0,,2018-09-12,2300.0,,-520258125.8400006,.
409000438620',2018-09-12,CR824818289629/RMCPL22522/0,,2018-09-12,1000.0,,-520259125.8400006,.
409000438620',2018-09-12,CR824818289644/RMCPL16787/0,,2018-09-12,1800.0,,-520260925.8400006,.
409000438620',2018-09-12,CR824810166081/RMCPL16774/0,,2018-09-12,10000.0,,-520270925.8400006,.
409000438620',2018-09-12,CR824810166056/RMCPL15535/0,,2018-09-12,2000.0,,-520272925.8400006,.
409000438620',2018-09-12,CR824816262576/RMCPL15510/0,,2018-09-12,1000.0,,-520273925.8400006,.
409000438620',2018-09-12,CR824810166083/RMCPL21260/0,,2018-09-12,500.0,,-520274425.8400006,.
409000438620',2018-09-12,CR824813228719/RMCPL23821/0,,2018-09-12,4000.0,,-520278425.8400006,.
409000438620',2018-09-12,CR824811199479/RMCPL14558/0,,2018-09-12,8000.0,,-520286425.8400006,.
409000438620',2018-09-12,CR824811199477/RMCPL20272/0,,2018-09-12,3000.0,,-520289425.8400006,.
409000438620',2018-09-12,CR824811190870/RMCPL24712/0,,2018-09-12,4100.0,,-520293525.8400006,.
409000438620',2018-09-12,MICRO ATM WDL FEE DT11091,,2018-09-12,,278200.0,-520015325.8400006,.
409000438620',2018-09-12,MICRO ATM INC DATED 11091,,2018-09-12,,645.84,-520014680.00000066,.
409000438620',2018-09-12,MICRO ATM GST DATED 11091,,2018-09-12,,129.17,-520014550.83000064,.
409000438620',2018-09-12,MAW/502964XXXXXX8690/Karu,,2018-09-12,,1800.0,-520012750.83000064,.
409000438620',2018-09-12,TRF TO  Indiaforensic SERVICES I,,2018-09-12,8400000.0,,-528412750.83000064,.
409000438620',2018-09-12,MAW/502964XXXXXX7981/NAGA,,2018-09-12,,200.0,-528412550.83000064,.
409000438620',2018-09-12,MAW/502964XXXXXX8542/NAGA,,2018-09-12,,400.0,-528412150.83000064,.
409000438620',2018-09-12,AEPS INCOME DT 11-09-2018,,2018-09-12,,21006.04,-528391144.7900006,.
409000438620',2018-09-12,AEPS GST INC DT 11-09-201,,2018-09-12,,4201.21,-528386943.58000064,.
409000438620',2018-09-12,MICRO ATM WDL FEE DT12091,,2018-09-12,,176400.0,-528210543.58000064,.
409000438620',2018-09-12,MICRO ATM INC DATED 12091,,2018-09-12,,449.28,-528210094.30000067,.
409000438620',2018-09-12,MICRO ATM GST DATED 12091,,2018-09-12,,89.86,-528210004.44000065,.
409000438620',2018-09-12,AEPS ACQUIRING ADJ FEES 1,,2018-09-12,14.75,,-528210019.19000065,.
409000438620',2018-09-12,AEPS ACQUIRING CR ADJ FEE,,2018-09-12,309.1,,-528210328.2900007,.
409000438620',2018-09-12,AEPS ACQUIRING REP ADJ FE,,2018-09-12,,35.4,-528210292.8900007,.
409000438620',2018-09-13,Indiaforensic AEPS NPCI WDL SET,,2018-09-13,,13092900.0,-515117392.8900007,.
409000438620',2018-09-13,CR825210093725/RMCPL24117/0,,2018-09-13,5100.0,,-515122492.8900007,.
409000438620',2018-09-13,CR825210098363/RMCPL20272/0,,2018-09-13,4000.0,,-515126492.8900007,.
409000438620',2018-09-13,CR825110899088/RMCPL10452/0,,2018-09-13,6000.0,,-515132492.8900007,.
409000438620',2018-09-13,CR825110893137/RMCPL22333/0,,2018-09-13,600.0,,-515133092.8900007,.
409000438620',2018-09-13,CR825115958890/RMCPL11793/0,,2018-09-13,2000.0,,-515135092.8900007,.
409000438620',2018-09-13,CR825109883520/RMCPL11634/0,,2018-09-13,1000.0,,-515136092.8900007,.
409000438620',2018-09-13,CR825115962168/RMCPL22502/0,,2018-09-13,5000.0,,-515141092.8900007,.
409000438620',2018-09-13,CR825110891834/RMCPL28497/0,,2018-09-13,5000.0,,-515146092.8900007,.
409000438620',2018-09-13,CR825110892932/RMCPL22349/0,,2018-09-13,3000.0,,-515149092.8900007,.
409000438620',2018-09-13,CR825110893491/RMCPL26434/0,,2018-09-13,8000.0,,-515157092.8900007,.
409000438620',2018-09-13,CR825112921990/RMCPL25247/0,,2018-09-13,4000.0,,-515161092.8900007,.
409000438620',2018-09-13,CR825112927748/RMCPL23041/0,,2018-09-13,1000.0,,-515162092.8900007,.
409000438620',2018-09-13,CR825112927752/RMCPL23906/0,,2018-09-13,800.0,,-515162892.8900007,.
409000438620',2018-09-13,CR825113936167/RMCPL19766/0,,2018-09-13,1000.0,,-515163892.8900007,.
409000438620',2018-09-13,CR825110895057/RMCPL12826/0,,2018-09-13,500.0,,-515164392.8900007,.
409000438620',2018-09-13,CR825110895007/RMCPL15016/0,,2018-09-13,1000.0,,-515165392.8900007,.
409000438620',2018-09-13,CR825110895268/RMCPL19730/0,,2018-09-13,1400.0,,-515166792.8900007,.
409000438620',2018-09-13,CR825110895260/RMCPL21872/0,,2018-09-13,5600.0,,-515172392.8900007,.
409000438620',2018-09-13,CR825110895351/RMCPL09827/0,,2018-09-13,4000.0,,-515176392.8900007,.
409000438620',2018-09-13,CR825110895262/RMCPL24236/0,,2018-09-13,1000.0,,-515177392.8900007,.
409000438620',2018-09-13,CR825114954741/RMCPL19639/0,,2018-09-13,6000.0,,-515183392.8900007,.
409000438620',2018-09-13,CR825114954740/RMCPL23370/0,,2018-09-13,2000.0,,-515185392.8900007,.
409000438620',2018-09-13,CR825018780521/RMCPL09617/0,,2018-09-13,2500.0,,-515187892.8900007,.
409000438620',2018-09-13,CR825015741720/RMCPL18088/0,,2018-09-13,5000.0,,-515192892.8900007,.
409000438620',2018-09-13,CR825011684767/RMCPL15121/0,,2018-09-13,7000.0,,-515199892.8900007,.
409000438620',2018-09-13,CR825017765022/RMCPL25604/0,,2018-09-13,1000.0,,-515200892.8900007,.
409000438620',2018-09-13,CR825013722827/RMCPL22022/0,,2018-09-13,700.0,,-515201592.8900007,.
409000438620',2018-09-13,CR825011686381/RMCPL23088/0,,2018-09-13,2000.0,,-515203592.8900007,.
409000438620',2018-09-13,CR825011686376/RMCPL14827/0,,2018-09-13,10000.0,,-515213592.8900007,.
409000438620',2018-09-13,CR825012699270/RMCPL23228/0,,2018-09-13,2000.0,,-515215592.8900007,.
409000438620',2018-09-13,CR825014734706/RMCPL22919/0,,2018-09-13,500.0,,-515216092.8900007,.
409000438620',2018-09-13,CR825016754606/RMCPL25362/0,,2018-09-13,1100.0,,-515217192.8900007,.
409000438620',2018-09-13,CR825016754615/RMCPL24821/0,,2018-09-13,1000.0,,-515218192.8900007,.
409000438620',2018-09-13,CR825014734632/RMCPL21030/0,,2018-09-13,2000.0,,-515220192.8900007,.
409000438620',2018-09-13,CR825014734707/RMCPL24700/0,,2018-09-13,800.0,,-515220992.8900007,.
409000438620',2018-09-13,CR825318390155/RMCPL09600/1,,2018-09-13,500.0,,-515221492.8900007,.
409000438620',2018-09-13,CR825318390198/RMCPL09472/1,,2018-09-13,500.0,,-515221992.8900007,.
409000438620',2018-09-13,CR825312311460/RMCPL24532/1,,2018-09-13,5000.0,,-515226992.8900007,.
409000438620',2018-09-13,CR825311288272/RMCPL26314/1,,2018-09-13,1500.0,,-515228492.8900007,.
409000438620',2018-09-13,CR825313324748/RMCPL23562/1,,2018-09-13,3100.0,,-515231592.8900007,.
409000438620',2018-09-13,CR825310280697/RMCPL20518/1,,2018-09-13,1000.0,,-515232592.8900007,.
409000438620',2018-09-13,CR825310280716/RMCPL11793/1,,2018-09-13,3000.0,,-515235592.8900007,.
409000438620',2018-09-13,CR825312311453/RMCPL11029/1,,2018-09-13,4000.0,,-515239592.8900007,.
409000438620',2018-09-13,CR825311296307/RMCPL26646/1,,2018-09-13,500.0,,-515240092.8900007,.
409000438620',2018-09-13,CR825316357793/RMCPL25346/1,,2018-09-13,5000.0,,-515245092.8900007,.
409000438620',2018-09-13,CR825317371393/RMCPL11996/1,,2018-09-13,5000.0,,-515250092.8900007,.
409000438620',2018-09-13,AEPS ACQ CR ADJ FEES 1209,,2018-09-13,530.41,,-515250623.3000007,.
409000438620',2018-09-13,TRF TO  Indiaforensic SERVICES I,,2018-09-13,13400000.0,,-528650623.3000007,.
409000438620',2018-09-13,AEPS INCOME DT 12-09-2018,,2018-09-13,,33558.14,-528617065.16000074,.
409000438620',2018-09-13,AEPS GST INC DT 12-09-201,,2018-09-13,,6711.63,-528610353.53000075,.
409000438620',2018-09-14,MAW/502964XXXXXX7427/Karu,,2018-09-14,,1800.0,-528608553.53000075,.
409000438620',2018-09-14,Indiaforensic AEPS NPCI WDL SET,,2018-09-14,,11661100.0,-516947453.53000075,.
409000438620',2018-09-14,MAW/502964XXXXXX0702/Karu,,2018-09-14,,1700.0,-516945753.53000075,.
409000438620',2018-09-14,MAW/502964XXXXXX6630/Karu,,2018-09-14,,1700.0,-516944053.53000075,.
409000438620',2018-09-14,MAW/502964XXXXXX4599/Karu,,2018-09-14,,1700.0,-516942353.53000075,.
409000438620',2018-09-14,MAW/502964XXXXXX2617/Karu,,2018-09-14,,1700.0,-516940653.53000075,.
409000438620',2018-09-14,MAW/502964XXXXXX7625/Karu,,2018-09-14,,1300.0,-516939353.53000075,.
409000438620',2018-09-14,MAW/502964XXXXXX0636/Karu,,2018-09-14,,1700.0,-516937653.53000075,.
409000438620',2018-09-14,MAW/502964XXXXXX2502/Karu,,2018-09-14,,1700.0,-516935953.53000075,.
409000438620',2018-09-14,TRF TO  Indiaforensic SERVICES I,,2018-09-14,11700000.0,,-528635953.53000075,.
409000438620',2018-09-14,AEPS ACQUIRING ADJ FEES 1,,2018-09-14,2.95,,-528635956.48000073,.
409000438620',2018-09-14,MAW/502964XXXXXX7658/Karu,,2018-09-14,,1000.0,-528634956.48000073,.
409000438620',2018-09-14,MICRO ATM WDL FEE DT12091,,2018-09-14,,247400.0,-528387556.48000073,.
409000438620',2018-09-14,MICRO ATM INC DATED 12091,,2018-09-14,,678.6,-528386877.8800007,.
409000438620',2018-09-14,MICRO ATM GST DATED 12091,,2018-09-14,,135.72,-528386742.1600007,.
409000438620',2018-09-14,MICRO ATM WDL FEE DT13091,,2018-09-14,,207500.0,-528179242.1600007,.
409000438620',2018-09-14,MICRO ATM INC DATED 13091,,2018-09-14,,516.24,-528178725.9200007,.
409000438620',2018-09-14,MICRO ATM GST DATED 13091,,2018-09-14,,103.25,-528178622.6700007,.
409000438620',2018-09-14,AEPS INCOME DT 13-09-2018,,2018-09-14,,29323.52,-528149299.1500007,.
409000438620',2018-09-14,AEPS GST INC DT 13-09-201,,2018-09-14,,5864.7,-528143434.4500007,.
409000438620',2018-09-14,MICRO ATM WDL FEE DT13091,,2018-09-14,,138400.0,-528005034.4500007,.
409000438620',2018-09-14,MICRO ATM INC DATED 13091,,2018-09-14,,326.88,-528004707.5700007,.
409000438620',2018-09-14,MICRO ATM GST DATED 13091,,2018-09-14,,65.38,-528004642.1900007,.
409000438620',2018-09-14,TRF TO  Indiaforensic SERVICES I,,2018-09-14,400000.0,,-528404642.1900007,.
409000438620',2018-09-14,MICRO ATM WDL FEE DT14091,,2018-09-14,,169600.0,-528235042.1900007,.
409000438620',2018-09-14,MICRO ATM INC DATED 14091,,2018-09-14,,327.24,-528234714.9500007,.
409000438620',2018-09-14,MICRO ATM GST DATED 14091,,2018-09-14,,65.45,-528234649.5000007,.
409000438620',2018-09-15,MAW/502964XXXXXX9796/NAGA,,2018-09-15,,1100.0,-528233549.5000007,.
409000438620',2018-09-15,Indiaforensic AEPS NPCI WDL SET1,,2018-09-15,,12001100.0,-516232449.5000007,.
409000438620',2018-09-15,CR825413542567/RMCPL11793/1,,2018-09-15,4000.0,,-516236449.5000007,.
409000438620',2018-09-15,CR825410495898/RMCPL23228/1,,2018-09-15,3000.0,,-516239449.5000007,.
409000438620',2018-09-15,CR825418598482/RMCPL11019/1,,2018-09-15,500.0,,-516239949.5000007,.
409000438620',2018-09-15,CR825418599864/RMCPL17831/1,,2018-09-15,2200.0,,-516242149.5000007,.
409000438620',2018-09-15,CR825418598450/RMCPL12666/1,,2018-09-15,10000.0,,-516252149.5000007,.
409000438620',2018-09-15,CR825418598513/RMCPL17574/1,,2018-09-15,1000.0,,-516253149.5000007,.
409000438620',2018-09-15,CR825418601918/RMCPL19959/1,,2018-09-15,700.0,,-516253849.5000007,.
409000438620',2018-09-15,CR825410495903/RMCPL25416/1,,2018-09-15,1000.0,,-516254849.5000007,.
409000438620',2018-09-15,CR825415564449/RMCPL20307/1,,2018-09-15,2500.0,,-516257349.5000007,.
409000438620',2018-09-15,CR825411515307/RMCPL21894/1,,2018-09-15,10000.0,,-516267349.5000007,.
409000438620',2018-09-15,CR825413542667/RMCPL28382/1,,2018-09-15,1000.0,,-516268349.5000007,.
409000438620',2018-09-15,CR825413536284/RMCPL13065/1,,2018-09-15,1500.0,,-516269849.5000007,.
409000438620',2018-09-15,CR825418598457/RMCPL17491/1,,2018-09-15,2000.0,,-516271849.5000007,.
409000438620',2018-09-15,CR825409473309/RMCPL24700/1,,2018-09-15,1100.0,,-516272949.5000007,.
409000438620',2018-09-15,CR825410493135/RMCPL17831/1,,2018-09-15,3100.0,,-516276049.5000007,.
409000438620',2018-09-15,CR825410493140/RMCPL27843/1,,2018-09-15,500.0,,-516276549.5000007,.
409000438620',2018-09-15,CR825414550348/RMCPL18408/1,,2018-09-15,1000.0,,-516277549.5000007,.
409000438620',2018-09-15,CR825410490043/RMCPL15535/1,,2018-09-15,10000.0,,-516287549.5000007,.
409000438620',2018-09-15,CR825411518601/RMCPL18244/1,,2018-09-15,2000.0,,-516289549.5000007,.
409000438620',2018-09-15,CR825408472677/RMCPL25806/1,,2018-09-15,500.0,,-516290049.5000007,.
409000438620',2018-09-15,CR825419614691/RMCPL09071/1,,2018-09-15,4000.0,,-516294049.5000007,.
409000438620',2018-09-15,CR825416572935/RMCPL18729/1,,2018-09-15,4000.0,,-516298049.5000007,.
409000438620',2018-09-15,CR825408468589/RMCPL18136/1,,2018-09-15,5000.0,,-516303049.5000007,.
409000438620',2018-09-15,CR825408468720/RMCPL19766/1,,2018-09-15,500.0,,-516303549.5000007,.
409000438620',2018-09-15,CR825413542894/RMCPL25247/1,,2018-09-15,2500.0,,-516306049.5000007,.
409000438620',2018-09-15,CR825408466834/RMCPL16684/1,,2018-09-15,600.0,,-516306649.5000007,.
409000438620',2018-09-15,CR825408466971/RMCPL23283/1,,2018-09-15,500.0,,-516307149.5000007,.
409000438620',2018-09-15,CR825408467341/RMCPL26120/1,,2018-09-15,3300.0,,-516310449.5000007,.
409000438620',2018-09-15,CR825414550338/RMCPL24462/1,,2018-09-15,4000.0,,-516314449.5000007,.
409000438620',2018-09-15,CR825408467628/RMCPL24691/1,,2018-09-15,10000.0,,-516324449.5000007,.
409000438620',2018-09-15,CR825408467711/RMCPL21872/1,,2018-09-15,6000.0,,-516330449.5000007,.
409000438620',2018-09-15,CR825408468256/RMCPL26120/1,,2018-09-15,3300.0,,-516333749.5000007,.
409000438620',2018-09-15,CR825413539218/RMCPL28497/1,,2018-09-15,2000.0,,-516335749.5000007,.
409000438620',2018-09-15,CR825413539895/RMCPL00195/1,,2018-09-15,500.0,,-516336249.5000007,.
409000438620',2018-09-15,CR825413542615/RMCPL11862/1,,2018-09-15,3000.0,,-516339249.5000007,.
409000438620',2018-09-15,CR825413539753/RMCPL23569/1,,2018-09-15,1500.0,,-516340749.5000007,.
409000438620',2018-09-15,CR825408468711/RMCPL11776/1,,2018-09-15,1500.0,,-516342249.5000007,.
409000438620',2018-09-15,CR825418611968/RMCPL09135/1,,2018-09-15,1000.0,,-516343249.5000007,.
409000438620',2018-09-15,MAW/502964XXXXXX7354/Karu,,2018-09-15,,1700.0,-516341549.5000007,.
409000438620',2018-09-15,TRFT O  Indiaforensic SERVICES I,,2018-09-15,10000000.0,,-526341549.5000007,.
409000438620',2018-09-15,TRFT O  Indiaforensic SERVICES I,,2018-09-15,2000000.0,,-528341549.5000007,.
409000438620',2018-09-15,AEPS INCOME DT 14-09-2018,,2018-09-15,,30609.72,-528310939.7800007,.
409000438620',2018-09-15,AEPS GST INC DT 14-09-201,,2018-09-15,,6121.94,-528304817.8400007,.
409000438620',2018-09-15,AEPS ACQCR ADJ FEES 14091,,2018-09-15,431.29,,-528305249.1300007,.
409000438620',2018-09-15,MAW/502964XXXXXX6629/Karu,,2018-09-15,,1700.0,-528303549.1300007,.
409000438620',2018-09-15,MICRO ATM WDL FEE DT14091,,2018-09-15,,173800.0,-528129749.1300007,.
409000438620',2018-09-15,MICRO ATM INC DATED 14091,,2018-09-15,,434.88,-528129314.2500007,.
409000438620',2018-09-15,MICRO ATM GST DATED 14091,,2018-09-15,,86.98,-528129227.2700007,.
409000438620',2018-09-15,AEPS PAY Indiaforensic 1409,,2018-09-15,,658.02,-528128569.2500007,.
409000438620',2018-09-15,MAW/502964XXXXXX0296/NAGA,,2018-09-15,,800.0,-528127769.2500007,.
409000438620',2018-09-15,MICRO ATM WDL FEE DT15091,,2018-09-15,,136800.0,-527990969.2500007,.
409000438620',2018-09-15,MICRO ATM INC DATED 15091,,2018-09-15,,309.96,-527990659.29000074,.
409000438620',2018-09-15,MICRO ATM GST DATED 15091,,2018-09-15,,61.99,-527990597.3000007,.
409000438620',2018-09-17,Indiaforensic AEPS NPCI WDL SET1,,2018-09-17,,10150100.0,-517840497.3000007,.
409000438620',2018-09-17,Indiaforensic AEPS NPCI WDL SET1,,2018-09-17,,6310000.0,-511530497.3000007,.
409000438620',2018-09-17,TRF TO  Indiaforensic SERVICES I,,2018-09-17,2000000.0,,-513530497.3000007,.
409000438620',2018-09-17,TRF TO  Indiaforensic SERVICES I,,2018-09-17,15000000.0,,-528530497.3000007,.
409000438620',2018-09-17,MAW/502964XXXXXX4574/Karu,,2018-09-17,,1700.0,-528528797.3000007,.
409000438620',2018-09-17,MICRO ATM WDL FEE DT15091,,2018-09-17,,196100.0,-528332697.3000007,.
409000438620',2018-09-17,MICRO ATM WDL FEE DT16091,,2018-09-17,,418400.0,-527914297.3000007,.
409000438620',2018-09-17,AEPS PAY Indiaforensic 1509,,2018-09-17,,297.23,-527914000.0700007,.
409000438620',2018-09-17,NPCI SETELEMENT DIFF_1509,,2018-09-17,,4000.0,-527910000.0700007,.
409000438620',2018-09-17,NPCI SETELEMENT DIFF_1609,,2018-09-17,,21500.0,-527888500.0700007,.
409000438620',2018-09-17,MICRO ATM WDL FEE DT17091,,2018-09-17,,181400.0,-527707100.0700007,.
409000438620',2018-09-17,MICRO ATM INC DATED 15091,,2018-09-17,,440.64,-527706659.4300007,.
409000438620',2018-09-17,MICRO ATM GST DATED 15091,,2018-09-17,,88.13,-527706571.3000007,.
409000438620',2018-09-17,MICRO ATM INC DATED 16091,,2018-09-17,,998.64,-527705572.66000074,.
409000438620',2018-09-17,MICRO ATM GST DATED 16091,,2018-09-17,,199.73,-527705372.9300007,.
409000438620',2018-09-17,MICRO ATM INC DATED 17091,,2018-09-17,,395.64,-527704977.29000074,.
409000438620',2018-09-17,MICRO ATM GST DATED 17091,,2018-09-17,,79.13,-527704898.16000074,.
409000438620',2018-09-17,AEPS INCOME DT 15-09-2018,,2018-09-17,,25791.8,-527679106.3600007,.
409000438620',2018-09-17,AEPS GST INCDT 15-09-2018,,2018-09-17,,5158.36,-527673948.0000007,.
409000438620',2018-09-17,AEPS INCOME DT 16-09-2018,,2018-09-17,,17034.35,-527656913.6500007,.
409000438620',2018-09-17,AEPS GST INCDT 16-09-2018,,2018-09-17,,3406.87,-527653506.7800007,.
409000438620',2018-09-17,AEPS ACQUIRING ADJ FEES 1,,2018-09-17,17.7,,-527653524.4800007,.
409000438620',2018-09-17,AEPS ACQ REP ADJ FEES 150,,2018-09-17,,11.8,-527653512.68000066,.
409000438620',2018-09-17,TRF TO  Indiaforensic SERVICES I,,2018-09-17,300000.0,,-527953512.68000066,.
409000438620',2018-09-18,MAW/502964XXXXXX2110/NAGA,,2018-09-18,,900.0,-527952612.68000066,.
409000438620',2018-09-18,MAW/502964XXXXXX0486/NAGA,,2018-09-18,,900.0,-527951712.68000066,.
409000438620',2018-09-18,Indiaforensic AEPS NPCI WDL SET1,,2018-09-18,,8495900.0,-519455812.68000066,.
409000438620',2018-09-18,CR825517815484/RMCPL18654/1,,2018-09-18,1000.0,,-519456812.68000066,.
409000438620',2018-09-18,CR825511735245/RMCPL16439/1,,2018-09-18,10000.0,,-519466812.68000066,.
409000438620',2018-09-18,CR825518826423/RMCPL11949/1,,2018-09-18,1000.0,,-519467812.68000066,.
409000438620',2018-09-18,CR825513760815/RMCPL12663/1,,2018-09-18,1100.0,,-519468912.68000066,.
409000438620',2018-09-18,CR825515791935/RMCPL23592/1,,2018-09-18,500.0,,-519469412.68000066,.
409000438620',2018-09-18,CR825512757689/RMCPL11529/1,,2018-09-18,1500.0,,-519470912.68000066,.
409000438620',2018-09-18,CR825517822586/RMCPL26361/1,,2018-09-18,500.0,,-519471412.68000066,.
409000438620',2018-09-18,CR825508688514/RMCPL23949/1,,2018-09-18,2000.0,,-519473412.68000066,.
409000438620',2018-09-18,CR825511738155/RMCPL11612/1,,2018-09-18,1600.0,,-519475012.68000066,.
409000438620',2018-09-18,CR825511728786/RMCPL19659/1,,2018-09-18,1000.0,,-519476012.68000066,.
409000438620',2018-09-18,CR825511735321/RMCPL20482/1,,2018-09-18,3000.0,,-519479012.68000066,.
409000438620',2018-09-18,CR825511735323/RMCPL17978/1,,2018-09-18,3500.0,,-519482512.68000066,.
409000438620',2018-09-18,CR825513767167/RMCPL09592/1,,2018-09-18,1000.0,,-519483512.68000066,.
409000438620',2018-09-18,CR825515796262/RMCPL18829/1,,2018-09-18,10000.0,,-519493512.68000066,.
409000438620',2018-09-18,CR825510717769/RMCPL28800/1,,2018-09-18,4000.0,,-519497512.68000066,.
409000438620',2018-09-18,CR825510707878/RMCPL21549/1,,2018-09-18,1000.0,,-519498512.68000066,.
409000438620',2018-09-18,CR825518830871/RMCPL28708/1,,2018-09-18,4200.0,,-519502712.68000066,.
409000438620',2018-09-18,CR825508688516/RMCPL22875/1,,2018-09-18,500.0,,-519503212.68000066,.
409000438620',2018-09-18,CR825510721033/RMCPL19597/1,,2018-09-18,2000.0,,-519505212.68000066,.
409000438620',2018-09-18,CR825610954747/RMCPL17491/1,,2018-09-18,10000.0,,-519515212.68000066,.
409000438620',2018-09-18,CR825610954757/RMCPL18364/1,,2018-09-18,500.0,,-519515712.68000066,.
409000438620',2018-09-18,CR825612981585/RMCPL27346/1,,2018-09-18,1900.0,,-519517612.68000066,.
409000438620',2018-09-18,CR825610942024/RMCPL11656/1,,2018-09-18,1000.0,,-519518612.68000066,.
409000438620',2018-09-18,CR825616039998/RMCPL21533/1,,2018-09-18,10000.0,,-519528612.68000066,.
409000438620',2018-09-18,CR825614010127/RMCPL21736/1,,2018-09-18,500.0,,-519529112.68000066,.
409000438620',2018-09-18,CR825614021932/RMCPL20077/1,,2018-09-18,500.0,,-519529612.68000066,.
409000438620',2018-09-18,CR825610946182/RMCPL22898/1,,2018-09-18,4000.0,,-519533612.68000066,.
409000438620',2018-09-18,CR825610946185/RMCPL15381/1,,2018-09-18,1000.0,,-519534612.68000066,.
409000438620',2018-09-18,CR825615029007/RMCPL23853/1,,2018-09-18,800.0,,-519535412.68000066,.
409000438620',2018-09-18,CR825614017952/RMCPL17491/1,,2018-09-18,10000.0,,-519545412.68000066,.
409000438620',2018-09-18,CR825614017967/RMCPL24928/1,,2018-09-18,3600.0,,-519549012.68000066,.
409000438620',2018-09-18,TRF TO  Indiaforensic SERVICES I,,2018-09-18,9100000.0,,-528649012.68000066,.
409000438620',2018-09-18,MICRO ATM WDL FEE DT17091,,2018-09-18,,337800.0,-528311212.68000066,.
409000438620',2018-09-18,MICRO ATM INC DATED 17091,,2018-09-18,,679.32,-528310533.36000067,.
409000438620',2018-09-18,MICRO ATM GST DATED 17091,,2018-09-18,,135.86,-528310397.50000066,.
409000438620',2018-09-18,MAW/502964XXXXXX6016/Akol,,2018-09-18,,2000.0,-528308397.50000066,.
409000438620',2018-09-18,MICRO ATM WDL FEE DT18091,,2018-09-18,,199300.0,-528109097.50000066,.
409000438620',2018-09-18,MICRO ATM INC DATED 18091,,2018-09-18,,447.48,-528108650.02000064,.
409000438620',2018-09-18,MICRO ATM GST DATED 18091,,2018-09-18,,89.5,-528108560.52000064,.
409000438620',2018-09-18,MAW/502964XXXXXX4836/Karu,,2018-09-18,,1800.0,-528106760.52000064,.
409000438620',2018-09-18,MAW/502964XXXXXX4565/Akol,,2018-09-18,,300.0,-528106460.52000064,.
409000438620',2018-09-18,TRF TO  Indiaforensic SERVICES I,,2018-09-18,500000.0,,-528606460.52000064,.
409000438620',2018-09-18,AEPS INCOME DT 17-09-2018,,2018-09-18,,22086.69,-528584373.83000064,.
409000438620',2018-09-18,AEPS GST INC DT 17-09-201,,2018-09-18,,4417.34,-528579956.49000067,.
409000438620',2018-09-18,AEPS ACQ CR ADJ FEES 1709,,2018-09-18,318.01,,-528580274.50000066,.
409000438620',2018-09-18,AEPS ACQ REP ADJ FEES 170,,2018-09-18,,2.95,-528580271.55000067,.
409000438620',2018-09-19,Indiaforensic AEPS NPCI WDL SET1,,2018-09-19,,9386100.0,-519194171.55000067,.
409000438620',2018-09-19,CR825911835419/RMCPL27487/1,,2018-09-19,1000.0,,-519195171.55000067,.
409000438620',2018-09-19,CR825910820694/RMCPL18726/1,,2018-09-19,2700.0,,-519197871.55000067,.
409000438620',2018-09-19,CR825916934155/RMCPL24076/1,,2018-09-19,1000.0,,-519198871.55000067,.
409000438620',2018-09-19,CR825812556390/RMCPL13501/1,,2018-09-19,500.0,,-519199371.55000067,.
409000438620',2018-09-19,CR825817634506/RMCPL19591/1,,2018-09-19,1000.0,,-519200371.55000067,.
409000438620',2018-09-19,CR825817640642/RMCPL25428/1,,2018-09-19,1000.0,,-519201371.55000067,.
409000438620',2018-09-19,CR825817646184/RMCPL24341/1,,2018-09-19,500.0,,-519201871.55000067,.
409000438620',2018-09-19,CR825817646171/RMCPL14643/1,,2018-09-19,1000.0,,-519202871.55000067,.
409000438620',2018-09-19,CR825818673927/RMCPL13013/1,,2018-09-19,3000.0,,-519205871.55000067,.
409000438620',2018-09-19,CR825811514524/RMCPL19639/1,,2018-09-19,1000.0,,-519206871.55000067,.
409000438620',2018-09-19,CR825811523141/RMCPL16457/1,,2018-09-19,6000.0,,-519212871.55000067,.
409000438620',2018-09-19,CR825813573793/RMCPL11613/1,,2018-09-19,1000.0,,-519213871.55000067,.
409000438620',2018-09-19,CR825811525352/RMCPL22093/1,,2018-09-19,1000.0,,-519214871.55000067,.
409000438620',2018-09-19,CR825811525350/RMCPL28678/1,,2018-09-19,2000.0,,-519216871.55000067,.
409000438620',2018-09-19,CR825815605745/RMCPL14060/1,,2018-09-19,2000.0,,-519218871.55000067,.
409000438620',2018-09-19,CR825818658745/RMCPL13876/1,,2018-09-19,4000.0,,-519222871.55000067,.
409000438620',2018-09-19,CR825811531004/RMCPL26443/1,,2018-09-19,1400.0,,-519224271.55000067,.
409000438620',2018-09-19,CR825810508970/RMCPL09617/1,,2018-09-19,2300.0,,-519226571.55000067,.
409000438620',2018-09-19,CR825812545045/RMCPL21906/1,,2018-09-19,600.0,,-519227171.55000067,.
409000438620',2018-09-19,CR825813562208/RMCPL19942/1,,2018-09-19,4800.0,,-519231971.55000067,.
409000438620',2018-09-19,CR825812556317/RMCPL12961/1,,2018-09-19,1200.0,,-519233171.55000067,.
409000438620',2018-09-19,CR825711218055/RMCPL25049/1,,2018-09-19,500.0,,-519233671.55000067,.
409000438620',2018-09-19,CR825711218041/RMCPL22866/1,,2018-09-19,500.0,,-519234171.55000067,.
409000438620',2018-09-19,CR825711222478/RMCPL20773/1,,2018-09-19,2000.0,,-519236171.55000067,.
409000438620',2018-09-19,CR825710202597/RMCPL15535/1,,2018-09-19,1000.0,,-519237171.55000067,.
409000438620',2018-09-19,CR825710202560/RMCPL26854/1,,2018-09-19,1000.0,,-519238171.55000067,.
409000438620',2018-09-19,CR825710198707/RMCPL16457/1,,2018-09-19,10000.0,,-519248171.55000067,.
409000438620',2018-09-19,CR825710198709/RMCPL22472/1,,2018-09-19,3000.0,,-519251171.55000067,.
409000438620',2018-09-19,CR825710206288/RMCPL26685/1,,2018-09-19,4000.0,,-519255171.55000067,.
409000438620',2018-09-19,CR825710206290/RMCPL12796/1,,2018-09-19,1200.0,,-519256371.55000067,.
409000438620',2018-09-19,CR825715280563/RMCPL25532/1,,2018-09-19,3000.0,,-519259371.55000067,.
409000438620',2018-09-19,CR825716283585/RMCPL16250/1,,2018-09-19,500.0,,-519259871.55000067,.
409000438620',2018-09-19,CR825716283564/RMCPL21742/1,,2018-09-19,2500.0,,-519262371.55000067,.
409000438620',2018-09-19,CR825709178660/RMCPL24555/1,,2018-09-19,4600.0,,-519266971.55000067,.
409000438620',2018-09-19,CR825710202600/RMCPL09542/1,,2018-09-19,700.0,,-519267671.55000067,.
409000438620',2018-09-19,CR825711222438/RMCPL21533/1,,2018-09-19,10000.0,,-519277671.55000067,.
409000438620',2018-09-19,CR825713249145/RMCPL09612/1,,2018-09-19,10000.0,,-519287671.55000067,.
409000438620',2018-09-19,TRF TO  Indiaforensic SERVICES I,,2018-09-19,5000000.0,,-524287671.55000067,.
409000438620',2018-09-19,TRF TO  Indiaforensic SERVICES I,,2018-09-19,4000000.0,,-528287671.55000067,.
409000438620',2018-09-19,MICRO ATM WDL FEE DT18091,,2018-09-19,,305100.0,-527982571.55000067,.
409000438620',2018-09-19,MICRO ATM INC DATED 18091,,2018-09-19,,717.12,-527981854.43000066,.
409000438620',2018-09-19,MICRO ATM GST DATED 18091,,2018-09-19,,143.42,-527981711.01000065,.
409000438620',2018-09-19,MICRO ATM WDL FEE DT19091,,2018-09-19,,231600.0,-527750111.01000065,.
409000438620',2018-09-19,MICRO ATM INC DATED 19091,,2018-09-19,,571.32,-527749539.69000065,.
409000438620',2018-09-19,MICRO ATM GST DATED 19091,,2018-09-19,,114.26,-527749425.43000066,.
409000438620',2018-09-19,AEPS INCOME DT 18-09-2018,,2018-09-19,,24619.82,-527724805.61000067,.
409000438620',2018-09-19,AEPS GST INC DT 18-09-201,,2018-09-19,,4923.96,-527719881.6500007,.
409000438620',2018-09-19,AEPS ACQ CR ADJ FEES 1809,,2018-09-19,378.19,,-527720259.8400007,.
409000438620',2018-09-19,TRF TO  Indiaforensic SERVICES I,,2018-09-19,500000.0,,-528220259.8400007,.
409000438620',2018-09-20,CB825012695127/RMCPL24928/0,,2018-09-20,500.0,,-528220759.8400007,.
409000438620',2018-09-20,Indiaforensic AEPS NPCI WDL SET1,,2018-09-20,,8097300.0,-520123459.8400007,.
409000438620',2018-09-20,CR826012181229/RMCPL26592/1,,2018-09-20,500.0,,-520123959.8400007,.
409000438620',2018-09-20,CR826012168678/RMCPL19942/1,,2018-09-20,500.0,,-520124459.8400007,.
409000438620',2018-09-20,CR826010145312/RMCPL28890/1,,2018-09-20,5000.0,,-520129459.8400007,.
409000438620',2018-09-20,CR826013191639/RMCPL21824/1,,2018-09-20,4000.0,,-520133459.8400007,.
409000438620',2018-09-20,CR826017253850/RMCPL19963/1,,2018-09-20,2000.0,,-520135459.8400007,.
409000438620',2018-09-20,CR826009115697/RMCPL20722/1,,2018-09-20,1000.0,,-520136459.8400007,.
409000438620',2018-09-20,CR826011151018/RMCPL13013/1,,2018-09-20,3000.0,,-520139459.8400007,.
409000438620',2018-09-20,CR826011151021/RMCPL18095/1,,2018-09-20,3000.0,,-520142459.8400007,.
409000438620',2018-09-20,CR826017248487/RMCPL03676/1,,2018-09-20,500.0,,-520142959.8400007,.
409000438620',2018-09-20,CR826016244053/RMCPL25432/1,,2018-09-20,7000.0,,-520149959.8400007,.
409000438620',2018-09-20,AEPS INCOME DT 19-09-2018,,2018-09-20,,21519.26,-520128440.5800007,.
409000438620',2018-09-20,AEPS GST INC DT 19-09-201,,2018-09-20,,4303.85,-520124136.7300007,.
409000438620',2018-09-20,AEPS ACQ CR ADJ FEES 1909,,2018-09-20,115.05,,-520124251.7800007,.
409000438620',2018-09-20,TRF TO  Indiaforensic SERVICES I,,2018-09-20,8500000.0,,-528624251.7800007,.
409000438620',2018-09-21,Indiaforensic AEPS NPCI WDL SET,,2018-09-21,,7500800.0,-521123451.7800007,.
409000438620',2018-09-21,FUND TRF TO  Indiaforensic SERVI,,2018-09-21,7500000.0,,-528623451.7800007,.
409000438620',2018-09-21,NPCI SETELEMENT DIFF_1909,,2018-09-21,,1000.0,-528622451.7800007,.
409000438620',2018-09-21,MAW/502964XXXXXX9031/NAGA,,2018-09-21,,1000.0,-528621451.7800007,.
409000438620',2018-09-21,MICRO ATM WDL FEE DT19091,,2018-09-21,,250300.0,-528371151.7800007,.
409000438620',2018-09-21,MICRO ATM INC DATED 19091,,2018-09-21,,577.8,-528370573.9800007,.
409000438620',2018-09-21,MICRO ATM GST DATED 19091,,2018-09-21,,115.56,-528370458.4200007,.
409000438620',2018-09-21,MICRO ATM WDL FEE DT20091,,2018-09-21,,193500.0,-528176958.4200007,.
409000438620',2018-09-21,MICRO ATM INC DATED 20091,,2018-09-21,,483.12,-528176475.30000067,.
409000438620',2018-09-21,MICRO ATM GST DATED 20091,,2018-09-21,,96.62,-528176378.68000066,.
409000438620',2018-09-21,AEPS INCOME DT 20-09-2018,,2018-09-21,,19886.88,-528156491.80000067,.
409000438620',2018-09-21,AEPS GST INC DT 20-09-201,,2018-09-21,,3977.38,-528152514.4200007,.
409000438620',2018-09-21,FUND TRF TO  Indiaforensic SERVI,,2018-09-21,400000.0,,-528552514.4200007,.
409000438620',2018-09-21,AEPS PAY Indiaforensic 2009,,2018-09-21,,298.93,-528552215.49000067,.
409000438620',2018-09-21,MICRO ATM WDL FEE DT20091,,2018-09-21,,296400.0,-528255815.49000067,.
409000438620',2018-09-21,MICRO ATM INC DATED 20091,,2018-09-21,,613.8,-528255201.69000065,.
409000438620',2018-09-21,MICRO ATM GST DATED 20091,,2018-09-21,,122.76,-528255078.93000066,.
409000438620',2018-09-21,MICRO ATM WDL FEE DT21091,,2018-09-21,,216500.0,-528038578.93000066,.
409000438620',2018-09-21,MICRO ATM INC DATED 21091,,2018-09-21,,490.32,-528038088.61000067,.
409000438620',2018-09-21,MICRO ATM GST DATED 21091,,2018-09-21,,98.06,-528037990.55000067,.
409000438620',2018-09-24,MAW/502964XXXXXX0502/NAGA,,2018-09-24,,1100.0,-528036890.55000067,.
409000438620',2018-09-24,CR826111430714/RMCPL16251/1,,2018-09-24,1000.0,,-528037890.55000067,.
409000438620',2018-09-24,CR826112443718/RMCPL26770/1,,2018-09-24,1000.0,,-528038890.55000067,.
409000438620',2018-09-24,CR826115497785/RMCPL24609/1,,2018-09-24,1000.0,,-528039890.55000067,.
409000438620',2018-09-24,CR826111435504/RMCPL28497/1,,2018-09-24,2500.0,,-528042390.55000067,.
409000438620',2018-09-24,CR826116516516/RMCPL20307/1,,2018-09-24,1000.0,,-528043390.55000067,.
409000438620',2018-09-24,CR826119571766/RMCPL11265/1,,2018-09-24,1000.0,,-528044390.55000067,.
409000438620',2018-09-24,CR826113470792/RMCPL24066/1,,2018-09-24,800.0,,-528045190.55000067,.
409000438620',2018-09-24,CR826117524554/RMCPL09386/1,,2018-09-24,500.0,,-528045690.55000067,.
409000438620',2018-09-24,CR826114486373/RMCPL20178/1,,2018-09-24,1000.0,,-528046690.55000067,.
409000438620',2018-09-24,CR826118538421/RMCPL19146/1,,2018-09-24,500.0,,-528047190.55000067,.
409000438620',2018-09-24,CR826219844286/RMCPL23833/1,,2018-09-24,10000.0,,-528057190.55000067,.
409000438620',2018-09-24,CR826212725111/RMCPL26544/1,,2018-09-24,7300.0,,-528064490.55000067,.
409000438620',2018-09-24,CR826212714641/RMCPL09582/1,,2018-09-24,500.0,,-528064990.55000067,.
409000438620',2018-09-24,CR826209671909/RMCPL20928/1,,2018-09-24,1500.0,,-528066490.55000067,.
409000438620',2018-09-24,CR826214745737/RMCPL14060/1,,2018-09-24,500.0,,-528066990.55000067,.
409000438620',2018-09-24,CR826213741387/RMCPL09612/1,,2018-09-24,3000.0,,-528069990.55000067,.
409000438620',2018-09-24,CR826213741407/RMCPL19783/1,,2018-09-24,2200.0,,-528072190.55000067,.
409000438620',2018-09-24,CR826209671897/RMCPL26348/1,,2018-09-24,1500.0,,-528073690.55000067,.
409000438620',2018-09-24,CR826209671910/RMCPL03043/1,,2018-09-24,3000.0,,-528076690.55000067,.
409000438620',2018-09-24,CR826210688649/RMCPL22291/1,,2018-09-24,3000.0,,-528079690.55000067,.
409000438620',2018-09-24,CR826214750216/RMCPL22038/1,,2018-09-24,500.0,,-528080190.55000067,.
409000438620',2018-09-24,CR826213736565/RMCPL16914/1,,2018-09-24,500.0,,-528080690.55000067,.
409000438620',2018-09-24,CR826211699376/RMCPL19631/1,,2018-09-24,2000.0,,-528082690.55000067,.
409000438620',2018-09-24,CR826215760784/RMCPL19485/1,,2018-09-24,1800.0,,-528084490.55000067,.
409000438620',2018-09-24,CR826212725782/RMCPL24718/1,,2018-09-24,2000.0,,-528086490.55000067,.
409000438620',2018-09-24,MAW/502964XXXXXX2699/Karu,,2018-09-24,,1700.0,-528084790.55000067,.
409000438620',2018-09-24,MAW/502964XXXXXX2326/Karu,,2018-09-24,,1700.0,-528083090.55000067,.
409000438620',2018-09-24,MAW/502964XXXXXX6017/Karu,,2018-09-24,,1700.0,-528081390.55000067,.
409000438620',2018-09-24,MAW/502964XXXXXX6461/Karu,,2018-09-24,,1700.0,-528079690.55000067,.
409000438620',2018-09-24,MAW/502964XXXXXX8931/Karu,,2018-09-24,,1700.0,-528077990.55000067,.
409000438620',2018-09-24,MAW/502964XXXXXX2659/Karu,,2018-09-24,,1700.0,-528076290.55000067,.
409000438620',2018-09-24,Indiaforensic AEPS NPCI WDL SET,,2018-09-24,,7035300.0,-521040990.55000067,.
409000438620',2018-09-24,MAW/502964XXXXXX6867/Karu,,2018-09-24,,1700.0,-521039290.55000067,.
409000438620',2018-09-24,MAW/502964XXXXXX4752/Karu,,2018-09-24,,1700.0,-521037590.55000067,.
409000438620',2018-09-24,MAW/502964XXXXXX0153/Karu,,2018-09-24,,1700.0,-521035890.55000067,.
409000438620',2018-09-24,MAW/502964XXXXXX8972/Karu,,2018-09-24,,1700.0,-521034190.55000067,.
409000438620',2018-09-24,MAW/502964XXXXXX0609/Karu,,2018-09-24,,1700.0,-521032490.55000067,.
409000438620',2018-09-24,Indiaforensic AEPS NPCI WDL SET,,2018-09-24,,6940100.0,-514092390.55000067,.
409000438620',2018-09-24,Indiaforensic AEPS NPCI WDL SET,,2018-09-24,,4423800.0,-509668590.55000067,.
409000438620',2018-09-24,MAW/502964XXXXXX0429/Karu,,2018-09-24,,4800.0,-509663790.55000067,.
409000438620',2018-09-24,TRF TO  Indiaforensic SERVICES I,,2018-09-24,2000000.0,,-511663790.55000067,.
409000438620',2018-09-24,TRF TO  Indiaforensic SERVICES I,,2018-09-24,5000000.0,,-516663790.55000067,.
409000438620',2018-09-24,TRF TO  Indiaforensic SERVICES I,,2018-09-24,11900000.0,,-528563790.55000067,.
409000438620',2018-09-24,MICRO ATM WDL FEE DT21091,,2018-09-24,,269100.0,-528294690.55000067,.
409000438620',2018-09-24,MICRO ATM INC DATED 21091,,2018-09-24,,615.6,-528294074.95000064,.
409000438620',2018-09-24,MICRO ATM GST DATED 21091,,2018-09-24,,123.12,-528293951.83000064,.
409000438620',2018-09-24,MAW/502964XXXXXX2136/NAGA,,2018-09-24,,900.0,-528293051.83000064,.
409000438620',2018-09-24,MICRO ATM WDL FEE DT22091,,2018-09-24,,709300.0,-527583751.83000064,.
409000438620',2018-09-24,MICRO ATM INC DATED 22091,,2018-09-24,,1614.96,-527582136.87000066,.
409000438620',2018-09-24,MICRO ATM GST DATED 22091,,2018-09-24,,322.99,-527581813.88000065,.
409000438620',2018-09-24,AEPS PAY Indiaforensic 2109,,2018-09-24,,299.52,-527581514.36000067,.
409000438620',2018-09-24,AEPS INCOME DT 21-09-2018,,2018-09-24,,18785.17,-527562729.19000065,.
409000438620',2018-09-24,AEPS GST INC DT 21-09-201,,2018-09-24,,3757.03,-527558972.1600007,.
409000438620',2018-09-24,AEPS INCOME DT 22-09-2018,,2018-09-24,,18378.95,-527540593.2100007,.
409000438620',2018-09-24,AEPS GST INC DT 22-09-201,,2018-09-24,,3675.79,-527536917.4200007,.
409000438620',2018-09-24,AEPS INCOME DT 23-09-2018,,2018-09-24,,11916.23,-527525001.19000065,.
409000438620',2018-09-24,AEPS GST INC DT 23-09-201,,2018-09-24,,2383.25,-527522617.94000065,.
409000438620',2018-09-24,MICRO ATM WDL FEE DT23091,,2018-09-24,,510600.0,-527012017.94000065,.
409000438620',2018-09-24,MICRO ATM INC DATED 23091,,2018-09-24,,1182.96,-527010834.9800007,.
409000438620',2018-09-24,MICRO ATM GST DATED 23091,,2018-09-24,,236.59,-527010598.3900007,.
409000438620',2018-09-24,AEPS ACQ CR ADJ FEES 2109,,2018-09-24,225.97,,-527010824.3600007,.
409000438620',2018-09-24,GFCB819418940693/RMCPL16717,,2018-09-24,,700.0,-527010124.3600007,.
409000438620',2018-09-24,AEPS ACQ GF RE ADJ FEES 2,,2018-09-24,,4.13,-527010120.23000073,.
409000438620',2018-09-24,TRF TO  Indiaforensic SERVICES I,,2018-09-24,1000000.0,,-528010120.23000073,.
409000438620',2018-09-24,MICRO ATM WDL FEE DT24091,,2018-09-24,,212600.0,-527797520.23000073,.
409000438620',2018-09-24,MICRO ATM INC DATED 24091,,2018-09-24,,504.0,-527797016.23000073,.
409000438620',2018-09-24,MICRO ATM GST DATED 24091,,2018-09-24,,100.8,-527796915.4300007,.
409000438620',2018-09-24,NPCI SETELEMENT DIFF_2209,,2018-09-24,,9000.0,-527787915.4300007,.
409000438620',2018-09-25,MAW/502964XXXXXX6008/Karu,,2018-09-25,,1700.0,-527786215.4300007,.
409000438620',2018-09-25,MAW/502964XXXXXX6577/Karu,,2018-09-25,,1700.0,-527784515.4300007,.
409000438620',2018-09-25,MAW/502964XXXXXX3051/Karu,,2018-09-25,,1700.0,-527782815.4300007,.
409000438620',2018-09-25,MAW/502964XXXXXX4589/Karu,,2018-09-25,,1700.0,-527781115.4300007,.
409000438620',2018-09-25,MAW/502964XXXXXX2288/Karu,,2018-09-25,,1700.0,-527779415.4300007,.
409000438620',2018-09-25,MAW/502964XXXXXX2806/Karu,,2018-09-25,,1700.0,-527777715.4300007,.
409000438620',2018-09-25,Indiaforensic AEPS NPCI WDL SET,,2018-09-25,,7673300.0,-520104415.4300007,.
409000438620',2018-09-25,CB825611969503/RMCPL09590/1,,2018-09-25,10000.0,,-520114415.4300007,.
409000438620',2018-09-25,TRF TO  Indiaforensic SERVICES I,,2018-09-25,4000000.0,,-524114415.4300007,.
409000438620',2018-09-25,TFR TO  Indiaforensic SERVICES I,,2018-09-25,4000000.0,,-528114415.4300007,.
409000438620',2018-09-25,TRF TO  Indiaforensic SERVICES I,,2018-09-25,500000.0,,-528614415.4300007,.
409000438620',2018-09-25,MAW/502964XXXXXX1757/NAGA,,2018-09-25,,2200.0,-528612215.4300007,.
409000438620',2018-09-25,MICRO ATM WDL FEE DT24091,,2018-09-25,,316700.0,-528295515.4300007,.
409000438620',2018-09-25,MICRO ATM INC DATED 24091,,2018-09-25,,770.4,-528294745.03000075,.
409000438620',2018-09-25,MICRO ATM GST DATED 24091,,2018-09-25,,154.08,-528294590.95000076,.
409000438620',2018-09-25,AEPS INCOME DT 24-09-2018,,2018-09-25,,20561.65,-528274029.3000008,.
409000438620',2018-09-25,AEPS GST INC DT 24-09-201,,2018-09-25,,4112.33,-528269916.9700008,.
409000438620',2018-09-25,MICRO ATM WDL FEE DT25091,,2018-09-25,,242900.0,-528027016.9700008,.
409000438620',2018-09-25,MICRO ATM INC DATED 25091,,2018-09-25,,568.8,-528026448.1700008,.
409000438620',2018-09-25,MICRO ATM GST DATED 25091,,2018-09-25,,113.76,-528026334.4100008,.
409000438620',2018-09-26,TRF TO  Indiaforensic SERVICES I,,2018-09-26,300000.0,,-528326334.4100008,.
409000438620',2018-09-26,MAW/502964XXXXXX6735/Karu,,2018-09-26,,1700.0,-528324634.4100008,.
409000438620',2018-09-26,MAW/502964XXXXXX4720/Karu,,2018-09-26,,1700.0,-528322934.4100008,.
409000438620',2018-09-26,MAW/502964XXXXXX2193/Karu,,2018-09-26,,1700.0,-528321234.4100008,.
409000438620',2018-09-26,MAW/502964XXXXXX8654/Karu,,2018-09-26,,1700.0,-528319534.4100008,.
409000438620',2018-09-26,MAW/502964XXXXXX4715/Karu,,2018-09-26,,1700.0,-528317834.4100008,.
409000438620',2018-09-26,MAW/502964XXXXXX4597/Karu,,2018-09-26,,1700.0,-528316134.4100008,.
409000438620',2018-09-26,MAW/502964XXXXXX4570/Karu,,2018-09-26,,1700.0,-528314434.4100008,.
409000438620',2018-09-26,MAW/502964XXXXXX4471/Karu,,2018-09-26,,1700.0,-528312734.4100008,.
409000438620',2018-09-26,CR826309941199/RMCPL22800/2,,2018-09-26,1100.0,,-528313834.4100008,.
409000438620',2018-09-26,CR826311974588/RMCPL15429/2,,2018-09-26,1000.0,,-528314834.4100008,.
409000438620',2018-09-26,CR826314021260/RMCPL21030/2,,2018-09-26,1800.0,,-528316634.4100008,.
409000438620',2018-09-26,CR826311972670/RMCPL24597/2,,2018-09-26,5000.0,,-528321634.4100008,.
409000438620',2018-09-26,MICRO ATM WDL FEE DT25091,,2018-09-26,,280500.0,-528041134.4100008,.
409000438620',2018-09-26,MICRO ATM INC DATED 25091,,2018-09-26,,727.2,-528040407.2100008,.
409000438620',2018-09-26,MICRO ATM GST DATED 25091,,2018-09-26,,145.44,-528040261.7700008,.
409000438620',2018-09-26,MAW/502964XXXXXX2353/Karu,,2018-09-26,,1700.0,-528038561.7700008,.
409000438620',2018-09-26,MAW/502964XXXXXX8746/Karu,,2018-09-26,,1700.0,-528036861.7700008,.
409000438620',2018-09-26,MAW/502964XXXXXX4475/Karu,,2018-09-26,,1700.0,-528035161.7700008,.
409000438620',2018-09-26,MAW/502964XXXXXX1243/Karu,,2018-09-26,,1700.0,-528033461.7700008,.
409000438620',2018-09-26,MAW/502964XXXXXX7641/Karu,,2018-09-26,,1900.0,-528031561.7700008,.
409000438620',2018-09-26,AEPS INCOME DT 25-09-2018,,2018-09-26,,19792.8,-528011768.9700008,.
409000438620',2018-09-26,AEPS GST INC DT 25-09-201,,2018-09-26,,3958.56,-528007810.4100008,.
409000438620',2018-09-26,AEPS ACQ CR ADJ FEES 2509,,2018-09-26,40.71,,-528007851.1200008,.
409000438620',2018-09-26,MICRO ATM WDL FEE DT26091,,2018-09-26,,206400.0,-527801451.1200008,.
409000438620',2018-09-26,MICRO ATM INC DATED 26091,,2018-09-26,,448.56,-527801002.5600008,.
409000438620',2018-09-26,MICRO ATM GST DATED 26091,,2018-09-26,,89.71,-527800912.8500008,.
409000438620',2018-09-26,TRF TO  Indiaforensic SERVICES I,,2018-09-26,600000.0,,-528400912.8500008,.
409000438620',2018-09-27,CR826611636134/RMCPL17978/2,,2018-09-27,1000.0,,-528401912.8500008,.
409000438620',2018-09-27,CR826610623875/RMCPL09726/2,,2018-09-27,10000.0,,-528411912.8500008,.
409000438620',2018-09-27,CR826513431620/RMCPL23812/2,,2018-09-27,1500.0,,-528413412.8500008,.
409000438620',2018-09-27,CR826513431614/RMCPL24609/2,,2018-09-27,700.0,,-528414112.8500008,.
409000438620',2018-09-27,CR826509377221/RMCPL11592/2,,2018-09-27,1500.0,,-528415612.8500008,.
409000438620',2018-09-27,CR826516471482/RMCPL15559/2,,2018-09-27,500.0,,-528416112.8500008,.
409000438620',2018-09-27,CR826512424822/RMCPL15375/2,,2018-09-27,2000.0,,-528418112.8500008,.
409000438620',2018-09-27,CR826509383063/RMCPL24026/2,,2018-09-27,500.0,,-528418612.8500008,.
409000438620',2018-09-27,CR826515457448/RMCPL25669/2,,2018-09-27,3000.0,,-528421612.8500008,.
409000438620',2018-09-27,CR826510399934/RMCPL23324/2,,2018-09-27,500.0,,-528422112.8500008,.
409000438620',2018-09-27,CR826514449998/RMCPL24794/2,,2018-09-27,1500.0,,-528423612.8500008,.
409000438620',2018-09-27,CR826512421168/RMCPL09290/2,,2018-09-27,500.0,,-528424112.8500008,.
409000438620',2018-09-27,CR826412200332/RMCPL15566/2,,2018-09-27,500.0,,-528424612.8500008,.
409000438620',2018-09-27,CR826411183653/RMCPL18655/2,,2018-09-27,1500.0,,-528426112.8500008,.
409000438620',2018-09-27,CR826411194847/RMCPL24092/2,,2018-09-27,1000.0,,-528427112.8500008,.
409000438620',2018-09-27,CR826412206046/RMCPL23887/2,,2018-09-27,5000.0,,-528432112.8500008,.
409000438620',2018-09-27,CR826414235519/RMCPL21107/2,,2018-09-27,500.0,,-528432612.8500008,.
409000438620',2018-09-27,CR826414235516/RMCPL20034/2,,2018-09-27,1000.0,,-528433612.8500008,.
409000438620',2018-09-27,CR826412200352/RMCPL23592/2,,2018-09-27,2000.0,,-528435612.8500008,.
409000438620',2018-09-27,CR826410173918/RMCPL15535/2,,2018-09-27,500.0,,-528436112.8500008,.
409000438620',2018-09-27,MAW/502964XXXXXX7642/Karu,,2018-09-27,,1700.0,-528434412.8500008,.
409000438620',2018-09-27,MAW/502964XXXXXX5073/Karu,,2018-09-27,,1700.0,-528432712.8500008,.
409000438620',2018-09-27,MAW/502964XXXXXX9723/Karu,,2018-09-27,,1700.0,-528431012.8500008,.
409000438620',2018-09-27,MICRO ATM WDL FEE DT26091,,2018-09-27,,267500.0,-528163512.8500008,.
409000438620',2018-09-27,MICRO ATM INC DATED 26091,,2018-09-27,,698.76,-528162814.0900008,.
409000438620',2018-09-27,MICRO ATM GST DATED 26091,,2018-09-27,,139.75,-528162674.3400008,.
409000438620',2018-09-27,MICRO ATM WDL FEE DT27091,,2018-09-27,,176900.0,-527985774.3400008,.
409000438620',2018-09-27,MICRO ATM INC DATED 27091,,2018-09-27,,455.4,-527985318.94000083,.
409000438620',2018-09-27,MICRO ATM GST DATED 27091,,2018-09-27,,91.08,-527985227.86000085,.
409000438620',2018-09-27,AEPS INCOME DT 26-09-2018,,2018-09-27,,18929.11,-527966298.75000083,.
409000438620',2018-09-27,AEPS GST INC DT 26-09-201,,2018-09-27,,3785.82,-527962512.93000084,.
409000438620',2018-09-27,AEPS ACQUIRING ADJ FEES 2,,2018-09-27,17.7,,-527962530.6300008,.
409000438620',2018-09-27,AEPS ACQ CR ADJ FEES 2609,,2018-09-27,154.58,,-527962685.2100008,.
409000438620',2018-09-27,TRF TO  Indiaforensic SERVICES I,,2018-09-27,600000.0,,-528562685.2100008,.
409000438620',2018-09-27,Indiaforensic AEPS NPCI WDL SET,,2018-09-27,,2400.0,-528560285.2100008,.
409000438620',2018-09-27,AEPS INCOME DT 19-09-2018,,2018-09-27,,9.0,-528560276.2100008,.
409000438620',2018-09-27,AEPS GST INC DT 19-09-201,,2018-09-27,,1.8,-528560274.4100008,.
409000438620',2018-09-28,MAW/502964XXXXXX0384/Karu,,2018-09-28,,1700.0,-528558574.4100008,.
409000438620',2018-09-28,MICRO ATM INC DATED 27091,,2018-09-28,,600.84,-528557973.5700008,.
409000438620',2018-09-28,MICRO ATM GST DATED 27091,,2018-09-28,,120.17,-528557853.4000008,.
409000438620',2018-09-28,CB826710835389/RMCPL25078/2,,2018-09-28,1500.0,,-528559353.4000008,.
409000438620',2018-09-28,CB826718950168/RMCPL23157/2,,2018-09-28,4500.0,,-528563853.4000008,.
409000438620',2018-09-28,CB826712872484/RMCPL22300/2,,2018-09-28,2000.0,,-528565853.4000008,.
409000438620',2018-09-28,CB826710830595/RMCPL18204/2,,2018-09-28,5000.0,,-528570853.4000008,.
409000438620',2018-09-28,CB826711860270/RMCPL18061/2,,2018-09-28,500.0,,-528571353.4000008,.
409000438620',2018-09-28,CB826710830627/RMCPL23228/2,,2018-09-28,2000.0,,-528573353.4000008,.
409000438620',2018-09-28,CB826710835396/RMCPL26423/2,,2018-09-28,5000.0,,-528578353.4000008,.
409000438620',2018-09-28,CB826709805313/RMCPL14954/2,,2018-09-28,500.0,,-528578853.4000008,.
409000438620',2018-09-28,CB826711848137/RMCPL19636/2,,2018-09-28,1000.0,,-528579853.4000008,.
409000438620',2018-09-28,CB826710839237/RMCPL24446/2,,2018-09-28,700.0,,-528580553.4000008,.
409000438620',2018-09-28,CB826715911932/RMCPL21941/2,,2018-09-28,500.0,,-528581053.4000008,.
409000438620',2018-09-28,CB826715911923/RMCPL21642/2,,2018-09-28,1200.0,,-528582253.4000008,.
409000438620',2018-09-28,CB826710839163/RMCPL14558/2,,2018-09-28,2000.0,,-528584253.4000008,.
409000438620',2018-09-28,CB826711852097/RMCPL20757/2,,2018-09-28,800.0,,-528585053.4000008,.
409000438620',2018-09-28,CB826711852091/RMCPL15429/2,,2018-09-28,800.0,,-528585853.4000008,.
409000438620',2018-09-28,CB826816178542/RMCPL01460/2,,2018-09-28,500.0,,-528586353.4000008,.
409000438620',2018-09-28,CB826818219659/RMCPL05148/2,,2018-09-28,500.0,,-528586853.4000008,.
409000438620',2018-09-28,CB826811091771/RMCPL16275/2,,2018-09-28,1500.0,,-528588353.4000008,.
409000438620',2018-09-28,CB826811091764/RMCPL19639/2,,2018-09-28,6000.0,,-528594353.4000008,.
409000438620',2018-09-28,CB826810077915/RMCPL16221/2,,2018-09-28,3000.0,,-528597353.4000008,.
409000438620',2018-09-28,CB826814147648/RMCPL19146/2,,2018-09-28,600.0,,-528597953.4000008,.
409000438620',2018-09-28,CB826811084752/RMCPL16755/2,,2018-09-28,600.0,,-528598553.4000008,.
409000438620',2018-09-28,CB826811088087/RMCPL23562/2,,2018-09-28,2000.0,,-528600553.4000008,.
409000438620',2018-09-28,CB826812101807/RMCPL18083/2,,2018-09-28,500.0,,-528601053.4000008,.
409000438620',2018-09-28,CB826816168621/RMCPL22525/2,,2018-09-28,4000.0,,-528605053.4000008,.
409000438620',2018-09-28,CB826816168644/RMCPL16787/2,,2018-09-28,1500.0,,-528606553.4000008,.
409000438620',2018-09-28,CB826809061164/RMCPL14572/2,,2018-09-28,600.0,,-528607153.4000008,.
409000438620',2018-09-28,MAW/502964XXXXXX2088/NAGA,,2018-09-28,,200.0,-528606953.4000008,.
409000438620',2018-09-28,MAW/502964XXXXXX7046/Karu,,2018-09-28,,1700.0,-528605253.4000008,.
409000438620',2018-09-28,AEPS INCOME DT 27-09-2018,,2018-09-28,,18179.24,-528587074.1600008,.
409000438620',2018-09-28,AEPS GST INC DT 27-09-201,,2018-09-28,,3635.85,-528583438.3100008,.
409000438620',2018-09-28,AEPS ACQ CR ADJ FEES 2709,,2018-09-28,234.82,,-528583673.13000077,.
409000438620',2018-09-28,MICRO ATM WDL FEE DT27091,,2018-09-28,,266300.0,-528317373.13000077,.
409000438620',2018-09-28,AEPS PAY Indiaforensic 2509,,2018-09-28,,99.64,-528317273.4900008,.
409000438620',2018-09-28,MICRO ATM WDL FEE DT28091,,2018-09-28,,207300.0,-528109973.4900008,.
409000438620',2018-09-28,TRF TO  Indiaforensic SERVICES I,,2018-09-28,300000.0,,-528409973.4900008,.
409000438620',2018-09-28,MICRO ATM INC DATED 28091,,2018-09-28,,545.4,-528409428.0900008,.
409000438620',2018-09-28,MICRO ATM GST DATED 28091,,2018-09-28,,109.08,-528409319.0100008,.
409000438620',2018-09-29,MAW/502964XXXXXX1997/NAGA,,2018-09-29,,1200.0,-528408119.0100008,.
409000438620',2018-09-29,Indiaforensic AEPS NPCI WDL SET,,2018-09-29,,6659400.0,-521748719.0100008,.
409000438620',2018-09-29,TRF TO  Indiaforensic SERVICES I,,2018-09-29,5000000.0,,-526748719.0100008,.
409000438620',2018-09-29,TRF TO  Indiaforensic SERVICES I,,2018-09-29,1000000.0,,-527748719.0100008,.
409000438620',2018-09-29,TRF TO  Indiaforensic SERVICES I,,2018-09-29,500000.0,,-528248719.0100008,.
409000438620',2018-09-29,MICRO ATM WDL FEE DT28091,,2018-09-29,,310600.0,-527938119.0100008,.
409000438620',2018-09-29,MICRO ATM INC DATED 28091,,2018-09-29,,766.8,-527937352.2100008,.
409000438620',2018-09-29,MICRO ATM GST DATED 28091,,2018-09-29,,153.36,-527937198.8500008,.
409000438620',2018-09-29,AEPS INCOME DT 28-09-2018,,2018-09-29,,17553.54,-527919645.3100008,.
409000438620',2018-09-29,AEPS GST INC DT 28-09-201,,2018-09-29,,3510.71,-527916134.6000008,.
409000438620',2018-09-29,TRF TO  Indiaforensic SERVICES I,,2018-09-29,500000.0,,-528416134.6000008,.
409000438620',2018-09-29,MICRO ATM WDL FEE DT29091,,2018-09-29,,135300.0,-528280834.6000008,.
409000438620',2018-09-29,MICRO ATM INC DATED 29091,,2018-09-29,,348.48,-528280486.1200008,.
409000438620',2018-09-29,MICRO ATM GST DATED 29091,,2018-09-29,,69.7,-528280416.4200008,.
409000438620',2018-09-29,AEPS PAY Indiaforensic 2809,,2018-09-29,,198.58,-528280217.8400008,.
409000438620',2018-10-01,Indiaforensic AEPS NPCI WDL SET,,2018-10-01,,6021200.0,-522259017.8400008,.
409000438620',2018-10-01,CR826909336684/RMCPL23368/2,,2018-10-01,500.0,,-522259517.8400008,.
409000438620',2018-10-01,CR826914413653/RMCPL28707/2,,2018-10-01,2000.0,,-522261517.8400008,.
409000438620',2018-10-01,CR826910362947/RMCPL23368/2,,2018-10-01,1500.0,,-522263017.8400008,.
409000438620',2018-10-01,CR826914414769/RMCPL16184/2,,2018-10-01,4000.0,,-522267017.8400008,.
409000438620',2018-10-01,CR826918466864/RMCPL27607/2,,2018-10-01,4000.0,,-522271017.8400008,.
409000438620',2018-10-01,CR826916444392/RMCPL14829/2,,2018-10-01,500.0,,-522271517.8400008,.
409000438620',2018-10-01,CR826916444394/RMCPL23228/2,,2018-10-01,7000.0,,-522278517.8400008,.
409000438620',2018-10-01,CR826917454888/RMCPL22278/2,,2018-10-01,700.0,,-522279217.8400008,.
409000438620',2018-10-01,CR826917454894/RMCPL22832/2,,2018-10-01,2000.0,,-522281217.8400008,.
409000438620',2018-10-01,CR826913399246/RMCPL15079/2,,2018-10-01,7000.0,,-522288217.8400008,.
409000438620',2018-10-01,CR826913411386/RMCPL24449/2,,2018-10-01,8000.0,,-522296217.8400008,.
409000438620',2018-10-01,CR826911370628/RMCPL14558/2,,2018-10-01,2000.0,,-522298217.8400008,.
409000438620',2018-10-01,CR826911372910/RMCPL22489/2,,2018-10-01,1800.0,,-522300017.8400008,.
409000438620',2018-10-01,CR826911372906/RMCPL28497/2,,2018-10-01,10000.0,,-522310017.8400008,.
409000438620',2018-10-01,CR826911372916/RMCPL09617/2,,2018-10-01,10000.0,,-522320017.8400008,.
409000438620',2018-10-01,CR826913408278/RMCPL12772/2,,2018-10-01,500.0,,-522320517.8400008,.
409000438620',2018-10-01,CR826919485843/RMCPL22472/2,,2018-10-01,1000.0,,-522321517.8400008,.
409000438620',2018-10-01,CR826919485869/RMCPL11330/2,,2018-10-01,500.0,,-522322017.8400008,.
409000438620',2018-10-01,CR826918466870/RMCPL16187/2,,2018-10-01,1000.0,,-522323017.8400008,.
409000438620',2018-10-01,CR826908319737/RMCPL05110/2,,2018-10-01,500.0,,-522323517.8400008,.
409000438620',2018-10-01,CR826908319730/RMCPL17970/2,,2018-10-01,4000.0,,-522327517.8400008,.
409000438620',2018-10-01,CR826912392486/RMCPL11996/2,,2018-10-01,1500.0,,-522329017.8400008,.
409000438620',2018-10-01,CR826913406059/RMCPL15935/2,,2018-10-01,1500.0,,-522330517.8400008,.
409000438620',2018-10-01,CR827012637608/RMCPL21824/2,,2018-10-01,600.0,,-522331117.8400008,.
409000438620',2018-10-01,CR827012633238/RMCPL24284/2,,2018-10-01,2000.0,,-522333117.8400008,.
409000438620',2018-10-01,CR827010587603/RMCPL10073/2,,2018-10-01,600.0,,-522333717.8400008,.
409000438620',2018-10-01,CR827009577725/RMCPL18376/2,,2018-10-01,2500.0,,-522336217.8400008,.
409000438620',2018-10-01,CR827013659591/RMCPL28890/2,,2018-10-01,700.0,,-522336917.8400008,.
409000438620',2018-10-01,CR827009568914/RMCPL11607/2,,2018-10-01,3000.0,,-522339917.8400008,.
409000438620',2018-10-01,CR827011608939/RMCPL15690/2,,2018-10-01,5000.0,,-522344917.8400008,.
409000438620',2018-10-01,CR827011613264/RMCPL28997/2,,2018-10-01,500.0,,-522345417.8400008,.
409000438620',2018-10-01,CR827011617493/RMCPL18940/2,,2018-10-01,500.0,,-522345917.8400008,.
409000438620',2018-10-01,CR827015681662/RMCPL22581/2,,2018-10-01,500.0,,-522346417.8400008,.
409000438620',2018-10-01,CR827009582430/RMCPL27211/2,,2018-10-01,2000.0,,-522348417.8400008,.
409000438620',2018-10-01,CR827017708843/RMCPL14572/2,,2018-10-01,1800.0,,-522350217.8400008,.
409000438620',2018-10-01,CR827013659612/RMCPL20758/2,,2018-10-01,3500.0,,-522353717.8400008,.
409000438620',2018-10-01,CR827011613242/RMCPL21526/2,,2018-10-01,4000.0,,-522357717.8400008,.
409000438620',2018-10-01,CR827017716673/RMCPL16447/2,,2018-10-01,9500.0,,-522367217.8400008,.
409000438620',2018-10-01,CR827013646271/RMCPL22628/2,,2018-10-01,800.0,,-522368017.8400008,.
409000438620',2018-10-01,CR827014664235/RMCPL24759/2,,2018-10-01,1000.0,,-522369017.8400008,.
409000438620',2018-10-01,CR827013654962/RMCPL14558/2,,2018-10-01,9000.0,,-522378017.8400008,.
409000438620',2018-10-01,CR827017712386/RMCPL22523/2,,2018-10-01,1000.0,,-522379017.8400008,.
409000438620',2018-10-01,CR827012641904/RMCPL21208/2,,2018-10-01,1000.0,,-522380017.8400008,.
409000438620',2018-10-01,CR827013646275/RMCPL18486/2,,2018-10-01,500.0,,-522380517.8400008,.
409000438620',2018-10-01,CR827012637611/RMCPL23228/2,,2018-10-01,2000.0,,-522382517.8400008,.
409000438620',2018-10-01,MAW/502964XXXXXX4993/Karu,,2018-10-01,,1700.0,-522380817.8400008,.
409000438620',2018-10-01,Indiaforensic AEPS NPCI WDL SET,,2018-10-01,,3550700.0,-518830117.8400008,.
409000438620',2018-10-01,TRF TO  Indiaforensic SERVICES I,,2018-10-01,4000000.0,,-522830117.8400008,.
409000438620',2018-10-01,TRF TO  Indiaforensic SERVICES I,,2018-10-01,5000000.0,,-527830117.8400008,.
409000438620',2018-10-01,NPCI SETELEMENT DIFF_3009,,2018-10-01,,1600.0,-527828517.8400008,.
409000438620',2018-10-01,MICRO ATM WDL FEE DT29091,,2018-10-01,,248100.0,-527580417.8400008,.
409000438620',2018-10-01,MICRO ATM INC DATED 29091,,2018-10-01,,614.16,-527579803.6800008,.
409000438620',2018-10-01,MICRO ATM GST DATED 29091,,2018-10-01,,122.83,-527579680.8500008,.
409000438620',2018-10-01,MAW/502964XXXXXX1997/NAGA,,2018-10-01,,1200.0,-527578480.8500008,.
409000438620',2018-10-01,AEPS PAY Indiaforensic 2909,,2018-10-01,,389.46,-527578091.3900008,.
409000438620',2018-10-01,AEPS PAY Indiaforensic 3009,,2018-10-01,,499.4,-527577591.99000084,.
409000438620',2018-10-01,TRF TO  Indiaforensic SERVICES I,,2018-10-01,800000.0,,-528377591.99000084,.
409000438620',2018-10-01,AEPS ACQUIRING ADJ FEES 2,,2018-10-01,26.55,,-528377618.54000086,.
409000438620',2018-10-01,AEPS ACQ CR ADJ FEES 2909,,2018-10-01,457.25,,-528378075.79000086,.
409000438620',2018-10-01,AEPS INCOME DT 29-09-2018,,2018-10-01,,16404.69,-528361671.10000086,.
409000438620',2018-10-01,AEPS GST INC DT 29-09-201,,2018-10-01,,3280.94,-528358390.16000086,.
409000438620',2018-10-01,AEPS INCOME DT 30-09-2018,,2018-10-01,,9503.69,-528348886.47000086,.
409000438620',2018-10-01,AEPS GST INC DT 30-09-201,,2018-10-01,,1900.74,-528346985.73000085,.
409000438620',2018-10-01,MICRO ATM WDL FEE DT30091,,2018-10-01,,501700.0,-527845285.73000085,.
409000438620',2018-10-01,MICRO ATM INC DATED 30091,,2018-10-01,,1193.04,-527844092.69000083,.
409000438620',2018-10-01,MICRO ATM GST DATED 30091,,2018-10-01,,238.61,-527843854.0800008,.
409000438620',2018-10-01,MICRO ATM WDL FEE DT01101,,2018-10-01,,157400.0,-527686454.0800008,.
409000438620',2018-10-01,MICRO ATM INC DATED 01101,,2018-10-01,,345.24,-527686108.8400008,.
409000438620',2018-10-01,MICRO ATM GST DATED 01101,,2018-10-01,,69.05,-527686039.7900008,.
409000438620',2018-10-02,MAW/502964XXXXXX9255/NAGA,,2018-10-02,,500.0,-527685539.7900008,.
409000438620',2018-10-02,MAW/502964XXXXXX9466/NAGA,,2018-10-02,,2800.0,-527682739.7900008,.
409000438620',2018-10-03,MAW/502964XXXXXX1100/NAGA,,2018-10-03,,800.0,-527681939.7900008,.
409000438620',2018-10-03,MAW/502964XXXXXX8617/Karu,,2018-10-03,,1700.0,-527680239.7900008,.
409000438620',2018-10-03,Indiaforensic AEPS NPCI WDL SET,,2018-10-03,,5587100.0,-522093139.7900008,.
409000438620',2018-10-03,Indiaforensic AEPS NPCI WDL SET,,2018-10-03,,5676100.0,-516417039.7900008,.
409000438620',2018-10-03,MAW/502964XXXXXX9004/Karu,,2018-10-03,,1700.0,-516415339.7900008,.
409000438620',2018-10-03,MAW/502964XXXXXX6635/Karu,,2018-10-03,,1700.0,-516413639.7900008,.
409000438620',2018-10-03,MAW/502964XXXXXX8781/Karu,,2018-10-03,,1700.0,-516411939.7900008,.
409000438620',2018-10-03,MAW/502964XXXXXX2144/Karu,,2018-10-03,,1700.0,-516410239.7900008,.
409000438620',2018-10-03,MAW/502964XXXXXX1146/Karu,,2018-10-03,,1700.0,-516408539.7900008,.
409000438620',2018-10-03,MAW/502964XXXXXX2251/Karu,,2018-10-03,,1700.0,-516406839.7900008,.
409000438620',2018-10-03,MAW/502964XXXXXX4430/Karu,,2018-10-03,,1700.0,-516405139.7900008,.
409000438620',2018-10-03,MAW/502964XXXXXX3044/Karu,,2018-10-03,,1700.0,-516403439.7900008,.
409000438620',2018-10-03,MICRO ATM WDL FEE DT01101,,2018-10-03,,527100.0,-515876339.7900008,.
409000438620',2018-10-03,MICRO ATM INC DATED 01101,,2018-10-03,,1257.84,-515875081.9500008,.
409000438620',2018-10-03,MICRO ATM GST DATED 01101,,2018-10-03,,251.57,-515874830.3800008,.
409000438620',2018-10-03,MICRO ATM WDL FEE DT02101,,2018-10-03,,892900.0,-514981930.3800008,.
409000438620',2018-10-03,MICRO ATM INC DATED 02101,,2018-10-03,,2048.04,-514979882.3400008,.
409000438620',2018-10-03,MICRO ATM GST DATED 02101,,2018-10-03,,409.61,-514979472.7300008,.
409000438620',2018-10-03,TRF TO  Indiaforensic SERVICES I,,2018-10-03,12200000.0,,-527179472.7300008,.
409000438620',2018-10-03,MICRO ATM WDL FEE DT03101,,2018-10-03,,324600.0,-526854872.7300008,.
409000438620',2018-10-03,MICRO ATM INC DATED 03101,,2018-10-03,,698.04,-526854174.6900008,.
409000438620',2018-10-03,MICRO ATM GST DATED 03101,,2018-10-03,,139.61,-526854035.08000076,.
409000438620',2018-10-03,AEPS INCOME DT 01-10-2018,,2018-10-03,,14586.57,-526839448.51000077,.
409000438620',2018-10-03,AEPS GST INC DT 01-10-201,,2018-10-03,,2917.31,-526836531.20000076,.
409000438620',2018-10-03,AEPS INCOME DT 02-10-2018,,2018-10-03,,15018.5,-526821512.70000076,.
409000438620',2018-10-03,AEPS GST INC DT 02-10-201,,2018-10-03,,3003.7,-526818509.0000008,.
409000438620',2018-10-03,AEPS ACQ REP ADJ FEES 011,,2018-10-03,,17.7,-526818491.3000008,.
409000438620',2018-10-03,TRF TO  Indiaforensic SERVICES I,,2018-10-03,1800000.0,,-528618491.3000008,.
409000438620',2018-10-03,AEPS PAY Indiaforensic 0110,,2018-10-03,,1218.69,-528617272.6100008,.
409000438620',2018-10-04,Indiaforensic AEPS NPCI WDL SET,,2018-10-04,,3783600.0,-524833672.6100008,.
409000438620',2018-10-04,MICRO ATM WDL FEE DT03101,,2018-10-04,,577800.0,-524255872.6100008,.
409000438620',2018-10-04,MICRO ATM INC DATED 03101,,2018-10-04,,1321.56,-524254551.0500008,.
409000438620',2018-10-04,MICRO ATM GST DATED 03101,,2018-10-04,,264.31,-524254286.7400008,.
409000438620',2018-10-04,TRF TO  Indiaforensic SERVICES I,,2018-10-04,3800000.0,,-528054286.7400008,.
409000438620',2018-10-04,AEPS INCOME DT 03-10-2018,,2018-10-04,,9960.14,-528044326.6000008,.
409000438620',2018-10-04,AEPS GST INC DT 03-10-201,,2018-10-04,,1992.03,-528042334.5700008,.
409000438620',2018-10-04,AEPS ACQUIRING ADJ FEES 0,,2018-10-04,35.4,,-528042369.9700008,.
409000438620',2018-10-04,MICRO ATM WDL FEE DT04101,,2018-10-04,,307700.0,-527734669.9700008,.
409000438620',2018-10-04,MICRO ATM INC DATED 04101,,2018-10-04,,653.76,-527734016.2100008,.
409000438620',2018-10-04,MICRO ATM GST DATED 04101,,2018-10-04,,130.75,-527733885.4600008,.
409000438620',2018-10-04,TRF TO  Indiaforensic SERVICES I,,2018-10-04,900000.0,,-528633885.4600008,.
409000438620',2018-10-05,Indiaforensic AEPS NPCI WDL SET,,2018-10-05,,4719800.0,-523914085.4600008,.
409000438620',2018-10-05,TRF TO  Indiaforensic SERVICES I,,2018-10-05,2500000.0,,-526414085.4600008,.
409000438620',2018-10-05,TRF TO  Indiaforensic SERVICES I,,2018-10-05,2200000.0,,-528614085.4600008,.
409000438620',2018-10-05,MICRO ATM WDL FEE DT04101,,2018-10-05,,548900.0,-528065185.4600008,.
409000438620',2018-10-05,MICRO ATM INC DATED 04101,,2018-10-05,,1284.84,-528063900.62000084,.
409000438620',2018-10-05,MICRO ATM GST DATED 04101,,2018-10-05,,256.97,-528063643.6500008,.
409000438620',2018-10-05,AEPS INCOME DT 04-10-2018,,2018-10-05,,12165.97,-528051477.6800008,.
409000438620',2018-10-05,AEPS GST INC DT 04-10-201,,2018-10-05,,2433.19,-528049044.4900008,.
409000438620',2018-10-05,AEPS ACQUIRING ADJ FEES 0,,2018-10-05,8.85,,-528049053.3400008,.
409000438620',2018-10-05,AEPS ACQ REP ADJ FEES 041,,2018-10-05,,26.55,-528049026.7900008,.
409000438620',2018-10-05,MICRO ATM WDL FEE DT05101,,2018-10-05,,332800.0,-527716226.7900008,.
409000438620',2018-10-05,MICRO ATM INC DATED 05101,,2018-10-05,,780.48,-527715446.3100008,.
409000438620',2018-10-05,MICRO ATM GST DATED 05101,,2018-10-05,,156.1,-527715290.21000075,.
409000438620',2018-10-05,TRF TO  Indiaforensic SERVICES I,,2018-10-05,500000.0,,-528215290.21000075,.
409000438620',2018-10-06,CR827112904021/RMCPL21208/2,,2018-10-06,1000.0,,-528216290.21000075,.
409000438620',2018-10-06,CR827108835586/RMCPL24703/2,,2018-10-06,3000.0,,-528219290.21000075,.
409000438620',2018-10-06,CR827117972923/RMCPL22655/2,,2018-10-06,2000.0,,-528221290.21000075,.
409000438620',2018-10-06,CR827117972945/RMCPL23207/2,,2018-10-06,1500.0,,-528222790.21000075,.
409000438620',2018-10-06,CR827112908061/RMCPL17957/2,,2018-10-06,500.0,,-528223290.21000075,.
409000438620',2018-10-06,CR827114925332/RMCPL27276/2,,2018-10-06,500.0,,-528223790.21000075,.
409000438620',2018-10-06,CR827116952157/RMCPL14573/2,,2018-10-06,900.0,,-528224690.21000075,.
409000438620',2018-10-06,CR827113917059/RMCPL25318/2,,2018-10-06,1000.0,,-528225690.21000075,.
409000438620',2018-10-06,CR827111893853/RMCPL22022/2,,2018-10-06,700.0,,-528226390.21000075,.
409000438620',2018-10-06,CR827116955605/RMCPL22499/2,,2018-10-06,2000.0,,-528228390.21000075,.
409000438620',2018-10-06,CR827110871201/RMCPL12604/2,,2018-10-06,2400.0,,-528230790.21000075,.
409000438620',2018-10-06,CR827111890219/RMCPL19247/2,,2018-10-06,3000.0,,-528233790.21000075,.
409000438620',2018-10-06,CR827115948261/RMCPL20998/2,,2018-10-06,600.0,,-528234390.21000075,.
409000438620',2018-10-06,CR827317422723/RMCPL22967/3,,2018-10-06,2400.0,,-528236790.21000075,.
409000438620',2018-10-06,CR827210104010/RMCPL28636/2,,2018-10-06,6000.0,,-528242790.21000075,.
409000438620',2018-10-06,CR827211111469/RMCPL09035/2,,2018-10-06,1200.0,,-528243990.21000075,.
409000438620',2018-10-06,CR827213149349/RMCPL10110/2,,2018-10-06,1000.0,,-528244990.21000075,.
409000438620',2018-10-06,CR827214154109/RMCPL15112/2,,2018-10-06,10000.0,,-528254990.21000075,.
409000438620',2018-10-06,CR827214154119/RMCPL15296/2,,2018-10-06,3000.0,,-528257990.21000075,.
409000438620',2018-10-06,CR827511799411/RMCPL26120/0,,2018-10-06,6100.0,,-528264090.21000075,.
409000438620',2018-10-06,CR827512807484/RMCPL23812/0,,2018-10-06,10000.0,,-528274090.21000075,.
409000438620',2018-10-06,CR827508750858/RMCPL16659/0,,2018-10-06,1000.0,,-528275090.21000075,.
409000438620',2018-10-06,CR827411560119/RMCPL19909/0,,2018-10-06,500.0,,-528275590.21000075,.
409000438620',2018-10-06,CR827410552579/RMCPL27206/0,,2018-10-06,8000.0,,-528283590.21000075,.
409000438620',2018-10-06,CR827416628290/RMCPL19909/0,,2018-10-06,500.0,,-528284090.21000075,.
409000438620',2018-10-06,CR827416621722/RMCPL24103/0,,2018-10-06,5000.0,,-528289090.21000075,.
409000438620',2018-10-06,CR827417633983/RMCPL19963/0,,2018-10-06,1100.0,,-528290190.21000075,.
409000438620',2018-10-06,CR827417633996/RMCPL09612/0,,2018-10-06,2000.0,,-528292190.21000075,.
409000438620',2018-10-06,CR827417633985/RMCPL21549/0,,2018-10-06,700.0,,-528292890.21000075,.
409000438620',2018-10-06,CR827411562326/RMCPL23895/0,,2018-10-06,500.0,,-528293390.21000075,.
409000438620',2018-10-06,CR827410542617/RMCPL20680/0,,2018-10-06,900.0,,-528294290.21000075,.
409000438620',2018-10-06,CR827413591224/RMCPL19888/0,,2018-10-06,600.0,,-528294890.21000075,.
409000438620',2018-10-06,CR827613019341/RMCPL20587/0,,2018-10-06,2000.0,,-528296890.21000075,.
409000438620',2018-10-06,CR827610984312/RMCPL17948/0,,2018-10-06,2700.0,,-528299590.21000075,.
409000438620',2018-10-06,CR827610984845/RMCPL22640/0,,2018-10-06,1000.0,,-528300590.21000075,.
409000438620',2018-10-06,CR827611001739/RMCPL23228/0,,2018-10-06,1000.0,,-528301590.21000075,.
409000438620',2018-10-06,CR827611001887/RMCPL19060/0,,2018-10-06,2000.0,,-528303590.21000075,.
409000438620',2018-10-06,CR827611998907/RMCPL17234/0,,2018-10-06,1000.0,,-528304590.21000075,.
409000438620',2018-10-06,CR827611999286/RMCPL00216/0,,2018-10-06,4000.0,,-528308590.21000075,.
409000438620',2018-10-06,CR827616057766/RMCPL16272/0,,2018-10-06,500.0,,-528309090.21000075,.
409000438620',2018-10-06,CR827616057743/RMCPL20978/0,,2018-10-06,500.0,,-528309590.21000075,.
409000438620',2018-10-06,CR827611999705/RMCPL24449/0,,2018-10-06,3000.0,,-528312590.21000075,.
409000438620',2018-10-06,CR827616057760/RMCPL18729/0,,2018-10-06,600.0,,-528313190.21000075,.
409000438620',2018-10-06,CR827610986907/RMCPL18157/0,,2018-10-06,500.0,,-528313690.21000075,.
409000438620',2018-10-06,CR827610986927/RMCPL27694/0,,2018-10-06,5500.0,,-528319190.21000075,.
409000438620',2018-10-06,CR827611996499/RMCPL27696/0,,2018-10-06,10000.0,,-528329190.21000075,.
409000438620',2018-10-06,CR827611998719/RMCPL19469/0,,2018-10-06,3000.0,,-528332190.21000075,.
409000438620',2018-10-06,CR827612005997/RMCPL23710/0,,2018-10-06,1800.0,,-528333990.21000075,.
409000438620',2018-10-06,CR827613020659/RMCPL23228/0,,2018-10-06,500.0,,-528334490.21000075,.
409000438620',2018-10-06,CR827615042999/RMCPL19899/0,,2018-10-06,2000.0,,-528336490.21000075,.
409000438620',2018-10-06,CR827612014014/RMCPL09550/0,,2018-10-06,9000.0,,-528345490.21000075,.
409000438620',2018-10-06,CR827612014632/RMCPL21642/0,,2018-10-06,1000.0,,-528346490.21000075,.
409000438620',2018-10-06,CR827612014941/RMCPL15326/0,,2018-10-06,2000.0,,-528348490.21000075,.
409000438620',2018-10-06,CR827611001077/RMCPL15535/0,,2018-10-06,500.0,,-528348990.21000075,.
409000438620',2018-10-06,CR827612008398/RMCPL16262/0,,2018-10-06,500.0,,-528349490.21000075,.
409000438620',2018-10-06,CR827611001378/RMCPL11352/0,,2018-10-06,800.0,,-528350290.21000075,.
409000438620',2018-10-06,CR827611001385/RMCPL17789/0,,2018-10-06,1000.0,,-528351290.21000075,.
409000438620',2018-10-06,CR827615052295/RMCPL14840/0,,2018-10-06,1000.0,,-528352290.21000075,.
409000438620',2018-10-06,CR827611003570/RMCPL26216/0,,2018-10-06,2000.0,,-528354290.21000075,.
409000438620',2018-10-06,CR827611003461/RMCPL14096/0,,2018-10-06,500.0,,-528354790.21000075,.
409000438620',2018-10-06,CR827610988291/RMCPL22963/0,,2018-10-06,1000.0,,-528355790.21000075,.
409000438620',2018-10-06,CR827610988638/RMCPL25592/0,,2018-10-06,1000.0,,-528356790.21000075,.
409000438620',2018-10-06,CR827610989034/RMCPL22042/0,,2018-10-06,10000.0,,-528366790.21000075,.
409000438620',2018-10-06,CR827610987129/RMCPL23065/0,,2018-10-06,1000.0,,-528367790.21000075,.
409000438620',2018-10-06,CR827610987141/RMCPL26156/0,,2018-10-06,500.0,,-528368290.21000075,.
409000438620',2018-10-06,CR827610987054/RMCPL24482/0,,2018-10-06,600.0,,-528368890.21000075,.
409000438620',2018-10-06,CR827610987417/RMCPL16282/0,,2018-10-06,500.0,,-528369390.21000075,.
409000438620',2018-10-06,CR827610987812/RMCPL27487/0,,2018-10-06,2000.0,,-528371390.21000075,.
409000438620',2018-10-06,CR827610987587/RMCPL22250/0,,2018-10-06,1000.0,,-528372390.21000075,.
409000438620',2018-10-06,CR827615050474/RMCPL22832/0,,2018-10-06,1500.0,,-528373890.21000075,.
409000438620',2018-10-06,CR827616056272/RMCPL23534/0,,2018-10-06,1000.0,,-528374890.21000075,.
409000438620',2018-10-06,CR827616056659/RMCPL21824/0,,2018-10-06,1500.0,,-528376390.21000075,.
409000438620',2018-10-06,CR827612016763/RMCPL21743/0,,2018-10-06,4000.0,,-528380390.21000075,.
409000438620',2018-10-06,CR827613020101/RMCPL23065/0,,2018-10-06,1500.0,,-528381890.21000075,.
409000438620',2018-10-06,CR827613020536/RMCPL21646/0,,2018-10-06,500.0,,-528382390.21000075,.
409000438620',2018-10-06,CR827613020691/RMCPL28457/0,,2018-10-06,1000.0,,-528383390.21000075,.
409000438620',2018-10-06,CR827614035234/RMCPL25806/0,,2018-10-06,5500.0,,-528388890.21000075,.
409000438620',2018-10-06,CR827612010073/RMCPL21807/0,,2018-10-06,500.0,,-528389390.21000075,.
409000438620',2018-10-06,CR827611992408/RMCPL24148/0,,2018-10-06,500.0,,-528389890.21000075,.
409000438620',2018-10-06,CR827612010056/RMCPL18157/0,,2018-10-06,2000.0,,-528391890.21000075,.
409000438620',2018-10-06,CR827612010079/RMCPL23887/0,,2018-10-06,1700.0,,-528393590.21000075,.
409000438620',2018-10-06,CR827611992848/RMCPL16457/0,,2018-10-06,1500.0,,-528395090.21000075,.
409000438620',2018-10-06,CR827611992708/RMCPL16247/0,,2018-10-06,10000.0,,-528405090.21000075,.
409000438620',2018-10-06,CR827611992690/RMCPL15375/0,,2018-10-06,500.0,,-528405590.21000075,.
409000438620',2018-10-06,CR827609973109/RMCPL19028/0,,2018-10-06,1000.0,,-528406590.21000075,.
409000438620',2018-10-06,CR827611991426/RMCPL11793/0,,2018-10-06,1000.0,,-528407590.21000075,.
409000438620',2018-10-06,CR827611991851/RMCPL00111/0,,2018-10-06,2000.0,,-528409590.21000075,.
409000438620',2018-10-06,CR827611991931/RMCPL20871/0,,2018-10-06,1000.0,,-528410590.21000075,.
409000438620',2018-10-06,CR827612016815/RMCPL22481/0,,2018-10-06,2000.0,,-528412590.21000075,.
409000438620',2018-10-06,CR827611001667/RMCPL14431/0,,2018-10-06,1000.0,,-528413590.21000075,.
409000438620',2018-10-06,CR827612006381/RMCPL22042/0,,2018-10-06,3000.0,,-528416590.21000075,.
409000438620',2018-10-06,CR827615046964/RMCPL09827/0,,2018-10-06,600.0,,-528417190.21000075,.
409000438620',2018-10-06,CR827615053248/RMCPL13161/0,,2018-10-06,1200.0,,-528418390.21000075,.
409000438620',2018-10-06,CR827615054005/RMCPL09612/0,,2018-10-06,10000.0,,-528428390.21000075,.
409000438620',2018-10-06,CR827615053863/RMCPL15326/0,,2018-10-06,3000.0,,-528431390.21000075,.
409000438620',2018-10-06,CR827615054327/RMCPL13776/0,,2018-10-06,1000.0,,-528432390.21000075,.
409000438620',2018-10-06,CR827616059196/RMCPL24829/0,,2018-10-06,1000.0,,-528433390.21000075,.
409000438620',2018-10-06,CR827616059256/RMCPL15110/0,,2018-10-06,1000.0,,-528434390.21000075,.
409000438620',2018-10-06,CR827617075326/RMCPL16457/0,,2018-10-06,500.0,,-528434890.21000075,.
409000438620',2018-10-06,CR827617077786/RMCPL18042/0,,2018-10-06,600.0,,-528435490.21000075,.
409000438620',2018-10-06,CR827613020137/RMCPL20482/0,,2018-10-06,500.0,,-528435990.21000075,.
409000438620',2018-10-06,CR827611003447/RMCPL11131/0,,2018-10-06,5000.0,,-528440990.21000075,.
409000438620',2018-10-06,CR827610989367/RMCPL11281/0,,2018-10-06,1000.0,,-528441990.21000075,.
409000438620',2018-10-06,CR827611993127/RMCPL23157/0,,2018-10-06,4500.0,,-528446490.21000075,.
409000438620',2018-10-06,CR827611993114/RMCPL15609/0,,2018-10-06,2000.0,,-528448490.21000075,.
409000438620',2018-10-06,CR827610987772/RMCPL22744/0,,2018-10-06,500.0,,-528448990.21000075,.
409000438620',2018-10-06,CR827611992724/RMCPL27696/0,,2018-10-06,2500.0,,-528451490.21000075,.
409000438620',2018-10-06,CR827610988169/RMCPL23562/0,,2018-10-06,500.0,,-528451990.21000075,.
409000438620',2018-10-06,CR827610988188/RMCPL20871/0,,2018-10-06,1000.0,,-528452990.21000075,.
409000438620',2018-10-06,CR827612015572/RMCPL09617/0,,2018-10-06,10000.0,,-528462990.21000075,.
409000438620',2018-10-06,CR827612015563/RMCPL12664/0,,2018-10-06,3000.0,,-528465990.21000075,.
409000438620',2018-10-06,CR827616056265/RMCPL18061/0,,2018-10-06,500.0,,-528466490.21000075,.
409000438620',2018-10-06,CR827615046987/RMCPL24692/0,,2018-10-06,4000.0,,-528470490.21000075,.
409000438620',2018-10-06,CR827616056431/RMCPL20034/0,,2018-10-06,500.0,,-528470990.21000075,.
409000438620',2018-10-06,CR827617083159/RMCPL09821/0,,2018-10-06,5000.0,,-528475990.21000075,.
409000438620',2018-10-06,Indiaforensic AEPS NPCI WDL SET,,2018-10-06,,5442700.0,-523033290.21000075,.
409000438620',2018-10-06,TRF TO  Indiaforensic SERVICES I,,2018-10-06,5000000.0,,-528033290.21000075,.
409000438620',2018-10-06,TRF TO  Indiaforensic SERVICES I,,2018-10-06,500000.0,,-528533290.21000075,.
409000438620',2018-10-06,MICRO ATM WDL FEE DT05101,,2018-10-06,,510000.0,-528023290.21000075,.
409000438620',2018-10-06,MICRO ATM INC DATED 05101,,2018-10-06,,1171.8,-528022118.41000074,.
409000438620',2018-10-06,MICRO ATM GST DATED 05101,,2018-10-06,,234.36,-528021884.0500007,.
409000438620',2018-10-06,TRF TO  Indiaforensic SERVICES I,,2018-10-06,500000.0,,-528521884.0500007,.
409000438620',2018-10-06,AEPS INCOME DT 05-10-2018,,2018-10-06,,13931.32,-528507952.73000073,.
409000438620',2018-10-06,AEPS GST INC DT 05-10-201,,2018-10-06,,2786.26,-528505166.47000074,.
409000438620',2018-10-06,AEPS ACQ CR ADJ FEES 0510,,2018-10-06,1056.69,,-528506223.16000074,.
409000438620',2018-10-06,MICRO ATM WDL FEE DT06101,,2018-10-06,,404800.0,-528101423.16000074,.
409000438620',2018-10-06,MICRO ATM INC DATED 06101,,2018-10-06,,970.92,-528100452.2400007,.
409000438620',2018-10-06,MICRO ATM GST DATED 06101,,2018-10-06,,194.18,-528100258.0600007,.
409000438620',2018-10-08,Indiaforensic AEPS NPCI WDL SET,,2018-10-08,,5377500.0,-522722758.0600007,.
409000438620',2018-10-08,Indiaforensic AEPS NPCI WDL SET,,2018-10-08,,3065500.0,-519657258.0600007,.
409000438620',2018-10-08,TRF TO  Indiaforensic SERVICES I,,2018-10-08,8900000.0,,-528557258.0600007,.
409000438620',2018-10-08,MICRO ATM WDL FEE DT06101,,2018-10-08,,533800.0,-528023458.0600007,.
409000438620',2018-10-08,MICRO ATM INC DATED 06101,,2018-10-08,,1205.64,-528022252.42000073,.
409000438620',2018-10-08,MICRO ATM GST DATED 06101,,2018-10-08,,241.13,-528022011.29000074,.
409000438620',2018-10-08,MICRO ATM WDL FEE DT07101,,2018-10-08,,967900.0,-527054111.29000074,.
409000438620',2018-10-08,MICRO ATM INC DATED 07101,,2018-10-08,,2106.36,-527052004.9300007,.
409000438620',2018-10-08,MICRO ATM GST DATED 07101,,2018-10-08,,421.27,-527051583.66000074,.
409000438620',2018-10-08,MICRO ATM WDL FEE DT08101,,2018-10-08,,491800.0,-526559783.66000074,.
409000438620',2018-10-08,MICRO ATM INC DATED 08101,,2018-10-08,,1075.68,-526558707.98000073,.
409000438620',2018-10-08,MICRO ATM GST DATED 08101,,2018-10-08,,215.14,-526558492.84000075,.
409000438620',2018-10-08,TRF TO  Indiaforensic SERVICES I,,2018-10-08,1000000.0,,-527558492.84000075,.
409000438620',2018-10-08,NPCI SETELEMENT DIFF_0710,,2018-10-08,,7500.0,-527550992.84000075,.
409000438620',2018-10-08,AEPS INCOME DT 06-10-2018,,2018-10-08,,14157.31,-527536835.53000075,.
409000438620',2018-10-08,AEPS GST INC DT 06-10-201,,2018-10-08,,2831.46,-527534004.07000077,.
409000438620',2018-10-08,AEPS INCOME DT 07-10-2018,,2018-10-08,,8091.25,-527525912.82000077,.
409000438620',2018-10-08,AEPS GST INC DT 07-10-201,,2018-10-08,,1618.25,-527524294.57000077,.
409000438620',2018-10-08,AEPS ACQUIRING ADJ FEES 0,,2018-10-08,17.7,,-527524312.27000076,.
409000438620',2018-10-08,AEPS ACQUIRING ADJ FEES 0,,2018-10-08,35.4,,-527524347.67000073,.
409000438620',2018-10-08,AEPS ACQ REP ADJ FEES 061,,2018-10-08,,35.4,-527524312.27000076,.
409000438620',2018-10-09,TRF TO  Indiaforensic SERVICES I,,2018-10-09,1000000.0,,-528524312.27000076,.
409000438620',2018-10-09,Indiaforensic AEPS NPCI WDL SET,,2018-10-09,,5273800.0,-523250512.27000076,.
409000438620',2018-10-09,MAW/502964XXXXXX6016/Akol,,2018-10-09,,2000.0,-523248512.27000076,.
409000438620',2018-10-09,TRF TO  Indiaforensic SERVICES I,,2018-10-09,5000000.0,,-528248512.27000076,.
409000438620',2018-10-09,MICRO ATM WDL FEE DT08101,,2018-10-09,,564900.0,-527683612.27000076,.
409000438620',2018-10-09,MICRO ATM INC DATED 08101,,2018-10-09,,1359.36,-527682252.91000074,.
409000438620',2018-10-09,MICRO ATM GST DATED 08101,,2018-10-09,,271.87,-527681981.04000074,.
409000438620',2018-10-09,TRF TO  Indiaforensic SERVICES I,,2018-10-09,900000.0,,-528581981.04000074,.
409000438620',2018-10-09,MICRO ATM WDL FEE DT09101,,2018-10-09,,434000.0,-528147981.04000074,.
409000438620',2018-10-09,MICRO ATM INC DATED 09101,,2018-10-09,,1017.72,-528146963.3200007,.
409000438620',2018-10-09,MICRO ATM GST DATED 09101,,2018-10-09,,203.54,-528146759.7800007,.
409000438620',2018-10-09,AEPS INCOME DT 10-08-2018,,2018-10-09,,13962.09,-528132797.6900007,.
409000438620',2018-10-09,AEPS GST INC DT 10-08-201,,2018-10-09,,2792.42,-528130005.2700007,.
409000438620',2018-10-09,AEPS ACQ REP ADJ FEES 081,,2018-10-09,,8.85,-528129996.4200007,.
409000438620',2018-10-10,Indiaforensic AEPS NPCI WDL SET,,2018-10-10,,4882500.0,-523247496.4200007,.
409000438620',2018-10-10,TRF TO  Indiaforensic SERVICES I,,2018-10-10,5400000.0,,-528647496.4200007,.
409000438620',2018-10-10,NPCI SETELEMENT DIFF_0710,,2018-10-10,7500.0,,-528654996.4200007,.
409000438620',2018-10-10,NPCI SETELEMENT DIFF_0910,,2018-10-10,,10000.0,-528644996.4200007,.
409000438620',2018-10-10,MICRO ATM WDL FEE DT09101,,2018-10-10,,655200.0,-527989796.4200007,.
409000438620',2018-10-10,MICRO ATM INC DATED 09101,,2018-10-10,,1529.28,-527988267.1400007,.
409000438620',2018-10-10,MICRO ATM GST DATED 09101,,2018-10-10,,305.86,-527987961.2800007,.
409000438620',2018-10-10,MICRO ATM WDL FEE DT10101,,2018-10-10,,319600.0,-527668361.2800007,.
409000438620',2018-10-10,MICRO ATM INC DATED 10101,,2018-10-10,,810.0,-527667551.2800007,.
409000438620',2018-10-10,MICRO ATM GST DATED 10101,,2018-10-10,,162.0,-527667389.2800007,.
409000438620',2018-10-10,TRF TO  Indiaforensic SERVICES I,,2018-10-10,600000.0,,-528267389.2800007,.
409000438620',2018-10-10,AEPS INCOME DT 10-09-2018,,2018-10-10,,12997.22,-528254392.06000066,.
409000438620',2018-10-10,AEPS GST INC DT 10-09-201,,2018-10-10,,2599.44,-528251792.62000066,.
409000438620',2018-10-10,AEPS ACQUIRING ADJ FEES 0,,2018-10-10,35.4,,-528251828.02000064,.
409000438620',2018-10-11,AEPS PAY Indiaforensic 0510,,2018-10-11,,498.12,-528251329.90000063,.
409000438620',2018-10-11,MAW/502964XXXXXX0839/NAGA,,2018-10-11,,900.0,-528250429.90000063,.
409000438620',2018-10-11,Indiaforensic AEPS NPCI WDL SET,,2018-10-11,,4897200.0,-523353229.90000063,.
409000438620',2018-10-11,CR827711251567/RMCPL24821/0,,2018-10-11,10000.0,,-523363229.90000063,.
409000438620',2018-10-11,CR827711251581/RMCPL19766/0,,2018-10-11,500.0,,-523363729.90000063,.
409000438620',2018-10-11,CR827711251577/RMCPL19527/0,,2018-10-11,2000.0,,-523365729.90000063,.
409000438620',2018-10-11,CR827711245132/RMCPL23991/0,,2018-10-11,5500.0,,-523371229.90000063,.
409000438620',2018-10-11,CR827711245149/RMCPL17696/0,,2018-10-11,1000.0,,-523372229.90000063,.
409000438620',2018-10-11,CR827711245271/RMCPL12805/0,,2018-10-11,1000.0,,-523373229.90000063,.
409000438620',2018-10-11,CR827711245037/RMCPL20518/0,,2018-10-11,5000.0,,-523378229.90000063,.
409000438620',2018-10-11,CR827711237290/RMCPL21549/0,,2018-10-11,10000.0,,-523388229.90000063,.
409000438620',2018-10-11,CR827711237300/RMCPL09152/0,,2018-10-11,700.0,,-523388929.90000063,.
409000438620',2018-10-11,CR827711250546/RMCPL12354/0,,2018-10-11,2000.0,,-523390929.90000063,.
409000438620',2018-10-11,CR827711251039/RMCPL14829/0,,2018-10-11,6000.0,,-523396929.90000063,.
409000438620',2018-10-11,CR827711251030/RMCPL20491/0,,2018-10-11,500.0,,-523397429.90000063,.
409000438620',2018-10-11,CR827711251026/RMCPL12354/0,,2018-10-11,2000.0,,-523399429.90000063,.
409000438620',2018-10-11,CR827711243143/RMCPL26120/0,,2018-10-11,800.0,,-523400229.90000063,.
409000438620',2018-10-11,CR827711252012/RMCPL15613/0,,2018-10-11,1000.0,,-523401229.90000063,.
409000438620',2018-10-11,CR827711251660/RMCPL27211/0,,2018-10-11,1000.0,,-523402229.90000063,.
409000438620',2018-10-11,CR827711251777/RMCPL14829/0,,2018-10-11,2000.0,,-523404229.90000063,.
409000438620',2018-10-11,CR827711252322/RMCPL22250/0,,2018-10-11,2000.0,,-523406229.90000063,.
409000438620',2018-10-11,CR827711241718/RMCPL23533/0,,2018-10-11,500.0,,-523406729.90000063,.
409000438620',2018-10-11,CR827711241717/RMCPL14643/0,,2018-10-11,2000.0,,-523408729.90000063,.
409000438620',2018-10-11,CR827711242199/RMCPL18049/0,,2018-10-11,10000.0,,-523418729.90000063,.
409000438620',2018-10-11,CR827711242261/RMCPL15112/0,,2018-10-11,1000.0,,-523419729.90000063,.
409000438620',2018-10-11,CR827711252340/RMCPL19079/0,,2018-10-11,900.0,,-523420629.90000063,.
409000438620',2018-10-11,CR827717323017/RMCPL19959/0,,2018-10-11,500.0,,-523421129.90000063,.
409000438620',2018-10-11,CR827717331318/RMCPL23157/0,,2018-10-11,1000.0,,-523422129.90000063,.
409000438620',2018-10-11,CR827711248498/RMCPL21549/0,,2018-10-11,2000.0,,-523424129.90000063,.
409000438620',2018-10-11,CR827711248568/RMCPL14382/0,,2018-10-11,1200.0,,-523425329.90000063,.
409000438620',2018-10-11,CR827711248924/RMCPL24117/0,,2018-10-11,1000.0,,-523426329.90000063,.
409000438620',2018-10-11,CR827711248563/RMCPL20143/0,,2018-10-11,2000.0,,-523428329.90000063,.
409000438620',2018-10-11,CR827711248932/RMCPL27346/0,,2018-10-11,2400.0,,-523430729.90000063,.
409000438620',2018-10-11,CR827711248560/RMCPL20518/0,,2018-10-11,1300.0,,-523432029.90000063,.
409000438620',2018-10-11,CR827711249108/RMCPL19146/0,,2018-10-11,500.0,,-523432529.90000063,.
409000438620',2018-10-11,CR827711249333/RMCPL22507/0,,2018-10-11,3000.0,,-523435529.90000063,.
409000438620',2018-10-11,CR827711249480/RMCPL22866/0,,2018-10-11,1000.0,,-523436529.90000063,.
409000438620',2018-10-11,CR827711249474/RMCPL20143/0,,2018-10-11,2000.0,,-523438529.90000063,.
409000438620',2018-10-11,CR827711249749/RMCPL20587/0,,2018-10-11,2000.0,,-523440529.90000063,.
409000438620',2018-10-11,CR827712253388/RMCPL11151/0,,2018-10-11,500.0,,-523441029.90000063,.
409000438620',2018-10-11,CR827712253324/RMCPL23031/0,,2018-10-11,500.0,,-523441529.90000063,.
409000438620',2018-10-11,CR827712253877/RMCPL20245/0,,2018-10-11,5000.0,,-523446529.90000063,.
409000438620',2018-10-11,CR827712253870/RMCPL25271/0,,2018-10-11,500.0,,-523447029.90000063,.
409000438620',2018-10-11,CR827712254403/RMCPL19941/0,,2018-10-11,2500.0,,-523449529.90000063,.
409000438620',2018-10-11,CR827712254329/RMCPL13815/0,,2018-10-11,4000.0,,-523453529.90000063,.
409000438620',2018-10-11,CR827712254721/RMCPL19146/0,,2018-10-11,700.0,,-523454229.90000063,.
409000438620',2018-10-11,CR827712257212/RMCPL23244/0,,2018-10-11,1000.0,,-523455229.90000063,.
409000438620',2018-10-11,CR827712257107/RMCPL11131/0,,2018-10-11,1000.0,,-523456229.90000063,.
409000438620',2018-10-11,CR827712260631/RMCPL25277/0,,2018-10-11,500.0,,-523456729.90000063,.
409000438620',2018-10-11,CR827712260572/RMCPL20311/0,,2018-10-11,2000.0,,-523458729.90000063,.
409000438620',2018-10-11,CR827712260640/RMCPL23562/0,,2018-10-11,500.0,,-523459229.90000063,.
409000438620',2018-10-11,CR827712260621/RMCPL27159/0,,2018-10-11,2000.0,,-523461229.90000063,.
409000438620',2018-10-11,CR827712260637/RMCPL15535/0,,2018-10-11,2000.0,,-523463229.90000063,.
409000438620',2018-10-11,CR827712260624/RMCPL18671/0,,2018-10-11,10000.0,,-523473229.90000063,.
409000438620',2018-10-11,CR827712260648/RMCPL09523/0,,2018-10-11,3000.0,,-523476229.90000063,.
409000438620',2018-10-11,CR827712260658/RMCPL17534/0,,2018-10-11,10000.0,,-523486229.90000063,.
409000438620',2018-10-11,CR827712253232/RMCPL09612/0,,2018-10-11,1500.0,,-523487729.90000063,.
409000438620',2018-10-11,CR827712253258/RMCPL26216/0,,2018-10-11,6000.0,,-523493729.90000063,.
409000438620',2018-10-11,CR827711243055/RMCPL25199/0,,2018-10-11,1000.0,,-523494729.90000063,.
409000438620',2018-10-11,CR827711243077/RMCPL18596/0,,2018-10-11,500.0,,-523495229.90000063,.
409000438620',2018-10-11,CR827711245069/RMCPL09726/0,,2018-10-11,5000.0,,-523500229.90000063,.
409000438620',2018-10-11,CR827816550310/RMCPL22286/0,,2018-10-11,500.0,,-523500729.90000063,.
409000438620',2018-10-11,CR827816547296/RMCPL21728/0,,2018-10-11,500.0,,-523501229.90000063,.
409000438620',2018-10-11,CR827816551052/RMCPL24250/0,,2018-10-11,500.0,,-523501729.90000063,.
409000438620',2018-10-11,CR827814528982/RMCPL19108/0,,2018-10-11,5000.0,,-523506729.90000063,.
409000438620',2018-10-11,CR827814527010/RMCPL23228/0,,2018-10-11,1500.0,,-523508229.90000063,.
409000438620',2018-10-11,CR827814528027/RMCPL21381/0,,2018-10-11,2500.0,,-523510729.90000063,.
409000438620',2018-10-11,CR827811476742/RMCPL19108/0,,2018-10-11,700.0,,-523511429.90000063,.
409000438620',2018-10-11,CR827811476795/RMCPL21454/0,,2018-10-11,10000.0,,-523521429.90000063,.
409000438620',2018-10-11,MICROATM_DIFF_101018,,2018-10-11,,10000.0,-523511429.90000063,.
409000438620',2018-10-11,TRF TO  Indiaforensic SERVICES I,,2018-10-11,5000000.0,,-528511429.90000063,.
409000438620',2018-10-11,MAW/502964XXXXXX8983/NAGA,,2018-10-11,,1000.0,-528510429.90000063,.
409000438620',2018-10-11,MICRO ATM WDL FEE DT10101,,2018-10-11,,470000.0,-528040429.90000063,.
409000438620',2018-10-11,MICRO ATM INC DATED 10101,,2018-10-11,,1128.24,-528039301.6600006,.
409000438620',2018-10-11,MICRO ATM GST DATED 10101,,2018-10-11,,225.65,-528039076.01000065,.
409000438620',2018-10-11,TRF TO  Indiaforensic SERVICES I,,2018-10-11,600000.0,,-528639076.01000065,.
409000438620',2018-10-11,MICRO ATM WDL FEE DT11101,,2018-10-11,,343700.0,-528295376.01000065,.
409000438620',2018-10-11,MICRO ATM INC DATED 11101,,2018-10-11,,755.28,-528294620.7300007,.
409000438620',2018-10-11,MICRO ATM GST DATED 11101,,2018-10-11,,151.06,-528294469.6700007,.
409000438620',2018-10-11,AEPS INCOME DT 10-10-2018,,2018-10-11,,12684.07,-528281785.6000007,.
409000438620',2018-10-11,AEPS GST INC DT 10-10-201,,2018-10-11,,2536.81,-528279248.7900007,.
409000438620',2018-10-11,AEPS ACQ CR ADJ FEES 1010,,2018-10-11,641.33,,-528279890.12000066,.
409000438620',2018-10-11,AEPS ACQ REP ADJ FEES 101,,2018-10-11,,53.1,-528279837.02000064,.
409000438620',2018-10-11,AEPS PAY Indiaforensic 1010,,2018-10-11,,99.64,-528279737.38000065,.
409000438620',2018-10-12,MAW/502964XXXXXX0699/Karu,,2018-10-12,,1800.0,-528277937.38000065,.
409000438620',2018-10-12,Indiaforensic AEPS NPCI WDL SET,,2018-10-12,,4610700.0,-523667237.38000065,.
409000438620',2018-10-12,CR828010944194/RMCPL25301/0,,2018-10-12,500.0,,-523667737.38000065,.
409000438620',2018-10-12,CR828017036942/RMCPL00225/0,,2018-10-12,10000.0,,-523677737.38000065,.
409000438620',2018-10-12,CR828017036928/RMCPL27464/0,,2018-10-12,2000.0,,-523679737.38000065,.
409000438620',2018-10-12,CR827909695194/RMCPL27083/0,,2018-10-12,700.0,,-523680437.38000065,.
409000438620',2018-10-12,CR827916795400/RMCPL20420/0,,2018-10-12,500.0,,-523680937.38000065,.
409000438620',2018-10-12,CR827911720308/RMCPL23821/0,,2018-10-12,10000.0,,-523690937.38000065,.
409000438620',2018-10-12,CR828212450385/RMCPL15290/0,,2018-10-12,1200.0,,-523692137.38000065,.
409000438620',2018-10-12,CR828217516610/RMCPL25883/0,,2018-10-12,2400.0,,-523694537.38000065,.
409000438620',2018-10-12,CR828214467604/RMCPL00225/0,,2018-10-12,1500.0,,-523696037.38000065,.
409000438620',2018-10-12,CR828216492973/RMCPL24532/0,,2018-10-12,3300.0,,-523699337.38000065,.
409000438620',2018-10-12,CR828117280324/RMCPL18136/0,,2018-10-12,1000.0,,-523700337.38000065,.
409000438620',2018-10-12,TRF TO  Indiaforensic SERVICES I,,2018-10-12,4900000.0,,-528600337.38000065,.
409000438620',2018-10-12,MAW/502964XXXXXX4259/Karu,,2018-10-12,,2000.0,-528598337.38000065,.
409000438620',2018-10-12,MAW/502964XXXXXX7502/Akol,,2018-10-12,,1000.0,-528597337.38000065,.
409000438620',2018-10-12,MAW/502964XXXXXX1997/NAGA,,2018-10-12,,1200.0,-528596137.38000065,.
409000438620',2018-10-12,MICRO ATM WDL FEE DT11101,,2018-10-12,,543700.0,-528052437.38000065,.
409000438620',2018-10-12,MICRO ATM INC DATED 11101,,2018-10-12,,1203.48,-528051233.90000063,.
409000438620',2018-10-12,MICRO ATM GST DATED 11101,,2018-10-12,,240.7,-528050993.20000064,.
409000438620',2018-10-12,AEPS INCOME DT 10-11-2018,,2018-10-12,,11805.69,-528039187.51000065,.
409000438620',2018-10-12,AEPS GST INC DT 10-11-201,,2018-10-12,,2361.14,-528036826.37000066,.
409000438620',2018-10-12,TRF TO  Indiaforensic SERVICES I,,2018-10-12,600000.0,,-528636826.37000066,.
409000438620',2018-10-12,AEPS ACQ CR ADJ FEES 1110,,2018-10-12,110.92,,-528636937.2900007,.
409000438620',2018-10-12,MICRO ATM WDL FEE DT12101,,2018-10-12,,382200.0,-528254737.2900007,.
409000438620',2018-10-12,MICRO ATM INC DATED 12101,,2018-10-12,,967.32,-528253769.9700007,.
409000438620',2018-10-12,MICRO ATM GST DATED 12101,,2018-10-12,,193.46,-528253576.5100007,.
409000438620',2018-10-12,NPCI SETELEMENT DIFF_1110,,2018-10-12,,6000.0,-528247576.5100007,.
409000438620',2018-10-13,MAW/502964XXXXXX3514/NAGA,,2018-10-13,,1200.0,-528246376.5100007,.
409000438620',2018-10-14,MAW/502964XXXXXX9031/NAGA,,2018-10-14,,900.0,-528245476.5100007,.
409000438620',2018-10-15,Indiaforensic AEPS NPCI WDL SET,,2018-10-15,,4946700.0,-523298776.5100007,.
409000438620',2018-10-15,TRF TO  Indiaforensic SERVICES I,,2018-10-15,5300000.0,,-528598776.5100007,.
409000438620',2018-10-15,Indiaforensic AEPS NPCI WDL SET,,2018-10-15,,4262800.0,-524335976.5100007,.
409000438620',2018-10-15,MAW/502964XXXXXX2797/Karu,,2018-10-15,,1700.0,-524334276.5100007,.
409000438620',2018-10-15,MAW/502964XXXXXX4795/Karu,,2018-10-15,,1700.0,-524332576.5100007,.
409000438620',2018-10-15,MAW/502964XXXXXX6003/Karu,,2018-10-15,,1700.0,-524330876.5100007,.
409000438620',2018-10-15,MAW/502964XXXXXX0616/Karu,,2018-10-15,,1700.0,-524329176.5100007,.
409000438620',2018-10-15,MAW/502964XXXXXX8907/Karu,,2018-10-15,,1700.0,-524327476.5100007,.
409000438620',2018-10-15,CR828311672209/RMCPL12805/1,,2018-10-15,1000.0,,-524328476.5100007,.
409000438620',2018-10-15,CR828314716251/RMCPL00928/1,,2018-10-15,500.0,,-524328976.5100007,.
409000438620',2018-10-15,CR828312681787/RMCPL19793/1,,2018-10-15,4000.0,,-524332976.5100007,.
409000438620',2018-10-15,CR828318764591/RMCPL11793/1,,2018-10-15,4000.0,,-524336976.5100007,.
409000438620',2018-10-15,Indiaforensic AEPS NPCI WDL SET,,2018-10-15,,2821100.0,-521515876.5100007,.
409000438620',2018-10-15,TRF TO  Indiaforensic SERVICES I,,2018-10-15,3000000.0,,-524515876.5100007,.
409000438620',2018-10-15,TRF TO  Indiaforensic SERVICES I,,2018-10-15,4000000.0,,-528515876.5100007,.
409000438620',2018-10-15,NPCI SETELEMENT DIFF_1210,,2018-10-15,,5000.0,-528510876.5100007,.
409000438620',2018-10-15,MICRO ATM WDL FEE DT15101,,2018-10-15,,525200.0,-527985676.5100007,.
409000438620',2018-10-15,MICRO ATM INC DATED 15101,,2018-10-15,,1333.8,-527984342.7100007,.
409000438620',2018-10-15,MICRO ATM GST DATED 15101,,2018-10-15,,266.76,-527984075.9500007,.
409000438620',2018-10-15,MICRO ATM WDL FEE DT12101,,2018-10-15,,633900.0,-527350175.9500007,.
409000438620',2018-10-15,MICRO ATM INC DATED 12101,,2018-10-15,,1396.44,-527348779.5100007,.
409000438620',2018-10-15,MICRO ATM GST DATED 12101,,2018-10-15,,279.29,-527348500.2200007,.
409000438620',2018-10-15,MICRO ATM WDL FEE DT13101,,2018-10-15,,1075300.0,-526273200.2200007,.
409000438620',2018-10-15,MICRO ATM INC DATED 13101,,2018-10-15,,2415.24,-526270784.9800007,.
409000438620',2018-10-15,MICRO ATM GST DATED 13101,,2018-10-15,,483.05,-526270301.93000066,.
409000438620',2018-10-15,MICRO ATM WDL FEE DT14101,,2018-10-15,,1016500.0,-525253801.93000066,.
409000438620',2018-10-15,MICRO ATM INC DATED 14101,,2018-10-15,,2486.52,-525251315.4100007,.
409000438620',2018-10-15,MICRO ATM GST DATED 14101,,2018-10-15,,497.3,-525250818.11000067,.
409000438620',2018-10-15,TRF TO  Indiaforensic SERVICES I,,2018-10-15,3000000.0,,-528250818.11000067,.
409000438620',2018-10-15,AEPS INCOME DT 10-12-2018,,2018-10-15,,13097.03,-528237721.0800007,.
409000438620',2018-10-15,AEPS GST INC DT 10-12-201,,2018-10-15,,2619.41,-528235101.6700007,.
409000438620',2018-10-15,AEPS INCOME DT 10-13-2018,,2018-10-15,,11285.01,-528223816.6600007,.
409000438620',2018-10-15,AEPS GST INC DT 10-13-201,,2018-10-15,,2257.0,-528221559.6600007,.
409000438620',2018-10-15,AEPS INCOME DT 10-14-2018,,2018-10-15,,7680.53,-528213879.1300007,.
409000438620',2018-10-15,AEPS GST INC DT 10-14-201,,2018-10-15,,1536.11,-528212343.0200007,.
409000438620',2018-10-15,AEPS ACQUIRING ADJ FEES 1,,2018-10-15,17.7,,-528212360.7200007,.
409000438620',2018-10-15,AEPS ACQ CR ADJ FEES 1210,,2018-10-15,44.25,,-528212404.9700007,.
409000438620',2018-10-15,AEPS ACQ REP ADJ FEES 121,,2018-10-15,,17.7,-528212387.2700007,.
409000438620',2018-10-15,AEPS PAY Indiaforensic 1310,,2018-10-15,,398.87,-528211988.4000007,.
409000438620',2018-10-16,MAW/502964XXXXXX8587/NAGA,,2018-10-16,,900.0,-528211088.4000007,.
409000438620',2018-10-16,Indiaforensic AEPS NPCI WDL SET,,2018-10-16,,4309800.0,-523901288.4000007,.
409000438620',2018-10-16,CR828409879832/RMCPL21726/1,,2018-10-16,500.0,,-523901788.4000007,.
409000438620',2018-10-16,CR828412923728/RMCPL10937/1,,2018-10-16,500.0,,-523902288.4000007,.
409000438620',2018-10-16,CR828417992743/RMCPL12772/1,,2018-10-16,500.0,,-523902788.4000007,.
409000438620',2018-10-16,CR828413946715/RMCPL09592/1,,2018-10-16,10000.0,,-523912788.4000007,.
409000438620',2018-10-16,TRF TO  Indiaforensic SERVICES I,,2018-10-16,4600000.0,,-528512788.4000007,.
409000438620',2018-10-16,MAW/502964XXXXXX0486/NAGA,,2018-10-16,,900.0,-528511888.4000007,.
409000438620',2018-10-16,MAW/502964XXXXXX8117/NAGA,,2018-10-16,,600.0,-528511288.4000007,.
409000438620',2018-10-16,NPCI SETELEMENT DIFF_1410,,2018-10-16,,1600.0,-528509688.4000007,.
409000438620',2018-10-16,MICRO ATM WDL FEE DT15101,,2018-10-16,,826800.0,-527682888.4000007,.
409000438620',2018-10-16,MICRO ATM INC DATED 15101,,2018-10-16,,2061.36,-527680827.0400007,.
409000438620',2018-10-16,MICRO ATM GST DATED 15101,,2018-10-16,,412.27,-527680414.7700007,.
409000438620',2018-10-16,AEPS INCOME DT 10-15-2018,,2018-10-16,,11465.65,-527668949.1200007,.
409000438620',2018-10-16,AEPS GST INC DT 10-15-201,,2018-10-16,,2293.13,-527666655.9900007,.
409000438620',2018-10-16,AEPS ACQ CR ADJ FEES 1510,,2018-10-16,26.55,,-527666682.54000074,.
409000438620',2018-10-16,MICRO ATM WDL FEE DT16101,,2018-10-16,,583800.0,-527082882.54000074,.
409000438620',2018-10-16,MICRO ATM INC DATED 16101,,2018-10-16,,1371.6,-527081510.9400007,.
409000438620',2018-10-16,MICRO ATM GST DATED 16101,,2018-10-16,,274.32,-527081236.6200007,.
409000438620',2018-10-16,TRF TO  Indiaforensic SERVICES I,,2018-10-16,600000.0,,-527681236.6200007,.
409000438620',2018-10-16,TRF TO  Indiaforensic SERVICES I,,2018-10-16,900000.0,,-528581236.6200007,.
409000438620',2018-10-17,CB827711242705/RMCPL22522/0,,2018-10-17,3000.0,,-528584236.6200007,.
409000438620',2018-10-17,Indiaforensic AEPS NPCI WDL SET,,2018-10-17,,4545300.0,-524038936.6200007,.
409000438620',2018-10-17,CR828609360769/RMCPL19422/1,,2018-10-17,1000.0,,-524039936.6200007,.
409000438620',2018-10-17,CR828616455674/RMCPL12858/1,,2018-10-17,10000.0,,-524049936.6200007,.
409000438620',2018-10-17,CR828616455583/RMCPL22756/1,,2018-10-17,1600.0,,-524051536.6200007,.
409000438620',2018-10-17,CR828610374687/RMCPL12952/1,,2018-10-17,5000.0,,-524056536.6200007,.
409000438620',2018-10-17,CR828612406662/RMCPL25190/1,,2018-10-17,10000.0,,-524066536.6200007,.
409000438620',2018-10-17,CR828511149943/RMCPL24195/1,,2018-10-17,1800.0,,-524068336.6200007,.
409000438620',2018-10-17,CR828511149965/RMCPL19037/1,,2018-10-17,1000.0,,-524069336.6200007,.
409000438620',2018-10-17,MAW/502964XXXXXX6900/Karu,,2018-10-17,,1900.0,-524067436.6200007,.
409000438620',2018-10-17,MAW/502964XXXXXX3012/Karu,,2018-10-17,,1700.0,-524065736.6200007,.
409000438620',2018-10-17,MICRO ATM WDL FEE DT16101,,2018-10-17,,792000.0,-523273736.6200007,.
409000438620',2018-10-17,MICRO ATM INC DATED 16101,,2018-10-17,,1848.6,-523271888.0200007,.
409000438620',2018-10-17,MICRO ATM GST DATED 16101,,2018-10-17,,369.72,-523271518.30000067,.
409000438620',2018-10-17,TRF TO  Indiaforensic SERVICES I,,2018-10-17,4400000.0,,-527671518.30000067,.
409000438620',2018-10-17,AEPS PAY Indiaforensic 1510,,2018-10-17,,99.64,-527671418.6600007,.
409000438620',2018-10-17,AEPS INCOME DT 10-16-2018,,2018-10-17,,11855.19,-527659563.4700007,.
409000438620',2018-10-17,AEPS GST INC DT 10-16-201,,2018-10-17,,2371.04,-527657192.43000066,.
409000438620',2018-10-17,TRF TO  Indiaforensic SERVICES I,,2018-10-17,900000.0,,-528557192.43000066,.
409000438620',2018-10-17,AEPS ACQ CR ADJ FEES 1610,,2018-10-17,84.96,,-528557277.39000064,.
409000438620',2018-10-17,MICRO ATM WDL FEE DT17101,,2018-10-17,,670300.0,-527886977.39000064,.
409000438620',2018-10-17,MICRO ATM INC DATED 17101,,2018-10-17,,1611.36,-527885366.0300006,.
409000438620',2018-10-17,MICRO ATM GST DATED 17101,,2018-10-17,,322.27,-527885043.76000065,.
409000438620',2018-10-17,TRF TO  Indiaforensic SERVICES I,,2018-10-17,700000.0,,-528585043.76000065,.
409000438620',2018-10-18,Indiaforensic AEPS NPCI WDL SET,,2018-10-18,,4532000.0,-524053043.76000065,.
409000438620',2018-10-18,AEPS INCOME DT 10-17-2018,,2018-10-18,,12456.86,-524040586.90000063,.
409000438620',2018-10-18,AEPS GST INC DT 10-17-201,,2018-10-18,,2491.37,-524038095.5300006,.
409000438620',2018-10-18,AEPS ACQ REP ADJ FEES 171,,2018-10-18,,17.7,-524038077.83000064,.
409000438620',2018-10-18,TRF TO  Indiaforensic SERVICES I,,2018-10-18,4600000.0,,-528638077.83000064,.
409000438620',2018-10-18,MAW/502964XXXXXX0270/NAGA,,2018-10-18,,1700.0,-528636377.83000064,.
409000438620',2018-10-19,MAW/502964XXXXXX0296/NAGA,,2018-10-19,,1700.0,-528634677.83000064,.
409000438620',2018-10-19,MAW/502964XXXXXX0821/NAGA,,2018-10-19,,500.0,-528634177.83000064,.
409000438620',2018-10-19,Indiaforensic AEPS NPCI WDL SET,,2018-10-19,,3405300.0,-525228877.83000064,.
409000438620',2018-10-19,MAW/502964XXXXXX0502/NAGA,,2018-10-19,,1400.0,-525227477.83000064,.
409000438620',2018-10-19,MAW/502964XXXXXX9796/NAGA,,2018-10-19,,1300.0,-525226177.83000064,.
409000438620',2018-10-19,AEPS INCOME DT 10-18-2018,,2018-10-19,,9439.22,-525216738.6100006,.
409000438620',2018-10-19,AEPS GST INC DT 10-18-201,,2018-10-19,,1887.84,-525214850.77000064,.
409000438620',2018-10-19,AEPS PAY Indiaforensic 1810,,2018-10-19,,1058.48,-525213792.2900006,.
409000438620',2018-10-19,AEPS PAY Indiaforensic 1710,,2018-10-19,,299.23,-525213493.0600006,.
409000438620',2018-10-19,MICRO ATM WDL FEE DT17101,,2018-10-19,,735800.0,-524477693.0600006,.
409000438620',2018-10-19,MICRO ATM INC DATED 17101,,2018-10-19,,1822.32,-524475870.7400006,.
409000438620',2018-10-19,MICRO ATM GST DATED 17101,,2018-10-19,,364.46,-524475506.2800006,.
409000438620',2018-10-19,MICRO ATM WDL FEE DT18101,,2018-10-19,,658400.0,-523817106.2800006,.
409000438620',2018-10-19,MICRO ATM INC DATED 18101,,2018-10-19,,1618.92,-523815487.3600006,.
409000438620',2018-10-19,MICRO ATM GST DATED 18101,,2018-10-19,,323.78,-523815163.58000064,.
409000438620',2018-10-19,MICRO ATM WDL FEE DT18101,,2018-10-19,,618600.0,-523196563.58000064,.
409000438620',2018-10-19,MICRO ATM INC DATED 18101,,2018-10-19,,1360.44,-523195203.14000064,.
409000438620',2018-10-19,MICRO ATM GST DATED 18101,,2018-10-19,,272.09,-523194931.05000067,.
409000438620',2018-10-19,TFR TO 1196428  Indiaforensic SE,,2018-10-19,3000000.0,,-526194931.05000067,.
409000438620',2018-10-19,MICRO ATM WDL FEE DT19101,,2018-10-19,,540400.0,-525654531.05000067,.
409000438620',2018-10-19,MICRO ATM INC DATED 19101,,2018-10-19,,1123.92,-525653407.13000065,.
409000438620',2018-10-19,MICRO ATM GST DATED 19101,,2018-10-19,,224.78,-525653182.3500007,.
409000438620',2018-10-20,MAW/502964XXXXXX1963/NAGA,,2018-10-20,,300.0,-525652882.3500007,.
409000438620',2018-10-20,Indiaforensic AEPS NPCI WDL SET,,2018-10-20,,3363700.0,-522289182.3500007,.
409000438620',2018-10-20,CR828815899935/RMCPL17167/1,,2018-10-20,5000.0,,-522294182.3500007,.
409000438620',2018-10-20,CR828815900027/RMCPL26216/1,,2018-10-20,2000.0,,-522296182.3500007,.
409000438620',2018-10-20,CR828812852337/RMCPL07044/1,,2018-10-20,3000.0,,-522299182.3500007,.
409000438620',2018-10-20,CR828812852283/RMCPL23966/1,,2018-10-20,4500.0,,-522303682.3500007,.
409000438620',2018-10-20,CR828812852304/RMCPL15535/1,,2018-10-20,8000.0,,-522311682.3500007,.
409000438620',2018-10-20,CR828812852272/RMCPL18061/1,,2018-10-20,1000.0,,-522312682.3500007,.
409000438620',2018-10-20,CR828812852291/RMCPL22431/1,,2018-10-20,2000.0,,-522314682.3500007,.
409000438620',2018-10-20,CR828813874844/RMCPL11131/1,,2018-10-20,500.0,,-522315182.3500007,.
409000438620',2018-10-20,CR828816902833/RMCPL09592/1,,2018-10-20,3500.0,,-522318682.3500007,.
409000438620',2018-10-20,CR828816903323/RMCPL22310/1,,2018-10-20,1000.0,,-522319682.3500007,.
409000438620',2018-10-20,CR828816914222/RMCPL11793/1,,2018-10-20,7000.0,,-522326682.3500007,.
409000438620',2018-10-20,CR828816903494/RMCPL17359/1,,2018-10-20,1000.0,,-522327682.3500007,.
409000438620',2018-10-20,CR828812850777/RMCPL17167/1,,2018-10-20,500.0,,-522328182.3500007,.
409000438620',2018-10-20,CR828818947142/RMCPL15254/1,,2018-10-20,500.0,,-522328682.3500007,.
409000438620',2018-10-20,CR828818947118/RMCPL23653/1,,2018-10-20,500.0,,-522329182.3500007,.
409000438620',2018-10-20,CR828818947202/RMCPL15670/1,,2018-10-20,500.0,,-522329682.3500007,.
409000438620',2018-10-20,CR828816902623/RMCPL29325/1,,2018-10-20,2000.0,,-522331682.3500007,.
409000438620',2018-10-20,CR828816902613/RMCPL09612/1,,2018-10-20,500.0,,-522332182.3500007,.
409000438620',2018-10-20,CR828816902683/RMCPL11151/1,,2018-10-20,700.0,,-522332882.3500007,.
409000438620',2018-10-20,CR828815899130/RMCPL11131/1,,2018-10-20,500.0,,-522333382.3500007,.
409000438620',2018-10-20,CR828815899072/RMCPL15254/1,,2018-10-20,1000.0,,-522334382.3500007,.
409000438620',2018-10-20,CR828815899114/RMCPL20068/1,,2018-10-20,1200.0,,-522335582.3500007,.
409000438620',2018-10-20,CR828815899617/RMCPL09592/1,,2018-10-20,1000.0,,-522336582.3500007,.
409000438620',2018-10-20,CR828815899953/RMCPL15510/1,,2018-10-20,6000.0,,-522342582.3500007,.
409000438620',2018-10-20,CR829015369926/RMCPL21218/1,,2018-10-20,4000.0,,-522346582.3500007,.
409000438620',2018-10-20,CR829010308972/RMCPL21381/1,,2018-10-20,2000.0,,-522348582.3500007,.
409000438620',2018-10-20,CR829010308898/RMCPL20241/1,,2018-10-20,1000.0,,-522349582.3500007,.
409000438620',2018-10-20,TRF TO  Indiaforensic SERVICES I,,2018-10-20,1000000.0,,-523349582.3500007,.
409000438620',2018-10-20,TRF TO  Indiaforensic SERVICES I,,2018-10-20,1000000.0,,-524349582.3500007,.
409000438620',2018-10-20,TRF TO  Indiaforensic SERVICES I,,2018-10-20,1000000.0,,-525349582.3500007,.
409000438620',2018-10-20,NPCI SETELEMENT DIFF_1910,,2018-10-20,,1000.0,-525348582.3500007,.
409000438620',2018-10-20,TRF TO  Indiaforensic SERVICES I,,2018-10-20,2000000.0,,-527348582.3500007,.
409000438620',2018-10-20,TRF TO  Indiaforensic SERVICES I,,2018-10-20,1000000.0,,-528348582.3500007,.
409000438620',2018-10-20,MICRO ATM WDL FEE DT19101,,2018-10-20,,174200.0,-528174382.3500007,.
409000438620',2018-10-20,MICRO ATM INC DATED 19101,,2018-10-20,,387.0,-528173995.3500007,.
409000438620',2018-10-20,MICRO ATM GST DATED 19101,,2018-10-20,,77.4,-528173917.9500007,.
409000438620',2018-10-20,AEPS PAY Indiaforensic 1910,,2018-10-20,,499.4,-528173418.5500007,.
409000438620',2018-10-20,AEPS INCOME DT 10-19-2018,,2018-10-20,,9124.69,-528164293.8600007,.
409000438620',2018-10-20,AEPS GST INC DT 10-19-201,,2018-10-20,,1824.94,-528162468.92000073,.
409000438620',2018-10-20,AEPS ACQCR ADJ FEES 19101,,2018-10-20,256.06,,-528162724.98000073,.
409000438620',2018-10-20,MICRO ATM WDL FEE DT20101,,2018-10-20,,447400.0,-527715324.98000073,.
409000438620',2018-10-20,MICRO ATM INC DATED 20101,,2018-10-20,,979.56,-527714345.42000073,.
409000438620',2018-10-20,MICRO ATM GST DATED 20101,,2018-10-20,,195.91,-527714149.5100007,.
409000438620',2018-10-22,MAW/502964XXXXXX2291/Karu,,2018-10-22,,700.0,-527713449.5100007,.
409000438620',2018-10-22,Indiaforensic AEPS NPCI WDL SET,,2018-10-22,,3400700.0,-524312749.5100007,.
409000438620',2018-10-22,Indiaforensic AEPS NPCI WDL SET,,2018-10-22,,2355300.0,-521957449.5100007,.
409000438620',2018-10-22,TRF TO  Indiaforensic SERVICES I,,2018-10-22,5000000.0,,-526957449.5100007,.
409000438620',2018-10-22,TRF TO  Indiaforensic SERVICES I,,2018-10-22,1000000.0,,-527957449.5100007,.
409000438620',2018-10-22,TRF TO  Indiaforensic SERVICES I,,2018-10-22,500000.0,,-528457449.5100007,.
409000438620',2018-10-22,MICRO ATM WDL FEE DT21101,,2018-10-22,,1351700.0,-527105749.5100007,.
409000438620',2018-10-22,MICRO ATM INC DATED 21101,,2018-10-22,,2840.4,-527102909.1100007,.
409000438620',2018-10-22,MICRO ATM GST DATED 21101,,2018-10-22,,568.08,-527102341.03000075,.
409000438620',2018-10-22,MICRO ATM WDL FEE DT22101,,2018-10-22,,551800.0,-526550541.03000075,.
409000438620',2018-10-22,MICRO ATM INC DATED 22101,,2018-10-22,,1300.68,-526549240.35000074,.
409000438620',2018-10-22,MICRO ATM GST DATED 22101,,2018-10-22,,260.14,-526548980.21000075,.
409000438620',2018-10-22,AEPS PAY Indiaforensic 2010,,2018-10-22,,99.64,-526548880.57000077,.
409000438620',2018-10-22,AEPS PAY Indiaforensic 2110,,2018-10-22,,199.58,-526548680.9900008,.
409000438620',2018-10-22,TRF TO  Indiaforensic SERVICES I,,2018-10-22,1500000.0,,-528048680.9900008,.
409000438620',2018-10-22,AEPS INCOME DT 10-20-2018,,2018-10-22,,9437.2,-528039243.7900008,.
409000438620',2018-10-22,AEPS GST INC DT 10-20-201,,2018-10-22,,1887.44,-528037356.3500008,.
409000438620',2018-10-22,AEPS INCOME DT 10-21-2018,,2018-10-22,,6509.4,-528030846.9500008,.
409000438620',2018-10-22,AEPS GST INC DT 10-21-201,,2018-10-22,,1301.88,-528029545.0700008,.
409000438620',2018-10-22,AEPS ACQUIRING ADJ FEES 2,,2018-10-22,23.6,,-528029568.67000085,.
409000438620',2018-10-22,TRF TO  Indiaforensic SERVICES I,,2018-10-22,500000.0,,-528529568.67000085,.
409000438620',2018-10-22,MICRO ATM WDL FEE DT20101,,2018-10-22,,584400.0,-527945168.67000085,.
409000438620',2018-10-22,MICRO ATM INC DATED 20101,,2018-10-22,,1258.92,-527943909.75000083,.
409000438620',2018-10-22,MICRO ATM GST DATED 20101,,2018-10-22,,251.78,-527943657.97000086,.
409000438620',2018-10-23,Indiaforensic AEPS NPCI WDL SET,,2018-10-23,,4575100.0,-523368557.97000086,.
409000438620',2018-10-23,AEPS ACQ CR829217854200/R,,2018-10-23,600.0,,-523369157.97000086,.
409000438620',2018-10-23,AEPS ACQ CR829211771491/R,,2018-10-23,5000.0,,-523374157.97000086,.
409000438620',2018-10-23,AEPS ACQ CR829111561309/R,,2018-10-23,2000.0,,-523376157.97000086,.
409000438620',2018-10-23,AEPS ACQ CR829113586407/R,,2018-10-23,500.0,,-523376657.97000086,.
409000438620',2018-10-23,TRF TO  Indiaforensic SERVICES I,,2018-10-23,5200000.0,,-528576657.97000086,.
409000438620',2018-10-23,MICRO ATM WDL FEE DT22101,,2018-10-23,,806200.0,-527770457.97000086,.
409000438620',2018-10-23,MICRO ATM INC DATED 22101,,2018-10-23,,1871.64,-527768586.3300009,.
409000438620',2018-10-23,MICRO ATM GST DATED 22101,,2018-10-23,,374.33,-527768212.0000009,.
409000438620',2018-10-23,NPCI_SETT_DIFF_221018,,2018-10-23,,3000.0,-527765212.0000009,.
409000438620',2018-10-23,TRF TO  Indiaforensic SERVICES I,,2018-10-23,800000.0,,-528565212.0000009,.
409000438620',2018-10-23,AEPS INCOME DT 10-22-2018,,2018-10-23,,12013.53,-528553198.4700009,.
409000438620',2018-10-23,AEPS GST INC DT 10-22-201,,2018-10-23,,2402.71,-528550795.76000094,.
409000438620',2018-10-23,AEPS ACQ CR ADJ FEES 2210,,2018-10-23,35.95,,-528550831.71000093,.
409000438620',2018-10-23,MICRO ATM WDL FEE DT23101,,2018-10-23,,340300.0,-528210531.71000093,.
409000438620',2018-10-23,MICRO ATM INC DATED 23101,,2018-10-23,,892.08,-528209639.63000095,.
409000438620',2018-10-23,MICRO ATM GST DATED 23101,,2018-10-23,,178.42,-528209461.21000093,.
409000438620',2018-10-24,Indiaforensic AEPS NPCI WDL SET,,2018-10-24,,4185100.0,-524024361.21000093,.
409000438620',2018-10-24,CR829312010258/RMCPL17167/2,,2018-10-24,5000.0,,-524029361.21000093,.
409000438620',2018-10-24,TRF TO  Indiaforensic SERVICES I,,2018-10-24,4600000.0,,-528629361.21000093,.
409000438620',2018-10-24,NPCI_SETT_DIFF_231018,,2018-10-24,,2000.0,-528627361.21000093,.
409000438620',2018-10-24,MICRO ATM WDL FEE DT23101,,2018-10-24,,448100.0,-528179261.21000093,.
409000438620',2018-10-24,MICRO ATM INC DATED 23101,,2018-10-24,,1073.16,-528178188.0500009,.
409000438620',2018-10-24,MICRO ATM GST DATED 23101,,2018-10-24,,214.63,-528177973.4200009,.
409000438620',2018-10-24,AEPS INCOME DT 10-23-2018,,2018-10-24,,11181.27,-528166792.15000093,.
409000438620',2018-10-24,AEPS GST INC DT 10-23-201,,2018-10-24,,2236.25,-528164555.90000093,.
409000438620',2018-10-24,AEPS ACQUIRING ADJ FEES 2,,2018-10-24,11.8,,-528164567.70000094,.
409000438620',2018-10-24,AEPS ACQ CR ADJ FEES 2310,,2018-10-24,17.7,,-528164585.40000093,.
409000438620',2018-10-24,TRF TO  Indiaforensic SERVICES I,,2018-10-24,400000.0,,-528564585.40000093,.
409000438620',2018-10-24,MICRO ATM WDL FEE DT24101,,2018-10-24,,349500.0,-528215085.40000093,.
409000438620',2018-10-24,MICRO ATM INC DATED 24101,,2018-10-24,,868.68,-528214216.7200009,.
409000438620',2018-10-24,MICRO ATM GST DATED 24101,,2018-10-24,,173.74,-528214042.9800009,.
409000438620',2018-10-25,AEPS PAY Indiaforensic 2310,,2018-10-25,,798.94,-528213244.0400009,.
409000438620',2018-10-25,Indiaforensic AEPS NPCI WDL SET,,2018-10-25,,3534500.0,-524678744.0400009,.
409000438620',2018-10-25,TRF TO  Indiaforensic SERVICES I,,2018-10-25,3900000.0,,-528578744.0400009,.
409000438620',2018-10-25,AEPS PAY Indiaforensic 2410,,2018-10-25,,100.64,-528578643.40000093,.
409000438620',2018-10-25,MICRO ATM WDL FEE DT25101,,2018-10-25,,315600.0,-528263043.40000093,.
409000438620',2018-10-25,MICRO ATM INC DATED 25101,,2018-10-25,,802.08,-528262241.32000095,.
409000438620',2018-10-25,MICRO ATM GST DATED 25101,,2018-10-25,,160.42,-528262080.90000093,.
409000438620',2018-10-25,AEPS INCOME DT 10-24-2018,,2018-10-25,,9573.35,-528252507.5500009,.
409000438620',2018-10-25,AEPS GST INC DT 10-24-201,,2018-10-25,,1914.67,-528250592.8800009,.
409000438620',2018-10-25,MICRO ATM WDL FEE DT24101,,2018-10-25,,485400.0,-527765192.8800009,.
409000438620',2018-10-25,MICRO ATM INC DATED 24101,,2018-10-25,,1119.96,-527764072.9200009,.
409000438620',2018-10-25,MICRO ATM GST DATED 24101,,2018-10-25,,223.99,-527763848.9300009,.
409000438620',2018-10-25,TRF TO  Indiaforensic SERVICES I,,2018-10-25,400000.0,,-528163848.9300009,.
409000438620',2018-10-26,Indiaforensic AEPS NPCI WDL SET,,2018-10-26,,3530700.0,-524633148.9300009,.
409000438620',2018-10-26,CR829611694306/RMCPL11776/2,,2018-10-26,3500.0,,-524636648.9300009,.
409000438620',2018-10-26,CR829611694329/RMCPL27488/2,,2018-10-26,2000.0,,-524638648.9300009,.
409000438620',2018-10-26,CR829611695242/RMCPL22963/2,,2018-10-26,1000.0,,-524639648.9300009,.
409000438620',2018-10-26,CR829611695338/RMCPL23821/2,,2018-10-26,2000.0,,-524641648.9300009,.
409000438620',2018-10-26,CR829616794851/RMCPL22278/2,,2018-10-26,1000.0,,-524642648.9300009,.
409000438620',2018-10-26,MAW/502964XXXXXX2908/NAGA,,2018-10-26,,1700.0,-524640948.9300009,.
409000438620',2018-10-26,MAW/502964XXXXXX7298/NAGA,,2018-10-26,,1700.0,-524639248.9300009,.
409000438620',2018-10-26,TRF TO  Indiaforensic SERVICES I,,2018-10-26,4000000.0,,-528639248.9300009,.
409000438620',2018-10-26,MICRO ATM WDL FEE DT25101,,2018-10-26,,600700.0,-528038548.9300009,.
409000438620',2018-10-26,MICRO ATM INC DATED 25101,,2018-10-26,,1510.2,-528037038.7300009,.
409000438620',2018-10-26,MICRO ATM GST DATED 25101,,2018-10-26,,302.04,-528036736.6900009,.
409000438620',2018-10-26,MAW/502964XXXXXX8690/NAGA,,2018-10-26,,1700.0,-528035036.6900009,.
409000438620',2018-10-26,MAW/502964XXXXXX6850/NAGA,,2018-10-26,,1700.0,-528033336.6900009,.
409000438620',2018-10-26,MICRO ATM WDL FEE DT26101,,2018-10-26,,265800.0,-527767536.6900009,.
409000438620',2018-10-26,MICRO ATM INC DATED 26101,,2018-10-26,,676.8,-527766859.8900009,.
409000438620',2018-10-26,MICRO ATM GST DATED 26101,,2018-10-26,,135.36,-527766724.53000087,.
409000438620',2018-10-26,AEPS INCOME DT 10-25-2018,,2018-10-26,,9467.25,-527757257.28000087,.
409000438620',2018-10-26,AEPS GST INC DT 10-25-201,,2018-10-26,,1893.45,-527755363.8300009,.
409000438620',2018-10-26,AEPS ACQ CR ADJ FEES 2510,,2018-10-26,53.1,,-527755416.9300009,.
409000438620',2018-10-26,AEPS ACQ REP ADJ FEES 251,,2018-10-26,,23.6,-527755393.3300009,.
409000438620',2018-10-26,TRF TO  Indiaforensic SERVICES I,,2018-10-26,800000.0,,-528555393.3300009,.
409000438620',2018-10-27,MAW/502964XXXXXX8561/Ujja,,2018-10-27,,2000.0,-528553393.3300009,.
409000438620',2018-10-27,MAW/502964XXXXXX8561/Ujja,,2018-10-27,,1500.0,-528551893.3300009,.
409000438620',2018-10-27,MAW/502964XXXXXX2138/NAGA,,2018-10-27,,1700.0,-528550193.3300009,.
409000438620',2018-10-27,MAW/502964XXXXXX7563/NAGA,,2018-10-27,,1700.0,-528548493.3300009,.
409000438620',2018-10-29,Indiaforensic AEPS NPCI WDL SET,,2018-10-29,,3776600.0,-524771893.3300009,.
409000438620',2018-10-29,Indiaforensic AEPS NPCI WDL SET,,2018-10-29,,3401900.0,-521369993.3300009,.
409000438620',2018-10-29,Indiaforensic AEPS NPCI WDL SET,,2018-10-29,,1941600.0,-519428393.3300009,.
409000438620',2018-10-29,CR829713053791/RMCPL21038/2,,2018-10-29,500.0,,-519428893.3300009,.
409000438620',2018-10-29,TRF TO  Indiaforensic SERVICES I,,2018-10-29,9200000.0,,-528628893.3300009,.
409000438620',2018-10-29,MICRO ATM WDL FEE DT26101,,2018-10-29,,835400.0,-527793493.3300009,.
409000438620',2018-10-29,MICRO ATM INC DATED 26101,,2018-10-29,,1638.36,-527791854.97000086,.
409000438620',2018-10-29,MICRO ATM GST DATED 26101,,2018-10-29,,327.67,-527791527.30000085,.
409000438620',2018-10-29,MICRO ATM WDL FEE DT27101,,2018-10-29,,915000.0,-526876527.30000085,.
409000438620',2018-10-29,MICRO ATM INC DATED 27101,,2018-10-29,,2082.96,-526874444.34000087,.
409000438620',2018-10-29,MICRO ATM GST DATED 27101,,2018-10-29,,416.59,-526874027.7500009,.
409000438620',2018-10-29,MICRO ATM WDL FEE DT28101,,2018-10-29,,848100.0,-526025927.7500009,.
409000438620',2018-10-29,MICRO ATM INC DATED 28101,,2018-10-29,,1997.28,-526023930.4700009,.
409000438620',2018-10-29,MICRO ATM GST DATED 28101,,2018-10-29,,399.46,-526023531.01000094,.
409000438620',2018-10-29,TRF TO  Indiaforensic SERVICES I,,2018-10-29,800000.0,,-526823531.01000094,.
409000438620',2018-10-29,AEPS PAY Indiaforensic 2610,,2018-10-29,,322.51,-526823208.50000095,.
409000438620',2018-10-29,MICRO ATM WDL FEE DT29101,,2018-10-29,,409700.0,-526413508.50000095,.
409000438620',2018-10-29,MICRO ATM INC DATED 29101,,2018-10-29,,927.0,-526412581.50000095,.
409000438620',2018-10-29,MICRO ATM GST DATED 29101,,2018-10-29,,185.4,-526412396.100001,.
409000438620',2018-10-29,NPCI SETELEMENT DIFF_2610,,2018-10-29,,3000.0,-526409396.100001,.
409000438620',2018-10-29,AEPS INCOME DT 10-28-2018,,2018-10-29,,5296.37,-526404099.730001,.
409000438620',2018-10-29,AEPS GST INC DT 10-28-201,,2018-10-29,,1059.27,-526403040.460001,.
409000438620',2018-10-29,AEPS INCOME DT 10-27-2018,,2018-10-29,,9253.78,-526393786.680001,.
409000438620',2018-10-29,AEPS GST INC DT 10-27-201,,2018-10-29,,1850.76,-526391935.92000103,.
409000438620',2018-10-29,AEPS INCOME DT 10-28-2018,,2018-10-29,,5296.37,-526386639.550001,.
409000438620',2018-10-29,AEPS GST INC DT 10-28-201,,2018-10-29,,1059.27,-526385580.28000104,.
409000438620',2018-10-29,AEPS ACQUIRING ADJ FEES 2,,2018-10-29,17.7,,-526385597.98000103,.
409000438620',2018-10-29,AEPS ACQ CR ADJ FEES 2610,,2018-10-29,2.95,,-526385600.930001,.
409000438620',2018-10-29,AEPS ACQ REP ADJ FEES 261,,2018-10-29,,11.8,-526385589.130001,.
409000438620',2018-10-30,TRF TO  Indiaforensic SERVICES I,,2018-10-30,2000000.0,,-528385589.130001,.
409000438620',2018-10-30,Indiaforensic AEPS NPCI WDL SET,,2018-10-30,,2707300.0,-525678289.130001,.
409000438620',2018-10-30,TRF TO  Indiaforensic SERVICES I,,2018-10-30,2900000.0,,-528578289.130001,.
409000438620',2018-10-30,MICRO ATM WDL FEE DT29101,,2018-10-30,,518100.0,-528060189.130001,.
409000438620',2018-10-30,MICRO ATM INC DATED 29101,,2018-10-30,,1211.4,-528058977.73000103,.
409000438620',2018-10-30,MICRO ATM GST DATED 29101,,2018-10-30,,242.28,-528058735.45000106,.
409000438620',2018-10-30,AEPS PAY Indiaforensic 2910,,2018-10-30,,389.46,-528058345.9900011,.
409000438620',2018-10-30,MAW/502964XXXXXX8534/NAGA,,2018-10-30,,1700.0,-528056645.9900011,.
409000438620',2018-10-30,MICRO ATM WDL FEE DT30101,,2018-10-30,,443900.0,-527612745.9900011,.
409000438620',2018-10-30,MICRO ATM INC DATED 30101,,2018-10-30,,1144.8,-527611601.1900011,.
409000438620',2018-10-30,MICRO ATM GST DATED 30101,,2018-10-30,,228.96,-527611372.2300011,.
409000438620',2018-10-30,TRF TO  Indiaforensic SERVICES I,,2018-10-30,500000.0,,-528111372.2300011,.
409000438620',2018-10-30,AEPS INCOME DT 10-29-2018,,2018-10-30,,7062.81,-528104309.4200011,.
409000438620',2018-10-30,AEPS GST INC DT 10-29-201,,2018-10-30,,1412.56,-528102896.8600011,.
409000438620',2018-10-30,AEPS ACQUIRING ADJ FEES 2,,2018-10-30,23.6,,-528102920.4600011,.
409000438620',2018-10-30,TRF TO  Indiaforensic SERVICES I,,2018-10-30,500000.0,,-528602920.4600011,.
409000438620',2018-10-31,Indiaforensic AEPS NPCI WDL SET,,2018-10-31,,3197500.0,-525405420.4600011,.
409000438620',2018-10-31,CR829807190201/RMCPL23087/2,,2018-10-31,1000.0,,-525406420.4600011,.
409000438620',2018-10-31,CR829817299129/RMCPL14928/2,,2018-10-31,500.0,,-525406920.4600011,.
409000438620',2018-10-31,CR829816296206/RMCPL16567/2,,2018-10-31,1000.0,,-525407920.4600011,.
409000438620',2018-10-31,CR829811229575/RMCPL19120/2,,2018-10-31,3000.0,,-525410920.4600011,.
409000438620',2018-10-31,MICRO ATM WDL FEE DT30101,,2018-10-31,,575900.0,-524835020.4600011,.
409000438620',2018-10-31,MICRO ATM INC DATED 30101,,2018-10-31,,1304.64,-524833715.8200011,.
409000438620',2018-10-31,MICRO ATM GST DATED 30101,,2018-10-31,,260.93,-524833454.8900011,.
409000438620',2018-10-31,TRF TO  Indiaforensic SERVICES I,,2018-10-31,3200000.0,,-528033454.8900011,.
409000438620',2018-10-31,AEPS PAY Indiaforensic 3010,,2018-10-31,,219.57,-528033235.3200011,.
409000438620',2018-10-31,AEPS INCOME DT 10-30-2018,,2018-10-31,,7889.27,-528025346.05000114,.
409000438620',2018-10-31,AEPS GST INC DT 10-30-201,,2018-10-31,,1577.85,-528023768.2000011,.
409000438620',2018-10-31,AEPS INCOME DT 10-26-2018,,2018-10-31,,10005.82,-528013762.3800011,.
409000438620',2018-10-31,AEPS GST INC DT 10-26-201,,2018-10-31,,2001.16,-528011761.2200011,.
409000438620',2018-10-31,REV AEPS INC DT 28-10-201,,2018-10-31,5296.37,,-528017057.5900011,.
409000438620',2018-10-31,REV AEPS GST INC DT 28101,,2018-10-31,1059.27,,-528018116.8600011,.
409000438620',2018-10-31,AEPS ACQ CR ADJ FEES 3010,,2018-10-31,32.45,,-528018149.3100011,.
409000438620',2018-10-31,MICRO ATM WDL FEE DT31101,,2018-10-31,,278200.0,-527739949.3100011,.
409000438620',2018-10-31,MICRO ATM INC DATED 31101,,2018-10-31,,652.32,-527739296.9900011,.
409000438620',2018-10-31,MICRO ATM GST DATED 31101,,2018-10-31,,130.46,-527739166.5300011,.
409000438620',2018-10-31,TRF TO  Indiaforensic SERVICES I,,2018-10-31,900000.0,,-528639166.5300011,.
409000438620',2018-11-01,Indiaforensic AEPS NPCI WDL SET,,2018-11-01,,2956100.0,-525683066.5300011,.
409000438620',2018-11-01,TRF TO  Indiaforensic SERVICES I,,2018-11-01,2900000.0,,-528583066.5300011,.
409000438620',2018-11-01,MICRO ATM WDL FEE DT31101,,2018-11-01,,500300.0,-528082766.5300011,.
409000438620',2018-11-01,MICRO ATM INC DATED 31101,,2018-11-01,,1154.88,-528081611.6500011,.
409000438620',2018-11-01,MICRO ATM GST DATED 31101,,2018-11-01,,230.98,-528081380.6700011,.
409000438620',2018-11-01,AEPS INCOME DT 10-31-2018,,2018-11-01,,7515.92,-528073864.7500011,.
409000438620',2018-11-01,AEPS GST INC DT 10-31-201,,2018-11-01,,1503.18,-528072361.57000107,.
409000438620',2018-11-01,AEPS ACQ REP ADJ FEES 311,,2018-11-01,,17.7,-528072343.8700011,.
409000438620',2018-11-01,AEPS PAY Indiaforensic 3110,,2018-11-01,,499.4,-528071844.4700011,.
409000438620',2018-11-01,TRF TO  Indiaforensic SERVICES I,,2018-11-01,500000.0,,-528571844.4700011,.
409000438620',2018-11-01,MICRO ATM WDL FEE DT01111,,2018-11-01,,425900.0,-528145944.4700011,.
409000438620',2018-11-01,MICRO ATM INC DATED 01111,,2018-11-01,,973.08,-528144971.3900011,.
409000438620',2018-11-01,MICRO ATM GST DATED 01111,,2018-11-01,,194.62,-528144776.7700011,.
409000438620',2018-11-02,MAW/502964XXXXXX0502/NAGA,,2018-11-02,,900.0,-528143876.7700011,.
409000438620',2018-11-02,Indiaforensic AEPS NPCI WDL SET,,2018-11-02,,3012900.0,-525130976.7700011,.
409000438620',2018-11-02,TRF TO  Indiaforensic SERVICES I,,2018-11-02,3500000.0,,-528630976.7700011,.
409000438620',2018-11-02,MICRO ATM WDL FEE DT01111,,2018-11-02,,520500.0,-528110476.7700011,.
409000438620',2018-11-02,MICRO ATM INC DATED 01111,,2018-11-02,,1145.52,-528109331.25000113,.
409000438620',2018-11-02,MICRO ATM GST DATED 01111,,2018-11-02,,229.1,-528109102.1500011,.
409000438620',2018-11-02,CR830017727003/RMCPL21565/2,,2018-11-02,2000.0,,-528111102.1500011,.
409000438620',2018-11-02,CR830007599383/RMCPL29003/2,,2018-11-02,2100.0,,-528113202.1500011,.
409000438620',2018-11-02,CR829909413388/RMCPL25068/2,,2018-11-02,10000.0,,-528123202.1500011,.
409000438620',2018-11-02,CR829912452158/RMCPL21642/2,,2018-11-02,500.0,,-528123702.1500011,.
409000438620',2018-11-02,CR829911434417/RMCPL20759/2,,2018-11-02,1500.0,,-528125202.1500011,.
409000438620',2018-11-02,CR830217112486/RMCPL15513/2,,2018-11-02,800.0,,-528126002.1500011,.
409000438620',2018-11-02,CR830212050312/RMCPL20307/2,,2018-11-02,500.0,,-528126502.1500011,.
409000438620',2018-11-02,CR830216099657/RMCPL22032/2,,2018-11-02,3000.0,,-528129502.1500011,.
409000438620',2018-11-02,CR830212049066/RMCPL16592/2,,2018-11-02,500.0,,-528130002.1500011,.
409000438620',2018-11-02,CR830212049177/RMCPL02155/2,,2018-11-02,4700.0,,-528134702.1500011,.
409000438620',2018-11-02,CR830212048992/RMCPL12966/2,,2018-11-02,500.0,,-528135202.1500011,.
409000438620',2018-11-02,CR830212050253/RMCPL07044/2,,2018-11-02,500.0,,-528135702.1500011,.
409000438620',2018-11-02,CR830209999384/RMCPL23002/2,,2018-11-02,3000.0,,-528138702.1500011,.
409000438620',2018-11-02,MAW/502964XXXXXX1001/NAGA,,2018-11-02,,900.0,-528137802.1500011,.
409000438620',2018-11-02,AEPS INCOME DT 11-01-2018,,2018-11-02,,7218.44,-528130583.7100011,.
409000438620',2018-11-02,AEPS GST INC DT 11-01-201,,2018-11-02,,1443.69,-528129140.0200011,.
409000438620',2018-11-02,AEPS ACQ CR ADJ FEES 0111,,2018-11-02,123.31,,-528129263.3300011,.
409000438620',2018-11-02,AEPS ACQ REP ADJ FEES 011,,2018-11-02,,23.6,-528129239.7300011,.
409000438620',2018-11-02,MICRO ATM WDL FEE DT02111,,2018-11-02,,283900.0,-527845339.7300011,.
409000438620',2018-11-02,MICRO ATM INC DATED 02111,,2018-11-02,,703.8,-527844635.9300011,.
409000438620',2018-11-02,MICRO ATM GST DATED 02111,,2018-11-02,,140.76,-527844495.1700011,.
409000438620',2018-11-02,TRF TO  Indiaforensic SERVICES I,,2018-11-02,500000.0,,-528344495.1700011,.
409000438620',2018-11-03,Indiaforensic AEPS NPCI WDL SET,,2018-11-03,,3024200.0,-525320295.1700011,.
409000438620',2018-11-03,TRF TO  Indiaforensic SERVICES I,,2018-11-03,3000000.0,,-528320295.1700011,.
409000438620',2018-11-03,MICRO ATM WDL FEE DT02111,,2018-11-03,,799200.0,-527521095.1700011,.
409000438620',2018-11-03,MICRO ATM INC DATED 02111,,2018-11-03,,1554.12,-527519541.0500011,.
409000438620',2018-11-03,MICRO ATM GST DATED 02111,,2018-11-03,,310.82,-527519230.2300011,.
409000438620',2018-11-03,MAW/502964XXXXXX2169/NAGA,,2018-11-03,,900.0,-527518330.2300011,.
409000438620',2018-11-03,AEPS INCOME DT 11-02-2018,,2018-11-03,,7490.12,-527510840.1100011,.
409000438620',2018-11-03,AEPS GST INC DT 11-02-201,,2018-11-03,,1498.02,-527509342.0900011,.
409000438620',2018-11-03,AEPS ACQ CR ADJ FEES 0211,,2018-11-03,106.79,,-527509448.8800011,.
409000438620',2018-11-03,CR830312262927RMCPL18434301,,2018-11-03,3000.0,,-527512448.8800011,.
409000438620',2018-11-03,CR830312262983RMCPL15477301,,2018-11-03,1000.0,,-527513448.8800011,.
409000438620',2018-11-03,CR830312262843RMCPL22143301,,2018-11-03,3000.0,,-527516448.8800011,.
409000438620',2018-11-03,CR830311253769RMCPL11019301,,2018-11-03,2000.0,,-527518448.8800011,.
409000438620',2018-11-03,CR830311260409RMCPL18599301,,2018-11-03,1000.0,,-527519448.8800011,.
409000438620',2018-11-03,CR830313282107RMCPL21161301,,2018-11-03,2100.0,,-527521548.8800011,.
409000438620',2018-11-03,CR830417548808RMCPL16714311,,2018-11-03,2000.0,,-527523548.8800011,.
409000438620',2018-11-03,CR830408427495RMCPL28997311,,2018-11-03,3000.0,,-527526548.8800011,.
409000438620',2018-11-03,CR830414512216RMCPL27488311,,2018-11-03,1000.0,,-527527548.8800011,.
409000438620',2018-11-03,TRF TO  Indiaforensic SERVICES I,,2018-11-03,1000000.0,,-528527548.8800011,.
409000438620',2018-11-03,MAW/502964XXXXXX1773/NAGA,,2018-11-03,,1000.0,-528526548.8800011,.
409000438620',2018-11-03,MICRO ATM WDL FEE DT03111,,2018-11-03,,540400.0,-527986148.8800011,.
409000438620',2018-11-03,MICRO ATM INC DATED 03111,,2018-11-03,,1093.32,-527985055.56000113,.
409000438620',2018-11-03,MICRO ATM GST DATED 03111,,2018-11-03,,218.66,-527984836.9000011,.
409000438620',2018-11-04,MAW/502964XXXXXX0270/NAGA,,2018-11-04,,900.0,-527983936.9000011,.
409000438620',2018-11-04,MAW/502964XXXXXX6122/NAGA,,2018-11-04,,1600.0,-527982336.9000011,.
409000438620',2018-11-05,MAW/502964XXXXXX9739/NAGA,,2018-11-05,,1300.0,-527981036.9000011,.
409000438620',2018-11-05,Indiaforensic AEPS NPCI WDL SET,,2018-11-05,,3505900.0,-524475136.9000011,.
409000438620',2018-11-05,Indiaforensic AEPS NPCI WDL SET,,2018-11-05,,2360100.0,-522115036.9000011,.
409000438620',2018-11-05,CR830518780627/RMCPL23891/0,,2018-11-05,500.0,,-522115536.9000011,.
409000438620',2018-11-05,CR830516756700/RMCPL17591/0,,2018-11-05,5000.0,,-522120536.9000011,.
409000438620',2018-11-05,CR830516756730/RMCPL29723/0,,2018-11-05,6000.0,,-522126536.9000011,.
409000438620',2018-11-05,CR830516756712/RMCPL25138/0,,2018-11-05,1100.0,,-522127636.9000011,.
409000438620',2018-11-05,CR830518780594/RMCPL09484/0,,2018-11-05,1400.0,,-522129036.9000011,.
409000438620',2018-11-05,CR830518781732/RMCPL24703/0,,2018-11-05,5500.0,,-522134536.9000011,.
409000438620',2018-11-05,CR830514734026/RMCPL28670/0,,2018-11-05,1000.0,,-522135536.9000011,.
409000438620',2018-11-05,CR830514735124/RMCPL20491/0,,2018-11-05,1000.0,,-522136536.9000011,.
409000438620',2018-11-05,CR830512709808/RMCPL18859/0,,2018-11-05,500.0,,-522137036.9000011,.
409000438620',2018-11-05,CR830512709864/RMCPL23228/0,,2018-11-05,1100.0,,-522138136.9000011,.
409000438620',2018-11-05,CR830512709841/RMCPL13136/0,,2018-11-05,500.0,,-522138636.9000011,.
409000438620',2018-11-05,CR829911437710/RMCPL28373/2,,2018-11-05,323.0,,-522138959.9000011,.
409000438620',2018-11-05,CR829113579525/RMCPL25130/1,,2018-11-05,280.0,,-522139239.9000011,.
409000438620',2018-11-05,TRF TO  Indiaforensic SERVICES I,,2018-11-05,6500000.0,,-528639239.9000011,.
409000438620',2018-11-05,MICRO ATM INC DATED 03111,,2018-11-05,,1276.2,-528637963.7000011,.
409000438620',2018-11-05,MICRO ATM GST DATED 03111,,2018-11-05,,255.24,-528637708.4600011,.
409000438620',2018-11-05,MICRO ATM INC DATED 04111,,2018-11-05,,2714.4,-528634994.06000113,.
409000438620',2018-11-05,MICRO ATM GST DATED 04111,,2018-11-05,,542.88,-528634451.18000114,.
409000438620',2018-11-05,MICRO ATM WDL FEE DT03111,,2018-11-05,,621000.0,-528013451.18000114,.
409000438620',2018-11-05,MICRO ATM WDL FEE DT04111,,2018-11-05,,1202200.0,-526811251.18000114,.
409000438620',2018-11-05,MICRO ATM WDL FEE DT05111,,2018-11-05,,607900.0,-526203351.18000114,.
409000438620',2018-11-05,MICRO ATM INC DATED 05111,,2018-11-05,,1394.28,-526201956.90000117,.
409000438620',2018-11-05,MICRO ATM GST DATED 05111,,2018-11-05,,278.86,-526201678.04000115,.
409000438620',2018-11-05,AEPS INCOME DT 11-03-2018,,2018-11-05,,8894.75,-526192783.29000115,.
409000438620',2018-11-05,AEPS GST INC DT 11-03-201,,2018-11-05,,1778.95,-526191004.34000117,.
409000438620',2018-11-05,AEPS INCOME DT 11-04-2018,,2018-11-05,,6027.34,-526184977.0000012,.
409000438620',2018-11-05,AEPS GST INC DT 11-04-201,,2018-11-05,,1205.47,-526183771.53000116,.
409000438620',2018-11-05,AEPS ACQ CR ADJ FEES 0311,,2018-11-05,94.63,,-526183866.16000116,.
409000438620',2018-11-05,TRF TO  Indiaforensic SERVICES I,,2018-11-05,2400000.0,,-528583866.16000116,.
409000438620',2018-11-05,NPCI SETELEMENT DIFF_0311,,2018-11-05,,800.0,-528583066.16000116,.
409000438620',2018-11-05,NPCI SETELEMENT DIFF_0411,,2018-11-05,,4000.0,-528579066.16000116,.
409000438620',2018-11-06,Indiaforensic AEPS NPCI WDL SET,,2018-11-06,,3972400.0,-524606666.16000116,.
409000438620',2018-11-06,TRF TO  Indiaforensic SERVICES I,,2018-11-06,4000000.0,,-528606666.16000116,.
409000438620',2018-11-06,AEPS PAY Indiaforensic 0411,,2018-11-06,,599.06,-528606067.10000116,.
409000438620',2018-11-06,MICRO ATM WDL FEE DT05111,,2018-11-06,,1161500.0,-527444567.10000116,.
409000438620',2018-11-06,MICRO ATM INC DATED 05111,,2018-11-06,,2462.76,-527442104.34000117,.
409000438620',2018-11-06,MICRO ATM GST DATED 05111,,2018-11-06,,492.55,-527441611.79000115,.
409000438620',2018-11-06,AEPS INCOME DT 11-05-2018,,2018-11-06,,9472.39,-527432139.40000117,.
409000438620',2018-11-06,AEPS GST INC DT 11-05-201,,2018-11-06,,1894.48,-527430244.92000115,.
409000438620',2018-11-06,AEPS ACQUIRING ADJ FEES 0,,2018-11-06,17.7,,-527430262.62000114,.
409000438620',2018-11-06,MICRO ATM WDL FEE DT06111,,2018-11-06,,646800.0,-526783462.62000114,.
409000438620',2018-11-06,MICRO ATM INC DATED 06111,,2018-11-06,,1513.08,-526781949.54000115,.
409000438620',2018-11-06,MICRO ATM GST DATED 06111,,2018-11-06,,302.62,-526781646.92000115,.
409000438620',2018-11-06,NPCI SETELEMENT DIFF_0511,,2018-11-06,,5000.0,-526776646.92000115,.
409000438620',2018-11-07,Indiaforensic AEPS NPCI WDL SET,,2018-11-07,,3520100.0,-523256546.92000115,.
409000438620',2018-11-07,CR830611895062/RMCPL14880/0,,2018-11-07,2000.0,,-523258546.92000115,.
409000438620',2018-11-07,MAW/502964XXXXXX1833/NAGA,,2018-11-07,,200.0,-523258346.92000115,.
409000438620',2018-11-07,AEPS INCOME DT 11-06-2018,,2018-11-07,,9048.05,-523249298.87000114,.
409000438620',2018-11-07,AEPS GST INC DT 11-06-201,,2018-11-07,,1809.61,-523247489.2600011,.
409000438620',2018-11-07,AEPS ACQ CR ADJ FEES 0611,,2018-11-07,11.8,,-523247501.06000113,.
409000438620',2018-11-08,CB830715173100/RMCPL09602/0,,2018-11-08,5000.0,,-523252501.06000113,.
409000438620',2018-11-08,Indiaforensic AEPS NPCI WDL SET,,2018-11-08,,2434600.0,-520817901.06000113,.
409000438620',2018-11-08,AEPS INCOME DT 07-11-2018,,2018-11-08,,6484.75,-520811416.31000113,.
409000438620',2018-11-08,AEPS GST INC DT 07-11-201,,2018-11-08,,1296.95,-520810119.36000115,.
409000438620',2018-11-08,AEPS ACQ CR ADJ FEES 0711,,2018-11-08,17.7,,-520810137.06000113,.
409000438620',2018-11-08,TRF TO  Indiaforensic SERVICES I,,2018-11-08,5000000.0,,-525810137.06000113,.
409000438620',2018-11-08,TRF TO  Indiaforensic SERVICES I,,2018-11-08,2800000.0,,-528610137.06000113,.
409000438620',2018-11-09,MICRO ATM WDL FEE DT06111,,2018-11-09,,1018100.0,-527592037.06000113,.
409000438620',2018-11-09,MICRO ATM WDL FEE DT07111,,2018-11-09,,809400.0,-526782637.06000113,.
409000438620',2018-11-09,MICRO ATM WDL FEE DT07111,,2018-11-09,,1040900.0,-525741737.06000113,.
409000438620',2018-11-09,MICRO ATM WDL FEE DT08111,,2018-11-09,,346200.0,-525395537.06000113,.
409000438620',2018-11-09,MICRO ATM WDL FEE DT08111,,2018-11-09,,818100.0,-524577437.06000113,.
409000438620',2018-11-09,CB830718224333/RMCPL05050/0,,2018-11-09,5100.0,,-524582537.06000113,.
409000438620',2018-11-09,Indiaforensic AEPS NPCI WDL SET,,2018-11-09,,1976700.0,-522605837.06000113,.
409000438620',2018-11-09,TRF TO  Indiaforensic SERVICES I,,2018-11-09,3000000.0,,-525605837.06000113,.
409000438620',2018-11-09,TRF TO  Indiaforensic SERVICES I,,2018-11-09,3000000.0,,-528605837.06000113,.
409000438620',2018-11-09,NPCI SETELEMENT DIFF_0611,,2018-11-09,,15000.0,-528590837.06000113,.
409000438620',2018-11-09,MICRO ATM INC DATED 06111,,2018-11-09,,2213.64,-528588623.42000115,.
409000438620',2018-11-09,MICRO ATM GST DATED 06111,,2018-11-09,,442.73,-528588180.69000113,.
409000438620',2018-11-09,AEPS INCOME DT 11-08-2018,,2018-11-09,,5252.28,-528582928.41000116,.
409000438620',2018-11-09,AEPS GST INC DT 11-08-201,,2018-11-09,,1050.46,-528581877.9500012,.
409000438620',2018-11-09,MICRO ATM INC DATED 07111,,2018-11-09,,1863.0,-528580014.9500012,.
409000438620',2018-11-09,MICRO ATM GST DATED 07111,,2018-11-09,,372.6,-528579642.35000116,.
409000438620',2018-11-09,MICRO ATM INC DATED 07111,,2018-11-09,,2331.72,-528577310.6300011,.
409000438620',2018-11-09,MICRO ATM GST DATED 07111,,2018-11-09,,466.34,-528576844.29000115,.
409000438620',2018-11-09,MICRO ATM INC DATED 08111,,2018-11-09,,859.32,-528575984.97000116,.
409000438620',2018-11-09,MICRO ATM GST DATED 08111,,2018-11-09,,171.86,-528575813.11000115,.
409000438620',2018-11-09,MICRO ATM INC DATED 08111,,2018-11-09,,1780.56,-528574032.55000114,.
409000438620',2018-11-09,MICRO ATM GST DATED 08111,,2018-11-09,,356.11,-528573676.44000113,.
409000438620',2018-11-09,MICRO ATM WDL FEE DT09111,,2018-11-09,,50500.0,-528523176.44000113,.
409000438620',2018-11-09,MICRO ATM INC DATED 09111,,2018-11-09,,91.8,-528523084.6400011,.
409000438620',2018-11-09,MICRO ATM GST DATED 09111,,2018-11-09,,18.36,-528523066.2800011,.
409000438620',2018-11-09,AEPS PAY Indiaforensic 0611,,2018-11-09,,1998.52,-528521067.7600011,.
409000438620',2018-11-10,MAW/502964XXXXXX1948/NAGA,,2018-11-10,,1000.0,-528520067.7600011,.
409000438620',2018-11-12,Indiaforensic AEPS NPCI WDL SET,,2018-11-12,,2120100.0,-526399967.7600011,.
409000438620',2018-11-12,Indiaforensic AEPS NPCI WDL SET,,2018-11-12,,1734000.0,-524665967.7600011,.
409000438620',2018-11-12,Indiaforensic AEPS NPCI WDL SET,,2018-11-12,,2335200.0,-522330767.7600011,.
409000438620',2018-11-12,MAW/502964XXXXXX1997/NAGA,,2018-11-12,,500.0,-522330267.7600011,.
409000438620',2018-11-12,TRF TO  Indiaforensic SERVICES I,,2018-11-12,4000000.0,,-526330267.7600011,.
409000438620',2018-11-12,TRF TO  Indiaforensic SERVICES I,,2018-11-12,2000000.0,,-528330267.7600011,.
409000438620',2018-11-12,MICRO ATM WDL FEE DT09111,,2018-11-12,,429800.0,-527900467.7600011,.
409000438620',2018-11-12,MICRO ATM INC DATED 09111,,2018-11-12,,804.6,-527899663.1600011,.
409000438620',2018-11-12,MICRO ATM GST DATED 09111,,2018-11-12,,160.92,-527899502.2400011,.
409000438620',2018-11-12,MICRO ATM WDL FEE DT10111,,2018-11-12,,1809600.0,-526089902.2400011,.
409000438620',2018-11-12,MICRO ATM INC DATED 10111,,2018-11-12,,3928.68,-526085973.5600011,.
409000438620',2018-11-12,MICRO ATM GST DATED 10111,,2018-11-12,,785.74,-526085187.82000107,.
409000438620',2018-11-12,MICRO ATM WDL FEE DT11111,,2018-11-12,,1506900.0,-524578287.82000107,.
409000438620',2018-11-12,MICRO ATM INC DATED 11111,,2018-11-12,,3426.84,-524574860.9800011,.
409000438620',2018-11-12,MICRO ATM GST DATED 11111,,2018-11-12,,685.37,-524574175.6100011,.
409000438620',2018-11-12,MICRO ATM WDL FEE DT12111,,2018-11-12,,612200.0,-523961975.6100011,.
409000438620',2018-11-12,MICRO ATM INC DATED 12111,,2018-11-12,,1369.08,-523960606.5300011,.
409000438620',2018-11-12,MICRO ATM GST DATED 12111,,2018-11-12,,273.82,-523960332.7100011,.
409000438620',2018-11-12,AEPS INCOME DT 11-09-2018,,2018-11-12,,5947.73,-523954384.9800011,.
409000438620',2018-11-12,AEPS GST INC DT 11-09-201,,2018-11-12,,1189.55,-523953195.4300011,.
409000438620',2018-11-12,AEPS INCOME DT 11-10-2018,,2018-11-12,,6000.3,-523947195.13000107,.
409000438620',2018-11-12,AEPS GST INC DT 11-10-201,,2018-11-12,,1200.06,-523945995.07000107,.
409000438620',2018-11-12,AEPS INCOME DT 11-11-2018,,2018-11-12,,4595.75,-523941399.32000107,.
409000438620',2018-11-12,AEPS GST INC DT 11-11-201,,2018-11-12,,919.15,-523940480.1700011,.
409000438620',2018-11-12,AEPS ACQUIRING ADJ FEES 0,,2018-11-12,5.9,,-523940486.07000107,.
409000438620',2018-11-12,TRF TO  Indiaforensic SERVICES I,,2018-11-12,4000000.0,,-527940486.07000107,.
409000438620',2018-11-13,Indiaforensic AEPS NPCI WDL SET,,2018-11-13,,2752700.0,-525187786.07000107,.
409000438620',2018-11-13,CR831115053900/RMCPL14542/0,,2018-11-13,10000.0,,-525197786.07000107,.
409000438620',2018-11-13,CR831008738667/RMCPL29740/0,,2018-11-13,500.0,,-525198286.07000107,.
409000438620',2018-11-13,CR831015833558/RMCPL19318/0,,2018-11-13,500.0,,-525198786.07000107,.
409000438620',2018-11-13,CR831015837159/RMCPL20307/0,,2018-11-13,2000.0,,-525200786.07000107,.
409000438620',2018-11-13,CR830916625302/RMCPL09612/0,,2018-11-13,10000.0,,-525210786.07000107,.
409000438620',2018-11-13,CR830916625301/RMCPL15656/0,,2018-11-13,1000.0,,-525211786.07000107,.
409000438620',2018-11-13,CR830914605380/RMCPL09612/0,,2018-11-13,1100.0,,-525212886.07000107,.
409000438620',2018-11-13,TRF TO  Indiaforensic SERVICES I,,2018-11-13,3000000.0,,-528212886.07000107,.
409000438620',2018-11-13,MAW/502964XXXXXX0102/Vals,,2018-11-13,,1000.0,-528211886.07000107,.
409000438620',2018-11-13,MICRO ATM WDL FEE DT12111,,2018-11-13,,1140600.0,-527071286.07000107,.
409000438620',2018-11-13,MICRO ATM INC DATED 12111,,2018-11-13,,2555.28,-527068730.7900011,.
409000438620',2018-11-13,MICRO ATM GST DATED 12111,,2018-11-13,,511.06,-527068219.7300011,.
409000438620',2018-11-13,AEPS PAY Indiaforensic 1011,,2018-11-13,,398.46,-527067821.2700011,.
409000438620',2018-11-13,TRF TO  Indiaforensic SERVICES I,,2018-11-13,1500000.0,,-528567821.2700011,.
409000438620',2018-11-13,AEPS INCOME DT 11-12-2018,,2018-11-13,,7359.35,-528560461.9200011,.
409000438620',2018-11-13,AEPS GST INC DT 11-12-201,,2018-11-13,,1471.87,-528558990.0500011,.
409000438620',2018-11-13,AEPS ACQ CR ADJ FEES 1211,,2018-11-13,65.49,,-528559055.5400011,.
409000438620',2018-11-13,AEPS PAY Indiaforensic 1211,,2018-11-13,,118.63,-528558936.9100011,.
409000438620',2018-11-13,MICRO ATM WDL FEE DT13111,,2018-11-13,,181100.0,-528377836.9100011,.
409000438620',2018-11-13,MICRO ATM INC DATED 13111,,2018-11-13,,399.96,-528377436.9500011,.
409000438620',2018-11-13,MICRO ATM GST DATED 13111,,2018-11-13,,79.99,-528377356.9600011,.
409000438620',2018-11-13,MAW/502964XXXXXX1213/NAGA,,2018-11-13,,2500.0,-528374856.9600011,.
409000438620',2018-11-14,Indiaforensic AEPS NPCI WDL SET,,2018-11-14,,2403900.0,-525970956.9600011,.
409000438620',2018-11-14,TRF TO  Indiaforensic SERVICES I,,2018-11-14,2600000.0,,-528570956.9600011,.
409000438620',2018-11-14,MAW/502964XXXXXX2094/NAGA,,2018-11-14,,1000.0,-528569956.9600011,.
409000438620',2018-11-14,MICRO ATM WDL FEE DT13111,,2018-11-14,,362900.0,-528207056.9600011,.
409000438620',2018-11-14,MICRO ATM INC DATED 13111,,2018-11-14,,690.84,-528206366.12000114,.
409000438620',2018-11-14,MICRO ATM GST DATED 13111,,2018-11-14,,138.17,-528206227.9500011,.
409000438620',2018-11-14,AEPS PAY Indiaforensic 1311,,2018-11-14,,497.12,-528205730.8300011,.
409000438620',2018-11-14,MICRO ATM WDL FEE DT14111,,2018-11-14,,468400.0,-527737330.8300011,.
409000438620',2018-11-14,MICRO ATM INC DATED 14111,,2018-11-14,,1074.24,-527736256.5900011,.
409000438620',2018-11-14,MICRO ATM GST DATED 14111,,2018-11-14,,214.85,-527736041.7400011,.
409000438620',2018-11-14,AEPS INCOME DT 11-13-2018,,2018-11-14,,6053.47,-527729988.27000105,.
409000438620',2018-11-14,AEPS GST INC DT 11-13-201,,2018-11-14,,1210.69,-527728777.58000106,.
409000438620',2018-11-14,AEPS ACQ REP ADJ FEES 131,,2018-11-14,,5.9,-527728771.6800011,.
409000438620',2018-11-14,TRF TO  Indiaforensic SERVICES I,,2018-11-14,400000.0,,-528128771.6800011,.
409000438620',2018-11-15,CR831312419569/RMCPL20001/0,,2018-11-15,10000.0,,-528138771.6800011,.
409000438620',2018-11-15,CR831614051575/RMCPL24591/1,,2018-11-15,9200.0,,-528147971.6800011,.
409000438620',2018-11-15,Indiaforensic AEPS NPCI WDL SET,,2018-11-15,,2410200.0,-525737771.6800011,.
409000438620',2018-11-15,MAW/502964XXXXXX8117/NAGA,,2018-11-15,,1400.0,-525736371.6800011,.
409000438620',2018-11-15,TRF TO  Indiaforensic SERVICES I,,2018-11-15,500000.0,,-526236371.6800011,.
409000438620',2018-11-15,MICRO ATM WDL FEE DT14111,,2018-11-15,,818500.0,-525417871.6800011,.
409000438620',2018-11-15,MICRO ATM INC DATED 14111,,2018-11-15,,1729.8,-525416141.88000107,.
409000438620',2018-11-15,MICRO ATM GST DATED 14111,,2018-11-15,,345.96,-525415795.9200011,.
409000438620',2018-11-15,TRF TO  Indiaforensic SERVICES I,,2018-11-15,2400000.0,,-527815795.9200011,.
409000438620',2018-11-15,AEPS PAY Indiaforensic 1411,,2018-11-15,,99.64,-527815696.2800011,.
409000438620',2018-11-15,AEPS INCOME DT 11-14-2018,,2018-11-15,,6276.71,-527809419.5700011,.
409000438620',2018-11-15,AEPS GST INC DT 11-14-201,,2018-11-15,,1255.34,-527808164.23000115,.
409000438620',2018-11-15,AEPS ACQ CR ADJ FEES 1411,,2018-11-15,35.4,,-527808199.6300011,.
409000438620',2018-11-15,TRF TO  Indiaforensic SERVICES I,,2018-11-15,800000.0,,-528608199.6300011,.
409000438620',2018-11-16,Indiaforensic AEPS NPCI WDL SET,,2018-11-16,,2688600.0,-525919599.6300011,.
409000438620',2018-11-16,TRF TO  Indiaforensic SERVICES I,,2018-11-16,2700000.0,,-528619599.6300011,.
409000438620',2018-11-16,MICRO ATM WDL FEE DT15111,,2018-11-16,,301100.0,-528318499.6300011,.
409000438620',2018-11-16,MICRO ATM INC DATED 15111,,2018-11-16,,682.56,-528317817.0700011,.
409000438620',2018-11-16,MICRO ATM GST DATED 15111,,2018-11-16,,136.51,-528317680.56000113,.
409000438620',2018-11-16,MAW/502964XXXXXX2128/NAGA,,2018-11-16,,1100.0,-528316580.56000113,.
409000438620',2018-11-16,AEPS INCOME DT 11-15-2018,,2018-11-16,,6871.85,-528309708.7100011,.
409000438620',2018-11-16,AEPS GST INC DT 11-15-201,,2018-11-16,,1374.37,-528308334.3400011,.
409000438620',2018-11-16,AEPS PAY Indiaforensic 1511,,2018-11-16,,99.64,-528308234.7000011,.
409000438620',2018-11-16,MICRO ATM WDL FEE DT16111,,2018-11-16,,420400.0,-527887834.7000011,.
409000438620',2018-11-16,MICRO ATM INC DATED 16111,,2018-11-16,,900.0,-527886934.7000011,.
409000438620',2018-11-16,MICRO ATM GST DATED 16111,,2018-11-16,,180.0,-527886754.7000011,.
409000438620',2018-11-16,TRF TO  Indiaforensic SERVICES I,,2018-11-16,700000.0,,-528586754.7000011,.
409000438620',2018-11-17,Indiaforensic AEPS NPCI WDL SET,,2018-11-17,,2210800.0,-526375954.7000011,.
409000438620',2018-11-17,CR831817528988/RMCPL12459/1,,2018-11-17,500.0,,-526376454.7000011,.
409000438620',2018-11-17,CR831817528905/RMCPL25009/1,,2018-11-17,3000.0,,-526379454.7000011,.
409000438620',2018-11-17,CR831818546157/RMCPL24117/1,,2018-11-17,3000.0,,-526382454.7000011,.
409000438620',2018-11-17,CR831912667485/RMCPL27340/1,,2018-11-17,100.0,,-526382554.7000011,.
409000438620',2018-11-17,CR831419726103/RMCPL27159/1,,2018-11-17,399.0,,-526382953.7000011,.
409000438620',2018-11-17,TRF TO  Indiaforensic SERVICES I,,2018-11-17,2000000.0,,-528382953.7000011,.
409000438620',2018-11-17,MICRO ATM WDL FEE DT16111,,2018-11-17,,420600.0,-527962353.7000011,.
409000438620',2018-11-17,MICRO ATM INC DATED 16111,,2018-11-17,,963.36,-527961390.3400011,.
409000438620',2018-11-17,MICRO ATM GST DATED 16111,,2018-11-17,,192.67,-527961197.6700011,.
409000438620',2018-11-17,AEPS INCOME DT 16-11-2018,,2018-11-17,,5414.18,-527955783.4900011,.
409000438620',2018-11-17,AEPS GST INC DT 16-11-201,,2018-11-17,,1082.84,-527954700.6500011,.
409000438620',2018-11-17,MICRO ATM WDL FEE DT17111,,2018-11-17,,417000.0,-527537700.6500011,.
409000438620',2018-11-17,MICRO ATM INC DATED 17111,,2018-11-17,,991.8,-527536708.8500011,.
409000438620',2018-11-17,MICRO ATM GST DATED 17111,,2018-11-17,,198.36,-527536510.4900011,.
409000438620',2018-11-17,AEPS ACQ CR ADJ FEES 1611,,2018-11-17,38.05,,-527536548.5400011,.
409000438620',2018-11-17,TRF TO  Indiaforensic SERVICES I,,2018-11-17,500000.0,,-528036548.5400011,.
409000438620',2018-11-17,TRF TO  Indiaforensic SERVICES I,,2018-11-17,500000.0,,-528536548.5400011,.
409000438620',2018-11-18,MAW/502964XXXXXX9031/NAGA,,2018-11-18,,200.0,-528536348.5400011,.
409000438620',2018-11-19,Indiaforensic AEPS NPCI WDL SET,,2018-11-19,,1964900.0,-526571448.5400011,.
409000438620',2018-11-19,Indiaforensic AEPS NPCI WDL SET,,2018-11-19,,1311700.0,-525259748.5400011,.
409000438620',2018-11-19,MAW/502964XXXXXX0502/NAGA,,2018-11-19,,1900.0,-525257848.5400011,.
409000438620',2018-11-19,TRF TO  Indiaforensic SERVICES I,,2018-11-19,2000000.0,,-527257848.5400011,.
409000438620',2018-11-19,TRF TO  Indiaforensic SERVICES I,,2018-11-19,1000000.0,,-528257848.5400011,.
409000438620',2018-11-19,MAW/502964XXXXXX1757/NAGA,,2018-11-19,,1400.0,-528256448.5400011,.
409000438620',2018-11-19,AEPS INCOME DT 17-11-2018,,2018-11-19,,5195.51,-528251253.0300011,.
409000438620',2018-11-19,AEPS GST INC DT 17-11-201,,2018-11-19,,1039.1,-528250213.9300011,.
409000438620',2018-11-19,AEPS INCOME DT 18-11-2018,,2018-11-19,,3586.1,-528246627.83000106,.
409000438620',2018-11-19,AEPS GST INC DT 18-11-201,,2018-11-19,,717.22,-528245910.610001,.
409000438620',2018-11-19,AEPS PAY Indiaforensic 1711,,2018-11-19,,198.58,-528245712.03000104,.
409000438620',2018-11-19,AEPS PAY Indiaforensic 1811,,2018-11-19,,566.78,-528245145.2500011,.
409000438620',2018-11-19,MICRO ATM WDL FEE DT17111,,2018-11-19,,601600.0,-527643545.2500011,.
409000438620',2018-11-19,MICRO ATM INC DATED 17111,,2018-11-19,,1332.36,-527642212.89000106,.
409000438620',2018-11-19,MICRO ATM GST DATED 17111,,2018-11-19,,266.47,-527641946.42000103,.
409000438620',2018-11-19,MICRO ATM WDL FEE DT18111,,2018-11-19,,965100.0,-526676846.42000103,.
409000438620',2018-11-19,MICRO ATM INC DATED 18111,,2018-11-19,,2026.08,-526674820.34000105,.
409000438620',2018-11-19,MICRO ATM GST DATED 18111,,2018-11-19,,405.22,-526674415.120001,.
409000438620',2018-11-19,MICRO ATM WDL FEE DT19111,,2018-11-19,,459500.0,-526214915.120001,.
409000438620',2018-11-19,MICRO ATM INC DATED 19111,,2018-11-19,,1042.2,-526213872.92000103,.
409000438620',2018-11-19,MICRO ATM GST DATED 19111,,2018-11-19,,208.44,-526213664.48000103,.
409000438620',2018-11-19,TRF TO  Indiaforensic SERVICES I,,2018-11-19,2000000.0,,-528213664.48000103,.
409000438620',2018-11-20,MAW/502964XXXXXX3464/NAGA,,2018-11-20,,1700.0,-528211964.48000103,.
409000438620',2018-11-20,Indiaforensic AEPS NPCI WDL SET,,2018-11-20,,1844500.0,-526367464.48000103,.
409000438620',2018-11-20,CB832010861463/RMCPL22055/1,,2018-11-20,500.0,,-526367964.48000103,.
409000438620',2018-11-20,TRF TO Indiaforensic SERVICES IN,,2018-11-20,2200000.0,,-528567964.48000103,.
409000438620',2018-11-20,MICRO ATM WDL FEE DT19111,,2018-11-20,,493300.0,-528074664.48000103,.
409000438620',2018-11-20,MICRO ATM INC DATED 19111,,2018-11-20,,1206.72,-528073457.760001,.
409000438620',2018-11-20,MICRO ATM GST DATED 19111,,2018-11-20,,241.34,-528073216.42000103,.
409000438620',2018-11-20,NPCI_SETT_DIFF_191118,,2018-11-20,,2000.0,-528071216.42000103,.
409000438620',2018-11-20,MICRO ATM WDL FEE DT20111,,2018-11-20,,318400.0,-527752816.42000103,.
409000438620',2018-11-20,MICRO ATM INC DATED 20111,,2018-11-20,,591.12,-527752225.300001,.
409000438620',2018-11-20,MICRO ATM GST DATED 20111,,2018-11-20,,118.22,-527752107.080001,.
409000438620',2018-11-20,AEPS INCOME DT 19-11-2018,,2018-11-20,,4638.4,-527747468.680001,.
409000438620',2018-11-20,AEPS GST INC DT 19-11-201,,2018-11-20,,927.68,-527746541.000001,.
409000438620',2018-11-20,AEPS ACQ CR ADJ FEES 1911,,2018-11-20,2.95,,-527746543.950001,.
409000438620',2018-11-21,Indiaforensic AEPS NPCI WDL SET,,2018-11-21,,1895600.0,-525850943.950001,.
409000438620',2018-11-21,AEPS INCOME DT 20-11-2018,,2018-11-21,,4739.79,-525846204.160001,.
409000438620',2018-11-21,AEPS GST INC DT 20-11-201,,2018-11-21,,947.96,-525845256.200001,.
409000438620',2018-11-21,FUND TRF TO  Indiaforensic SERVI,,2018-11-21,500000.0,,-526345256.200001,.
409000438620',2018-11-21,FUND TRF TO  Indiaforensic SERVI,,2018-11-21,2000000.0,,-528345256.200001,.
409000438620',2018-11-21,MAW/502964XXXXXX9820/NAGA,,2018-11-21,,1800.0,-528343456.200001,.
409000438620',2018-11-22,Indiaforensic AEPS NPCI WDL SET,,2018-11-22,,2048600.0,-526294856.200001,.
409000438620',2018-11-22,TRF TO  Indiaforensic SERVICES I,,2018-11-22,2300000.0,,-528594856.200001,.
409000438620',2018-11-22,AEPS PAY Indiaforensic 2011,,2018-11-22,,298.23,-528594557.970001,.
409000438620',2018-11-22,AEPS PAY Indiaforensic 2111,,2018-11-22,,649.02,-528593908.950001,.
409000438620',2018-11-22,MICRO ATM WDL FEE DT20111,,2018-11-22,,400000.0,-528193908.950001,.
409000438620',2018-11-22,MICRO ATM INC DATED 20111,,2018-11-22,,872.64,-528193036.310001,.
409000438620',2018-11-22,MICRO ATM GST DATED 20111,,2018-11-22,,174.53,-528192861.78000104,.
409000438620',2018-11-22,MICRO ATM WDL FEE DT21111,,2018-11-22,,303900.0,-527888961.78000104,.
409000438620',2018-11-22,MICRO ATM INC DATED 21111,,2018-11-22,,691.56,-527888270.22000104,.
409000438620',2018-11-22,MICRO ATM GST DATED 21111,,2018-11-22,,138.31,-527888131.91000104,.
409000438620',2018-11-22,MICRO ATM WDL FEE DT21111,,2018-11-22,,449500.0,-527438631.91000104,.
409000438620',2018-11-22,MICRO ATM INC DATED 21111,,2018-11-22,,966.96,-527437664.95000106,.
409000438620',2018-11-22,MICRO ATM GST DATED 21111,,2018-11-22,,193.39,-527437471.5600011,.
409000438620',2018-11-22,AEPS INCOME DT 21-11-2018,,2018-11-22,,5324.45,-527432147.1100011,.
409000438620',2018-11-22,AEPS GST INC DT 21-11-201,,2018-11-22,,1064.89,-527431082.2200011,.
409000438620',2018-11-22,MICRO ATM WDL FEE DT22111,,2018-11-22,,377100.0,-527053982.2200011,.
409000438620',2018-11-22,MICRO ATM INC DATED 22111,,2018-11-22,,795.6,-527053186.6200011,.
409000438620',2018-11-22,MICRO ATM GST DATED 22111,,2018-11-22,,159.12,-527053027.5000011,.
409000438620',2018-11-22,TRF TO  Indiaforensic SERVICES I,,2018-11-22,700000.0,,-527753027.5000011,.
409000438620',2018-11-22,NPCI_SETT_DIFF_211118,,2018-11-22,,500.0,-527752527.5000011,.
409000438620',2018-11-22,TRF TO  Indiaforensic SERVICES I,,2018-11-22,500000.0,,-528252527.5000011,.
409000438620',2018-11-23,Indiaforensic AEPS NPCI WDL SET,,2018-11-23,,1735200.0,-526517327.5000011,.
409000438620',2018-11-23,CR832412702280/RMCPL23968/2,,2018-11-23,2000.0,,-526519327.5000011,.
409000438620',2018-11-23,CR832311469065/RMCPL26200/1,,2018-11-23,1000.0,,-526520327.5000011,.
409000438620',2018-11-23,CR832310453101/RMCPL20722/1,,2018-11-23,2500.0,,-526522827.5000011,.
409000438620',2018-11-23,AEPS INCOME DT 11-22-2018,,2018-11-23,,4373.11,-526518454.39000106,.
409000438620',2018-11-23,AEPS GST INC DT 11-22-201,,2018-11-23,,874.62,-526517579.77000105,.
409000438620',2018-11-23,AEPS ACQ CR ADJ FEES 2211,,2018-11-23,32.45,,-526517612.22000104,.
409000438620',2018-11-23,MAW/502964XXXXXX0296/NAGA,,2018-11-23,,400.0,-526517212.22000104,.
409000438620',2018-11-26,Indiaforensic AEPS NPCI WDL SET,,2018-11-26,,1794800.0,-524722412.22000104,.
409000438620',2018-11-26,Indiaforensic AEPS NPCI WDL SET,,2018-11-26,,1855800.0,-522866612.22000104,.
409000438620',2018-11-26,Indiaforensic AEPS NPCI WDL SET,,2018-11-26,,1031800.0,-521834812.22000104,.
409000438620',2018-11-26,TRF TO  Indiaforensic SERVICES I,,2018-11-26,6800000.0,,-528634812.22000104,.
409000438620',2018-11-26,MICRO ATM WDL FEE DT22111,,2018-11-26,,398200.0,-528236612.22000104,.
409000438620',2018-11-26,MICRO ATM INC DATED 22111,,2018-11-26,,884.16,-528235728.060001,.
409000438620',2018-11-26,MICRO ATM GST DATED 22111,,2018-11-26,,176.83,-528235551.23000103,.
409000438620',2018-11-26,MICRO ATM WDL FEE DT23111,,2018-11-26,,298600.0,-527936951.23000103,.
409000438620',2018-11-26,MICRO ATM INC DATED 23111,,2018-11-26,,588.6,-527936362.630001,.
409000438620',2018-11-26,MICRO ATM GST DATED 23111,,2018-11-26,,117.72,-527936244.910001,.
409000438620',2018-11-26,MICRO ATM WDL FEE DT23111,,2018-11-26,,510800.0,-527425444.910001,.
409000438620',2018-11-26,MICRO ATM INC DATED 23111,,2018-11-26,,1071.36,-527424373.55000097,.
409000438620',2018-11-26,MICRO ATM GST DATED 23111,,2018-11-26,,214.27,-527424159.280001,.
409000438620',2018-11-26,AEPS PAY Indiaforensic 2211,,2018-11-26,,99.64,-527424059.640001,.
409000438620',2018-11-26,NPCI_SETT_DIFF_251118,,2018-11-26,,700.0,-527423359.640001,.
409000438620',2018-11-26,AEPS INCOME DT 24-11-2018,,2018-11-26,,4406.18,-527418953.460001,.
409000438620',2018-11-26,AEPS GST INC DT 24-11-201,,2018-11-26,,881.24,-527418072.220001,.
409000438620',2018-11-26,AEPS INCOME DT 23-11-2018,,2018-11-26,,4439.71,-527413632.510001,.
409000438620',2018-11-26,AEPS GST INC DT 23-11-201,,2018-11-26,,887.94,-527412744.570001,.
409000438620',2018-11-26,AEPS INCOME DT 25-11-2018,,2018-11-26,,2505.3,-527410239.270001,.
409000438620',2018-11-26,AEPS GST INC DT 25-11-201,,2018-11-26,,501.06,-527409738.210001,.
409000438620',2018-11-26,MICRO ATM WDL FEE DT24111,,2018-11-26,,1504500.0,-525905238.210001,.
409000438620',2018-11-26,MICRO ATM INC DATED 24111,,2018-11-26,,2821.32,-525902416.890001,.
409000438620',2018-11-26,MICRO ATM GST DATED 24111,,2018-11-26,,564.26,-525901852.630001,.
409000438620',2018-11-26,MICRO ATM WDL FEE DT25111,,2018-11-26,,1848700.0,-524053152.630001,.
409000438620',2018-11-26,MICRO ATM INC DATED 25111,,2018-11-26,,3545.28,-524049607.35000104,.
409000438620',2018-11-26,MICRO ATM GST DATED 25111,,2018-11-26,,709.06,-524048898.29000103,.
409000438620',2018-11-26,AEPS PAY Indiaforensic 2411,,2018-11-26,,99.64,-524048798.65000105,.
409000438620',2018-11-26,AEPS PAY Indiaforensic 2511,,2018-11-26,,2997.93,-524045800.72000104,.
409000438620',2018-11-26,MICRO ATM WDL FEE DT26111,,2018-11-26,,458800.0,-523587000.72000104,.
409000438620',2018-11-26,MICRO ATM INC DATED 26111,,2018-11-26,,814.68,-523586186.04000103,.
409000438620',2018-11-26,MICRO ATM GST DATED 26111,,2018-11-26,,162.94,-523586023.10000104,.
409000438620',2018-11-26,TRF TO  Indiaforensic SERVICES I,,2018-11-26,3400000.0,,-526986023.10000104,.
409000438620',2018-11-26,TRF TO  Indiaforensic SERVICES I,,2018-11-26,1200000.0,,-528186023.10000104,.
409000438620',2018-11-27,Indiaforensic AEPS NPCI WDL SET,,2018-11-27,,1860300.0,-526325723.10000104,.
409000438620',2018-11-27,CR832611095003/RMCPL20722/2,,2018-11-27,2000.0,,-526327723.10000104,.
409000438620',2018-11-27,CR832611094944/RMCPL21595/2,,2018-11-27,800.0,,-526328523.10000104,.
409000438620',2018-11-27,CR832612111054/RMCPL20307/2,,2018-11-27,6000.0,,-526334523.10000104,.
409000438620',2018-11-27,TRF TO  Indiaforensic SERVICES I,,2018-11-27,2300000.0,,-528634523.10000104,.
409000438620',2018-11-27,ACQ CB 4592000001871736 1,,2018-11-27,9000.0,,-528643523.10000104,.
409000438620',2018-11-27,ACQ CB 6070606000153409 6,,2018-11-27,2500.0,,-528646023.10000104,.
409000438620',2018-11-27,ACQ CB 6070936085442470 8,,2018-11-27,1000.0,,-528647023.10000104,.
409000438620',2018-11-27,MICRO ATM WDL FEE DT26111,,2018-11-27,,894900.0,-527752123.10000104,.
409000438620',2018-11-27,MICRO ATM INC DATED 26111,,2018-11-27,,1514.52,-527750608.58000106,.
409000438620',2018-11-27,MICRO ATM GST DATED 26111,,2018-11-27,,302.9,-527750305.6800011,.
409000438620',2018-11-27,AEPS INCOME DT 26-11-2018,,2018-11-27,,4503.22,-527745802.46000105,.
409000438620',2018-11-27,AEPS GST INC DT 26-11-201,,2018-11-27,,900.64,-527744901.82000107,.
409000438620',2018-11-27,MICRO ATM WDL FEE DT27111,,2018-11-27,,283400.0,-527461501.82000107,.
409000438620',2018-11-27,MICRO ATM INC DATED 27111,,2018-11-27,,624.96,-527460876.8600011,.
409000438620',2018-11-27,MICRO ATM GST DATED 27111,,2018-11-27,,124.99,-527460751.8700011,.
409000438620',2018-11-27,AEPS ACQ CR ADJ FEES 2611,,2018-11-27,34.22,,-527460786.0900011,.
409000438620',2018-11-27,TRF TO  Indiaforensic SERVICES I,,2018-11-27,1100000.0,,-528560786.0900011,.
409000438620',2018-11-28,Indiaforensic AEPS NPCI WDL SET,,2018-11-28,,1604700.0,-526956086.0900011,.
409000438620',2018-11-28,MICRO ATM WDL FEE DT27111,,2018-11-28,,579500.0,-526376586.0900011,.
409000438620',2018-11-28,MICRO ATM INC DATED 27111,,2018-11-28,,1094.76,-526375491.3300011,.
409000438620',2018-11-28,MICRO ATM GST DATED 27111,,2018-11-28,,218.95,-526375272.3800011,.
409000438620',2018-11-28,TRF TO  Indiaforensic SERVICES I,,2018-11-28,2000000.0,,-528375272.3800011,.
409000438620',2018-11-28,AEPS PAY Indiaforensic 2711,,2018-11-28,,298.93,-528374973.4500011,.
409000438620',2018-11-28,MICRO ATM WDL FEE DT28111,,2018-11-28,,305900.0,-528069073.4500011,.
409000438620',2018-11-28,MICRO ATM INC DATED 28111,,2018-11-28,,632.88,-528068440.5700011,.
409000438620',2018-11-28,MICRO ATM GST DATED 28111,,2018-11-28,,126.58,-528068313.99000114,.
409000438620',2018-11-28,AEPS INCOME DT 27-11-2018,,2018-11-28,,3847.93,-528064466.06000113,.
409000438620',2018-11-28,AEPS GST INC DT 27-11-201,,2018-11-28,,769.59,-528063696.47000116,.
409000438620',2018-11-28,ACQ CB 6075320177393914 1,,2018-11-28,6500.0,,-528070196.47000116,.
409000438620',2018-11-28,ACQ CB 5272530000910584 7,,2018-11-28,8500.0,,-528078696.47000116,.
409000438620',2018-11-28,TRF TO  Indiaforensic SERVICES I,,2018-11-28,500000.0,,-528578696.47000116,.
409000438620',2018-11-29,Indiaforensic AEPS NPCI WDL SET,,2018-11-29,,1440900.0,-527137796.47000116,.
409000438620',2018-11-29,CR832918874554/RMCPL22659/2,,2018-11-29,3000.0,,-527140796.47000116,.
409000438620',2018-11-29,CR833012031551/RMCPL23018/2,,2018-11-29,1500.0,,-527142296.47000116,.
409000438620',2018-11-29,TRF TO  Indiaforensic SERVICES I,,2018-11-29,1500000.0,,-528642296.47000116,.
409000438620',2018-11-29,AEPS PAY Indiaforensic 2811,,2018-11-29,,9993.8,-528632302.67000115,.
409000438620',2018-11-29,MICRO ATM WDL FEE DT28111,,2018-11-29,,421000.0,-528211302.67000115,.
409000438620',2018-11-29,MICRO ATM INC DATED 28111,,2018-11-29,,842.76,-528210459.91000116,.
409000438620',2018-11-29,MICRO ATM GST DATED 28111,,2018-11-29,,168.55,-528210291.36000115,.
409000438620',2018-11-29,AEPS INCOME DT 28-11-2018,,2018-11-29,,3756.46,-528206534.90000117,.
409000438620',2018-11-29,AEPS GST INC DT 28-11-201,,2018-11-29,,751.29,-528205783.61000115,.
409000438620',2018-11-29,MICRO ATM WDL FEE DT29111,,2018-11-29,,275000.0,-527930783.61000115,.
409000438620',2018-11-29,MICRO ATM INC DATED 29111,,2018-11-29,,566.64,-527930216.97000116,.
409000438620',2018-11-29,MICRO ATM GST DATED 29111,,2018-11-29,,113.33,-527930103.6400012,.
409000438620',2018-11-29,AEPS ACQ CR ADJ FEES 2811,,2018-11-29,26.55,,-527930130.1900012,.
409000438620',2018-11-29,TRF TO  Indiaforensic SERVICES I,,2018-11-29,700000.0,,-528630130.1900012,.
409000438620',2018-11-30,Indiaforensic AEPS NPCI WDL SET,,2018-11-30,,1618400.0,-527011730.1900012,.
409000438620',2018-11-30,AEPS PAY Indiaforensic 2911,,2018-11-30,,999.11,-527010731.0800012,.
409000438620',2018-11-30,TRF TO  Indiaforensic SERVICES I,,2018-11-30,1600000.0,,-528610731.0800012,.
409000438620',2018-11-30,MICRO ATM WDL FEE DT29111,,2018-11-30,,310800.0,-528299931.0800012,.
409000438620',2018-11-30,MICRO ATM INC DATED 29111,,2018-11-30,,722.88,-528299208.2000012,.
409000438620',2018-11-30,MICRO ATM GST DATED 29111,,2018-11-30,,144.58,-528299063.6200012,.
409000438620',2018-11-30,MICRO ATM WDL FEE DT30111,,2018-11-30,,350300.0,-527948763.6200012,.
409000438620',2018-11-30,MICRO ATM INC DATED 30111,,2018-11-30,,581.04,-527948182.5800012,.
409000438620',2018-11-30,MICRO ATM GST DATED 30111,,2018-11-30,,116.21,-527948066.3700012,.
409000438620',2018-11-30,AEPS INCOME DT 29-11-2018,,2018-11-30,,4169.23,-527943897.1400012,.
409000438620',2018-11-30,AEPS GST INC DT 29-11-201,,2018-11-30,,833.85,-527943063.29000115,.
409000438620',2018-11-30,TRF TO  Indiaforensic SERVICES I,,2018-11-30,700000.0,,-528643063.29000115,.
409000438620',2018-12-01,MAW/502964XXXXXX0486/NAGA,,2018-12-01,,1000.0,-528642063.29000115,.
409000438620',2018-12-01,Indiaforensic AEPS NPCI WDL SET,,2018-12-01,,1690700.0,-526951363.29000115,.
409000438620',2018-12-01,CR833114309116/RMCPL18983/2,,2018-12-01,500.0,,-526951863.29000115,.
409000438620',2018-12-01,CR833110249727/RMCPL16457/2,,2018-12-01,500.0,,-526952363.29000115,.
409000438620',2018-12-01,NPCI_SETT_DIFF_301118,,2018-12-01,,5000.0,-526947363.29000115,.
409000438620',2018-12-01,TRF TO  Indiaforensic SERVICES I,,2018-12-01,1000000.0,,-527947363.29000115,.
409000438620',2018-12-01,AEPS INCOME DT 30-11-2018,,2018-12-01,,4283.02,-527943080.2700012,.
409000438620',2018-12-01,AEPS GST INC DT 30-11-201,,2018-12-01,,856.6,-527942223.67000115,.
409000438620',2018-12-01,AEPS ACQ CR ADJ FEES 3011,,2018-12-01,5.9,,-527942229.5700011,.
409000438620',2018-12-01,MICRO ATM WDL FEE DT30111,,2018-12-01,,556500.0,-527385729.5700011,.
409000438620',2018-12-01,MICRO ATM INC DATED 30111,,2018-12-01,,1090.8,-527384638.7700011,.
409000438620',2018-12-01,MICRO ATM GST DATED 30111,,2018-12-01,,218.16,-527384420.6100011,.
409000438620',2018-12-01,MICRO ATM WDL FEE DT01121,,2018-12-01,,271900.0,-527112520.6100011,.
409000438620',2018-12-01,MICRO ATM INC DATED 01121,,2018-12-01,,533.52,-527111987.0900011,.
409000438620',2018-12-01,MICRO ATM GST DATED 01121,,2018-12-01,,106.7,-527111880.3900011,.
409000438620',2018-12-03,Indiaforensic AEPS NPCI WDL SET,,2018-12-03,,1802800.0,-525309080.3900011,.
409000438620',2018-12-03,Indiaforensic AEPS NPCI WDL SET,,2018-12-03,,849900.0,-524459180.3900011,.
409000438620',2018-12-03,MAW/502964XXXXXX0502/NAGA,,2018-12-03,,700.0,-524458480.3900011,.
409000438620',2018-12-03,TRF TO  Indiaforensic SERVICES I,,2018-12-03,4100000.0,,-528558480.3900011,.
409000438620',2018-12-03,MICRO ATM WDL FEE DT01121,,2018-12-03,,561700.0,-527996780.3900011,.
409000438620',2018-12-03,MICRO ATM INC DATED 01121,,2018-12-03,,998.28,-527995782.11000115,.
409000438620',2018-12-03,MICRO ATM GST DATED 01121,,2018-12-03,,199.66,-527995582.4500011,.
409000438620',2018-12-03,MICRO ATM WDL FEE DT02121,,2018-12-03,,1057300.0,-526938282.4500011,.
409000438620',2018-12-03,MICRO ATM INC DATED 02121,,2018-12-03,,2221.2,-526936061.25000113,.
409000438620',2018-12-03,MICRO ATM GST DATED 02121,,2018-12-03,,444.24,-526935617.0100011,.
409000438620',2018-12-03,AEPS PAY Indiaforensic 0212,,2018-12-03,,318.22,-526935298.7900011,.
409000438620',2018-12-03,NPCI SETELEMENT DIFF_0212,,2018-12-03,,7500.0,-526927798.7900011,.
409000438620',2018-12-03,MICRO ATM WDL FEE DT03121,,2018-12-03,,412000.0,-526515798.7900011,.
409000438620',2018-12-03,MICRO ATM INC DATED 03121,,2018-12-03,,815.76,-526514983.0300011,.
409000438620',2018-12-03,MICRO ATM GST DATED 03121,,2018-12-03,,163.15,-526514819.8800011,.
409000438620',2018-12-03,TRF TO  Indiaforensic SERVICES I,,2018-12-03,1700000.0,,-528214819.8800011,.
409000438620',2018-12-03,AEPS INCOME DT 01-12-2018,,2018-12-03,,4363.47,-528210456.4100011,.
409000438620',2018-12-03,AEPS GST INC DT 01-12-201,,2018-12-03,,872.69,-528209583.7200011,.
409000438620',2018-12-03,AEPS INCOME DT 02-12-2018,,2018-12-03,,2312.73,-528207270.9900011,.
409000438620',2018-12-03,AEPS GST INC DT 02-12-201,,2018-12-03,,462.55,-528206808.4400011,.
409000438620',2018-12-03,TRF TO  Indiaforensic SERVICES I,,2018-12-03,400000.0,,-528606808.4400011,.
409000438620',2018-12-04,Indiaforensic AEPS NPCI WDL SET,,2018-12-04,,1325300.0,-527281508.4400011,.
409000438620',2018-12-04,MAW/502964XXXXXX9796/NAGA,,2018-12-04,,200.0,-527281308.4400011,.
409000438620',2018-12-04,TRF TO  Indiaforensic SERVICES I,,2018-12-04,1300000.0,,-528581308.4400011,.
409000438620',2018-12-04,MICRO ATM WDL FEE DT03121,,2018-12-04,,589900.0,-527991408.4400011,.
409000438620',2018-12-04,MICRO ATM INC DATED 03121,,2018-12-04,,1119.24,-527990289.20000106,.
409000438620',2018-12-04,MICRO ATM GST DATED 03121,,2018-12-04,,223.85,-527990065.35000104,.
409000438620',2018-12-04,TRF TO  Indiaforensic SERVICES I,,2018-12-04,600000.0,,-528590065.35000104,.
409000438620',2018-12-04,MICRO ATM WDL FEE DT04121,,2018-12-04,,471900.0,-528118165.35000104,.
409000438620',2018-12-04,MICRO ATM INC DATED 04121,,2018-12-04,,843.12,-528117322.23000103,.
409000438620',2018-12-04,MICRO ATM GST DATED 04121,,2018-12-04,,168.62,-528117153.610001,.
409000438620',2018-12-04,AEPS INCOME DT 03-12-2018,,2018-12-04,,3289.55,-528113864.060001,.
409000438620',2018-12-04,AEPS GST INC DT 03-12-201,,2018-12-04,,657.91,-528113206.150001,.
409000438620',2018-12-04,AEPS PAY Indiaforensic 0312,,2018-12-04,,5695.46,-528107510.690001,.
409000438620',2018-12-05,Indiaforensic AEPS NPCI WDL SET,,2018-12-05,,1349000.0,-526758510.690001,.
409000438620',2018-12-05,TRF TO  Indiaforensic SERVICES I,,2018-12-05,1800000.0,,-528558510.690001,.
409000438620',2018-12-05,PEN 6070935006380173 6807,,2018-12-05,2300.0,,-528560810.690001,.
409000438620',2018-12-05,PRE ACC 6070935006380173,,2018-12-05,10000.0,,-528570810.690001,.
409000438620',2018-12-05,MICRO ATM WDL FEE DT04121,,2018-12-05,,509200.0,-528061610.690001,.
409000438620',2018-12-05,MICRO ATM INC DATED 04121,,2018-12-05,,975.6,-528060635.090001,.
409000438620',2018-12-05,MICRO ATM GST DATED 04121,,2018-12-05,,195.12,-528060439.970001,.
409000438620',2018-12-05,AEPS PAY Indiaforensic 0412,,2018-12-05,,99.64,-528060340.330001,.
409000438620',2018-12-05,AEPS INCOME DT 04-12-2018,,2018-12-05,,3260.27,-528057080.060001,.
409000438620',2018-12-05,AEPS GST INC DT 04-12-201,,2018-12-05,,652.05,-528056428.010001,.
409000438620',2018-12-05,MICRO ATM WDL FEE DT05121,,2018-12-05,,296200.0,-527760228.010001,.
409000438620',2018-12-05,MICRO ATM INC DATED 05121,,2018-12-05,,507.96,-527759720.050001,.
409000438620',2018-12-05,MICRO ATM GST DATED 05121,,2018-12-05,,101.59,-527759618.46000105,.
409000438620',2018-12-05,TRF TO  Indiaforensic SERVICES I,,2018-12-05,800000.0,,-528559618.46000105,.
409000438620',2018-12-06,Indiaforensic AEPS NPCI WDL SET,,2018-12-06,,1425700.0,-527133918.46000105,.
409000438620',2018-12-06,CR832113073938/RMCPL28013/1,,2018-12-06,199.0,,-527134117.46000105,.
409000438620',2018-12-06,CR832217329380/RMCPL25130/1,,2018-12-06,210.0,,-527134327.46000105,.
409000438620',2018-12-06,CR832517966150/RMCPL29319/2,,2018-12-06,500.0,,-527134827.46000105,.
409000438620',2018-12-06,CR833120394407/RMCPL27997/2,,2018-12-06,100.0,,-527134927.46000105,.
409000438620',2018-12-06,CR833120394873/RMCPL27997/2,,2018-12-06,100.0,,-527135027.46000105,.
409000438620',2018-12-06,TRF TO  Indiaforensic SERVICES I,,2018-12-06,1500000.0,,-528635027.46000105,.
409000438620',2018-12-06,AEPS INCOME DT 05-12-2018,,2018-12-06,,3810.27,-528631217.1900011,.
409000438620',2018-12-06,AEPS GST INC DT 05-12-201,,2018-12-06,,762.05,-528630455.14000106,.
409000438620',2018-12-06,AEPS ACQ REP ADJ FEES 051,,2018-12-06,,0.67,-528630454.47000104,.
409000438620',2018-12-06,MICRO ATM WDL FEE DT05121,,2018-12-06,,359000.0,-528271454.47000104,.
409000438620',2018-12-06,MICRO ATM INC DATED 05121,,2018-12-06,,758.88,-528270695.59000105,.
409000438620',2018-12-06,MICRO ATM GST DATED 05121,,2018-12-06,,151.78,-528270543.8100011,.
409000438620',2018-12-06,MICRO ATM WDL FEE DT06121,,2018-12-06,,272900.0,-527997643.8100011,.
409000438620',2018-12-06,MICRO ATM INC DATED 06121,,2018-12-06,,502.2,-527997141.6100011,.
409000438620',2018-12-06,MICRO ATM GST DATED 06121,,2018-12-06,,100.44,-527997041.1700011,.
409000438620',2018-12-07,MAW/502964XXXXXX9796/NAGA,,2018-12-07,,1000.0,-527996041.1700011,.
409000438620',2018-12-07,Indiaforensic AEPS NPCI WDL SET,,2018-12-07,,1328700.0,-526667341.1700011,.
409000438620',2018-12-07,MAW/502964XXXXXX7050/NAGA,,2018-12-07,,1200.0,-526666141.1700011,.
409000438620',2018-12-07,MAW/502964XXXXXX7068/NAGA,,2018-12-07,,1200.0,-526664941.1700011,.
409000438620',2018-12-07,MAW/502964XXXXXX8155/NAGA,,2018-12-07,,1200.0,-526663741.1700011,.
409000438620',2018-12-07,TRF TO  Indiaforensic SERVICES I,,2018-12-07,1900000.0,,-528563741.1700011,.
409000438620',2018-12-07,AEPS PAY Indiaforensic 0612,,2018-12-07,,199.58,-528563541.5900011,.
409000438620',2018-12-07,MICRO ATM WDL FEE DT06121,,2018-12-07,,387700.0,-528175841.5900011,.
409000438620',2018-12-07,MICRO ATM INC DATED 06121,,2018-12-07,,774.72,-528175066.8700011,.
409000438620',2018-12-07,MICRO ATM GST DATED 06121,,2018-12-07,,154.94,-528174911.9300011,.
409000438620',2018-12-07,AEPS INCOME DT 12-06-2018,,2018-12-07,,3403.27,-528171508.6600011,.
409000438620',2018-12-07,AEPS GST DT 12-06-2018 RO,,2018-12-07,,680.65,-528170828.0100011,.
409000438620',2018-12-07,MICRO ATM WDL FEE DT07121,,2018-12-07,,313500.0,-527857328.0100011,.
409000438620',2018-12-07,MICRO ATM INC DATED 07121,,2018-12-07,,568.44,-527856759.5700011,.
409000438620',2018-12-07,MICRO ATM GST DATED 07121,,2018-12-07,,113.69,-527856645.8800011,.
409000438620',2018-12-08,MAW/502964XXXXXX3464/NAGA,,2018-12-08,,900.0,-527855745.8800011,.
409000438620',2018-12-10,Indiaforensic AEPS NPCI WDL SET,,2018-12-10,,1220600.0,-526635145.8800011,.
409000438620',2018-12-10,Indiaforensic AEPS NPCI WDL SET,,2018-12-10,,1349600.0,-525285545.8800011,.
409000438620',2018-12-10,CR833811008170/RMCPL22655/4,,2018-12-10,900.0,,-525286445.8800011,.
409000438620',2018-12-10,CR833710717768/RMCPL16869/3,,2018-12-10,3000.0,,-525289445.8800011,.
409000438620',2018-12-10,Indiaforensic AEPS NPCI WDL SET,,2018-12-10,,791000.0,-524498445.8800011,.
409000438620',2018-12-10,TRF TO  Indiaforensic SERVICES I,,2018-12-10,4000000.0,,-528498445.8800011,.
409000438620',2018-12-10,MICRO ATM WDL FEE DT07121,,2018-12-10,,460600.0,-528037845.8800011,.
409000438620',2018-12-10,MICRO ATM INC DATED 07121,,2018-12-10,,867.96,-528036977.92000115,.
409000438620',2018-12-10,MICRO ATM GST DATED 07121,,2018-12-10,,173.59,-528036804.3300012,.
409000438620',2018-12-10,MICRO ATM WDL FEE DT08121,,2018-12-10,,1180700.0,-526856104.3300012,.
409000438620',2018-12-10,MICRO ATM INC DATED 08121,,2018-12-10,,2292.12,-526853812.2100012,.
409000438620',2018-12-10,MICRO ATM GST DATED 08121,,2018-12-10,,458.42,-526853353.79000115,.
409000438620',2018-12-10,MICRO ATM WDL FEE DT09121,,2018-12-10,,874300.0,-525979053.79000115,.
409000438620',2018-12-10,MICRO ATM INC DATED 09121,,2018-12-10,,1829.16,-525977224.6300011,.
409000438620',2018-12-10,MICRO ATM GST DATED 09121,,2018-12-10,,365.83,-525976858.80000114,.
409000438620',2018-12-10,NPCI SETELEMENT DIFF_0812,,2018-12-10,,1000.0,-525975858.80000114,.
409000438620',2018-12-10,NPCI SETELEMENT DIFF_0912,,2018-12-10,,10000.0,-525965858.80000114,.
409000438620',2018-12-10,AEPS INC DT 07-12-2018 RO,,2018-12-10,,3139.1,-525962719.7000011,.
409000438620',2018-12-10,AEPS GST INC DT 07-12-201,,2018-12-10,,627.82,-525962091.8800011,.
409000438620',2018-12-10,AEPS INC DT 08-12-2018 RO,,2018-12-10,,3455.31,-525958636.5700011,.
409000438620',2018-12-10,AEPS GST INC DT 08-12-201,,2018-12-10,,691.06,-525957945.5100011,.
409000438620',2018-12-10,AEPS INC DT 09-12-2018 RO,,2018-12-10,,1939.69,-525956005.8200011,.
409000438620',2018-12-10,AEPS GST INC DT 09-12-201,,2018-12-10,,387.94,-525955617.8800011,.
409000438620',2018-12-10,AEPS ACQ CR ADJ FEES 0712,,2018-12-10,23.01,,-525955640.8900011,.
409000438620',2018-12-10,MICRO ATM WDL FEE DT10121,,2018-12-10,,378600.0,-525577040.8900011,.
409000438620',2018-12-10,MICRO ATM INC DATED 10121,,2018-12-10,,747.36,-525576293.5300011,.
409000438620',2018-12-10,MICRO ATM GST DATED 10121,,2018-12-10,,149.47,-525576144.0600011,.
409000438620',2018-12-10,AEPS PAY Indiaforensic 0712,,2018-12-10,,999.11,-525575144.95000106,.
409000438620',2018-12-11,Indiaforensic AEPS NPCI WDL SET,,2018-12-11,,1434900.0,-524140244.95000106,.
409000438620',2018-12-11,TRF TO  Indiaforensic SERVICES I,,2018-12-11,4500000.0,,-528640244.95000106,.
409000438620',2018-12-11,AEPS PAY Indiaforensic 1012,,2018-12-11,,279.53,-528639965.4200011,.
409000438620',2018-12-11,MICRO ATM WDL FEE DT10121,,2018-12-11,,663500.0,-527976465.4200011,.
409000438620',2018-12-11,MICRO ATM INC DATED 10121,,2018-12-11,,1223.64,-527975241.7800011,.
409000438620',2018-12-11,MICRO ATM GST DATED 10121,,2018-12-11,,244.73,-527974997.0500011,.
409000438620',2018-12-11,AEPS INC DT 12-10-2018 RO,,2018-12-11,,3525.74,-527971471.3100011,.
409000438620',2018-12-11,AEPS GST INC DT 12-10-201,,2018-12-11,,705.15,-527970766.1600011,.
409000438620',2018-12-11,MICRO ATM WDL FEE DT11121,,2018-12-11,,255100.0,-527715666.1600011,.
409000438620',2018-12-11,MICRO ATM INC DATED 11121,,2018-12-11,,470.16,-527715196.0000011,.
409000438620',2018-12-11,MICRO ATM GST DATED 11121,,2018-12-11,,94.03,-527715101.9700011,.
409000438620',2018-12-12,Indiaforensic AEPS NPCI WDL SET,,2018-12-12,,1124700.0,-526590401.9700011,.
409000438620',2018-12-12,TRF TO  Indiaforensic SERVICES I,,2018-12-12,900000.0,,-527490401.9700011,.
409000438620',2018-12-12,TRF TO  Indiaforensic SERVICES I,,2018-12-12,1100000.0,,-528590401.9700011,.
409000438620',2018-12-12,MICRO ATM WDL FEE DT11121,,2018-12-12,,592900.0,-527997501.9700011,.
409000438620',2018-12-12,MICRO ATM INC DATED 11121,,2018-12-12,,1062.72,-527996439.2500011,.
409000438620',2018-12-12,MICRO ATM GST DATED 11121,,2018-12-12,,212.54,-527996226.71000105,.
409000438620',2018-12-12,MICRO ATM WDL FEE DT12121,,2018-12-12,,293400.0,-527702826.71000105,.
409000438620',2018-12-12,MICRO ATM INC DATED 12121,,2018-12-12,,512.28,-527702314.4300011,.
409000438620',2018-12-12,MICRO ATM GST DATED 12121,,2018-12-12,,102.46,-527702211.9700011,.
409000438620',2018-12-12,AEPS INC DT 12-11-2018 RO,,2018-12-12,,2972.84,-527699239.1300011,.
409000438620',2018-12-12,AEPS GST INC DT 12-11-201,,2018-12-12,,594.57,-527698644.56000113,.
409000438620',2018-12-13,Indiaforensic AEPS NPCI WDL SET,,2018-12-13,,1374700.0,-526323944.56000113,.
409000438620',2018-12-13,CR834316186581/RMCPL18136/0,,2018-12-13,1000.0,,-526324944.56000113,.
409000438620',2018-12-13,CR834210864650/RMCPL20143/0,,2018-12-13,2500.0,,-526327444.56000113,.
409000438620',2018-12-13,CR834209862383/RMCPL11457/0,,2018-12-13,1300.0,,-526328744.56000113,.
409000438620',2018-12-13,CR834212903897/RMCPL27291/0,,2018-12-13,2600.0,,-526331344.56000113,.
409000438620',2018-12-13,TRF TO  Indiaforensic SERVICES I,,2018-12-13,2300000.0,,-528631344.56000113,.
409000438620',2018-12-13,MICRO ATM WDL FEE DT12121,,2018-12-13,,393900.0,-528237444.56000113,.
409000438620',2018-12-13,MICRO ATM INC DATED 12121,,2018-12-13,,828.72,-528236615.8400011,.
409000438620',2018-12-13,MICRO ATM GST DATED 12121,,2018-12-13,,165.74,-528236450.1000011,.
409000438620',2018-12-13,MAW/502964XXXXXX8587/NAGA,,2018-12-13,,800.0,-528235650.1000011,.
409000438620',2018-12-13,AEPS INC DT 12-12-2018 RO,,2018-12-13,,3292.17,-528232357.9300011,.
409000438620',2018-12-13,AEPS GST INC DT 12-12-201,,2018-12-13,,658.43,-528231699.5000011,.
409000438620',2018-12-13,AEPS ACQ CR ADJ FEES 1212,,2018-12-13,43.66,,-528231743.1600011,.
409000438620',2018-12-13,AEPS PAY Indiaforensic 1212,,2018-12-13,,797.23,-528230945.9300011,.
409000438620',2018-12-13,MICRO ATM WDL FEE DT13121,,2018-12-13,,184500.0,-528046445.9300011,.
409000438620',2018-12-13,MICRO ATM INC DATED 13121,,2018-12-13,,408.6,-528046037.33000106,.
409000438620',2018-12-13,MICRO ATM GST DATED 13121,,2018-12-13,,81.72,-528045955.610001,.
409000438620',2018-12-14,Indiaforensic AEPS NPCI WDL SET,,2018-12-14,,1174500.0,-526871455.610001,.
409000438620',2018-12-14,TRF T  Indiaforensic SERVICES IN,,2018-12-14,1700000.0,,-528571455.610001,.
409000438620',2018-12-14,MICRO ATM WDL FEE DT13121,,2018-12-14,,366800.0,-528204655.610001,.
409000438620',2018-12-14,MICRO ATM INC DATED 13121,,2018-12-14,,753.48,-528203902.130001,.
409000438620',2018-12-14,MICRO ATM GST DATED 13121,,2018-12-14,,150.7,-528203751.430001,.
409000438620',2018-12-14,AEPS INC DT 12-13-2018 RO,,2018-12-14,,2896.42,-528200855.010001,.
409000438620',2018-12-14,AEPS GST INC DT 12-13-201,,2018-12-14,,579.28,-528200275.73000103,.
409000438620',2018-12-14,TRF TO  Indiaforensic SERVICES I,,2018-12-14,400000.0,,-528600275.73000103,.
409000438620',2018-12-14,MICRO ATM WDL FEE DT14121,,2018-12-14,,462600.0,-528137675.73000103,.
409000438620',2018-12-14,MICRO ATM INC DATED 14121,,2018-12-14,,842.04,-528136833.690001,.
409000438620',2018-12-14,MICRO ATM GST DATED 14121,,2018-12-14,,168.41,-528136665.280001,.
409000438620',2018-12-15,MAW/502964XXXXXX8117/NAGA,,2018-12-15,,700.0,-528135965.280001,.
409000438620',2018-12-15,Indiaforensic AEPS NPCI WDL SET,,2018-12-15,,1231400.0,-526904565.280001,.
409000438620',2018-12-15,TRF TO  Indiaforensic SERVICES I,,2018-12-15,1000000.0,,-527904565.280001,.
409000438620',2018-12-15,AEPS PAY Indiaforensic 1412,,2018-12-15,,399.17,-527904166.11000097,.
409000438620',2018-12-15,MICRO ATM WDL FEE DT14121,,2018-12-15,,386900.0,-527517266.11000097,.
409000438620',2018-12-15,MICRO ATM INC DATED 14121,,2018-12-15,,819.0,-527516447.11000097,.
409000438620',2018-12-15,MICRO ATM GST DATED 14121,,2018-12-15,,163.8,-527516283.31000096,.
409000438620',2018-12-15,CB 4598459009265230 2067,,2018-12-15,5000.0,,-527521283.31000096,.
409000438620',2018-12-15,AEPS INC DT 12-14-2018 RO,,2018-12-15,,3075.24,-527518208.07000095,.
409000438620',2018-12-15,AEPS GST INC DT 12-14-201,,2018-12-15,,615.05,-527517593.02000093,.
409000438620',2018-12-15,TRF TO  Indiaforensic SERVICES I,,2018-12-15,1000000.0,,-528517593.02000093,.
409000438620',2018-12-15,MICRO ATM WDL FEE DT15121,,2018-12-15,,311200.0,-528206393.02000093,.
409000438620',2018-12-15,MICRO ATM INC DATED 15121,,2018-12-15,,561.96,-528205831.06000096,.
409000438620',2018-12-15,MICRO ATM GST DATED 15121,,2018-12-15,,112.39,-528205718.670001,.
409000438620',2018-12-17,Indiaforensic AEPS NPCI WDL SET,,2018-12-17,,947000.0,-527258718.670001,.
409000438620',2018-12-17,Indiaforensic AEPS NPCI WDL SET,,2018-12-17,,614600.0,-526644118.670001,.
409000438620',2018-12-17,CR834510590954/RMCPL26772/1,,2018-12-17,1500.0,,-526645618.670001,.
409000438620',2018-12-17,MICRO ATM WDL FEE DT15121,,2018-12-17,,433800.0,-526211818.670001,.
409000438620',2018-12-17,MICRO ATM INC DATED 15121,,2018-12-17,,870.84,-526210947.830001,.
409000438620',2018-12-17,MICRO ATM GST DATED 15121,,2018-12-17,,174.17,-526210773.660001,.
409000438620',2018-12-17,TRF TO  Indiaforensic SERVICES I,,2018-12-17,2000000.0,,-528210773.660001,.
409000438620',2018-12-17,MICRO ATM WDL FEE DT16121,,2018-12-17,,591500.0,-527619273.660001,.
409000438620',2018-12-17,MICRO ATM INC DATED 16121,,2018-12-17,,1341.0,-527617932.660001,.
409000438620',2018-12-17,MICRO ATM GST DATED 16121,,2018-12-17,,268.2,-527617664.460001,.
409000438620',2018-12-17,TRF TO  Indiaforensic SERVICES I,,2018-12-17,1000000.0,,-528617664.460001,.
409000438620',2018-12-17,AEPS PAY Indiaforensic 1512,,2018-12-17,,999.11,-528616665.350001,.
409000438620',2018-12-17,AEPS PAY Indiaforensic 1612,,2018-12-17,,99.64,-528616565.710001,.
409000438620',2018-12-17,MICRO ATM WDL FEE DT17121,,2018-12-17,,325800.0,-528290765.710001,.
409000438620',2018-12-17,MICRO ATM INC DATED 17121,,2018-12-17,,646.92,-528290118.790001,.
409000438620',2018-12-17,MICRO ATM GST DATED 17121,,2018-12-17,,129.38,-528289989.410001,.
409000438620',2018-12-17,AEPS INC DT 12-15-2018 RO,,2018-12-17,,2448.6,-528287540.81000096,.
409000438620',2018-12-17,AEPS GST INC DT 12-15-201,,2018-12-17,,489.72,-528287051.0900009,.
409000438620',2018-12-17,AEPS INC DT 16-12-2018 RO,,2018-12-17,,1719.7,-528285331.39000094,.
409000438620',2018-12-17,AEPS GST INC DT 16-12-201,,2018-12-17,,343.94,-528284987.45000094,.
409000438620',2018-12-17,AEPS ACQ CR ADJ FEES 1512,,2018-12-17,8.8,,-528284996.25000095,.
409000438620',2018-12-18,MAW/502964XXXXXX0270/NAGA,,2018-12-18,,1800.0,-528283196.25000095,.
409000438620',2018-12-18,MAW/502964XXXXXX4423/NAGA,,2018-12-18,,3200.0,-528279996.25000095,.
409000438620',2018-12-18,Indiaforensic AEPS NPCI WDL SET,,2018-12-18,,1127100.0,-527152896.25000095,.
409000438620',2018-12-18,TRF TO  Indiaforensic SERVICES I,,2018-12-18,1000000.0,,-528152896.25000095,.
409000438620',2018-12-18,TRF TO  Indiaforensic SERVICES I,,2018-12-18,500000.0,,-528652896.25000095,.
409000438620',2018-12-18,AEPS INCOME DT 17-12-2018,,2018-12-18,,2899.86,-528649996.39000094,.
409000438620',2018-12-18,AEPS GST INC DT 17-12-201,,2018-12-18,,579.97,-528649416.4200009,.
409000438620',2018-12-18,MICRO ATM WDL FEE DT17121,,2018-12-18,,304000.0,-528345416.4200009,.
409000438620',2018-12-18,MICRO ATM INC DATED 17121,,2018-12-18,,671.04,-528344745.3800009,.
409000438620',2018-12-18,MICRO ATM GST DATED 17121,,2018-12-18,,134.21,-528344611.1700009,.
409000438620',2018-12-18,MICRO ATM WDL FEE DT18121,,2018-12-18,,209400.0,-528135211.1700009,.
409000438620',2018-12-18,MICRO ATM INC DATED 18121,,2018-12-18,,473.4,-528134737.77000093,.
409000438620',2018-12-18,MICRO ATM GST DATED 18121,,2018-12-18,,94.68,-528134643.0900009,.
409000438620',2018-12-19,Indiaforensic AEPS NPCI WDL SET,,2018-12-19,,1148400.0,-526986243.0900009,.
409000438620',2018-12-19,CR834912538877/RMCPL18749/1,,2018-12-19,1000.0,,-526987243.0900009,.
409000438620',2018-12-19,MAW/502964XXXXXX0502/NAGA,,2018-12-19,,700.0,-526986543.0900009,.
409000438620',2018-12-19,TRF TO  Indiaforensic SERVICES I,,2018-12-19,1600000.0,,-528586543.0900009,.
409000438620',2018-12-19,MICRO ATM WDL FEE DT18121,,2018-12-19,,328500.0,-528258043.0900009,.
409000438620',2018-12-19,MICRO ATM INC DATED 18121,,2018-12-19,,752.4,-528257290.69000095,.
409000438620',2018-12-19,MICRO ATM GST DATED 18121,,2018-12-19,,150.48,-528257140.21000093,.
409000438620',2018-12-19,MAW/502964XXXXXX0296/NAGA,,2018-12-19,,600.0,-528256540.21000093,.
409000438620',2018-12-19,AEPS INC DT 12-18-2018 RO,,2018-12-19,,3002.09,-528253538.12000096,.
409000438620',2018-12-19,AEPS GST INC DT 12-18-201,,2018-12-19,,600.42,-528252937.70000094,.
409000438620',2018-12-19,AEPS ACQ CR ADJ FEES 1712,,2018-12-19,5.9,,-528252943.6000009,.
409000438620',2018-12-19,MICRO ATM WDL FEE DT19121,,2018-12-19,,233200.0,-528019743.6000009,.
409000438620',2018-12-19,MICRO ATM INC DATED 19121,,2018-12-19,,506.88,-528019236.7200009,.
409000438620',2018-12-19,MICRO ATM GST DATED 19121,,2018-12-19,,101.38,-528019135.3400009,.
409000438620',2018-12-20,Indiaforensic AEPS NPCI WDL SET,,2018-12-20,,887600.0,-527131535.3400009,.
409000438620',2018-12-20,TRF TO  Indiaforensic SERVICES I,,2018-12-20,1000000.0,,-528131535.3400009,.
409000438620',2018-12-20,TRF TO  Indiaforensic SERVICES I,,2018-12-20,500000.0,,-528631535.3400009,.
409000438620',2018-12-20,AEPS PAY Indiaforensic 1912,,2018-12-20,,63460.17,-528568075.1700009,.
409000438620',2018-12-20,MICRO ATM WDL FEE DT19121,,2018-12-20,,495500.0,-528072575.1700009,.
409000438620',2018-12-20,MICRO ATM INC DATED 19121,,2018-12-20,,852.12,-528071723.0500009,.
409000438620',2018-12-20,MICRO ATM GST DATED 19121,,2018-12-20,,170.42,-528071552.6300009,.
409000438620',2018-12-20,AEPS INC DT 19-12-2018 RO,,2018-12-20,,2372.43,-528069180.2000009,.
409000438620',2018-12-20,AEPS GST INC DT 19-12-201,,2018-12-20,,474.49,-528068705.7100009,.
409000438620',2018-12-20,TRF TO  Indiaforensic SERVICES I,,2018-12-20,500000.0,,-528568705.7100009,.
409000438620',2018-12-21,Indiaforensic AEPS NPCI WDL SET,,2018-12-21,,831000.0,-527737705.7100009,.
409000438620',2018-12-21,TRF TO  Indiaforensic SERVICES I,,2018-12-21,900000.0,,-528637705.7100009,.
409000438620',2018-12-21,AEPS PAY Indiaforensic 2012,,2018-12-21,,62060.11,-528575645.60000086,.
409000438620',2018-12-21,ATW/536799XXXXXX9514/Indfor*,,2018-12-21,,500.0,-528575145.60000086,.
409000438620',2018-12-21,MICRO ATM WDL FEE DT20121,,2018-12-21,,95500.0,-528479645.60000086,.
409000438620',2018-12-21,MICRO ATM INC DATED 20121,,2018-12-21,,239.04,-528479406.56000084,.
409000438620',2018-12-21,MICRO ATM GST DATED 20121,,2018-12-21,,47.81,-528479358.75000083,.
409000438620',2018-12-21,AEPS INC DT 20-12-2018 RO,,2018-12-21,,2044.89,-528477313.86000085,.
409000438620',2018-12-21,AEPS GST INC DT 20-12-201,,2018-12-21,,408.98,-528476904.8800008,.
409000438620',2018-12-21,MICRO ATM WDL FEE DT20121,,2018-12-21,,204100.0,-528272804.8800008,.
409000438620',2018-12-21,MICRO ATM INC DATED 20121,,2018-12-21,,385.56,-528272419.3200008,.
409000438620',2018-12-21,MICRO ATM GST DATED 20121,,2018-12-21,,77.11,-528272342.2100008,.
409000438620',2018-12-24,Indiaforensic AEPS NPCI WDL SET,,2018-12-24,,1160300.0,-527112042.2100008,.
409000438620',2018-12-24,Indiaforensic AEPS NPCI WDL SET,,2018-12-24,,875000.0,-526237042.2100008,.
409000438620',2018-12-24,Indiaforensic AEPS NPCI WDL SET,,2018-12-24,,575200.0,-525661842.2100008,.
409000438620',2018-12-24,TRF TO  Indiaforensic SERVICES I,,2018-12-24,1000000.0,,-526661842.2100008,.
409000438620',2018-12-24,TRF TO  Indiaforensic SERVICES I,,2018-12-24,500000.0,,-527161842.2100008,.
409000438620',2018-12-24,MAW/502964XXXXXX7574/NAGA,,2018-12-24,,1000.0,-527160842.2100008,.
409000438620',2018-12-24,AEPS PAY Indiaforensic 2212,,2018-12-24,,589.42,-527160252.7900008,.
409000438620',2018-12-24,TRF TO  Indiaforensic SERVICES I,,2018-12-24,500000.0,,-527660252.7900008,.
409000438620',2018-12-24,TRF TO  Indiaforensic SERVICES I,,2018-12-24,500000.0,,-528160252.7900008,.
409000438620',2018-12-24,MICRO ATM WDL FEE DT21121,,2018-12-24,,489800.0,-527670452.7900008,.
409000438620',2018-12-24,MICRO ATM INC DATED 21121,,2018-12-24,,910.44,-527669542.3500008,.
409000438620',2018-12-24,MICRO ATM GST DATED 21121,,2018-12-24,,182.09,-527669360.2600008,.
409000438620',2018-12-24,MICRO ATM WDL FEE DT20121,,2018-12-24,,242000.0,-527427360.2600008,.
409000438620',2018-12-24,MICRO ATM INC DATED 20121,,2018-12-24,,457.2,-527426903.06000084,.
409000438620',2018-12-24,MICRO ATM GST DATED 20121,,2018-12-24,,91.44,-527426811.62000084,.
409000438620',2018-12-24,MICRO ATM WDL FEE DT22121,,2018-12-24,,738300.0,-526688511.62000084,.
409000438620',2018-12-24,MICRO ATM INC DATED 22121,,2018-12-24,,1358.28,-526687153.34000087,.
409000438620',2018-12-24,MICRO ATM GST DATED 22121,,2018-12-24,,271.66,-526686881.68000084,.
409000438620',2018-12-24,MICRO ATM WDL FEE DT23121,,2018-12-24,,331400.0,-526355481.68000084,.
409000438620',2018-12-24,MICRO ATM INC DATED 23121,,2018-12-24,,770.76,-526354710.92000085,.
409000438620',2018-12-24,MICRO ATM GST DATED 23121,,2018-12-24,,154.15,-526354556.7700009,.
409000438620',2018-12-24,AEPS INC DT 12-21-2018 RO,,2018-12-24,,2907.21,-526351649.5600009,.
409000438620',2018-12-24,AEPS GST INC DT 12-21-201,,2018-12-24,,581.44,-526351068.1200009,.
409000438620',2018-12-24,AEPS INC DT 12-22-2018 RO,,2018-12-24,,2096.51,-526348971.6100009,.
409000438620',2018-12-24,AEPS GST INC DT 12-22-201,,2018-12-24,,419.3,-526348552.3100009,.
409000438620',2018-12-24,AEPS INC DT 12-23-2018 RO,,2018-12-24,,1483.17,-526347069.1400009,.
409000438620',2018-12-24,AEPS GST INC DT 12-23-201,,2018-12-24,,296.63,-526346772.5100009,.
409000438620',2018-12-25,MAW/502964XXXXXX0202/NAGA,,2018-12-25,,1200.0,-526345572.5100009,.
409000438620',2018-12-26,TRF TO  Indiaforensic SERVICES I,,2018-12-26,2000000.0,,-528345572.5100009,.
409000438620',2018-12-26,Indiaforensic AEPS NPCI WDL SET,,2018-12-26,,991000.0,-527354572.5100009,.
409000438620',2018-12-26,Indiaforensic AEPS NPCI WDL SET,,2018-12-26,,963000.0,-526391572.5100009,.
409000438620',2018-12-26,MAW/502964XXXXXX8975/NAGA,,2018-12-26,,1800.0,-526389772.5100009,.
409000438620',2018-12-26,TRF TO  Indiaforensic SERVICES I,,2018-12-26,2000000.0,,-528389772.5100009,.
409000438620',2018-12-26,AEPS PAY Indiaforensic 2512,,2018-12-26,,499.4,-528389273.1100009,.
409000438620',2018-12-26,AEPS INC DT 12-24-2018 RO,,2018-12-26,,2495.39,-528386777.7200009,.
409000438620',2018-12-26,AEPS GST INC DT 12-24-201,,2018-12-26,,499.08,-528386278.64000094,.
409000438620',2018-12-26,MICRO ATM WDL FEE DT24121,,2018-12-26,,258900.0,-528127378.64000094,.
409000438620',2018-12-26,MICRO ATM INC DATED 24121,,2018-12-26,,595.44,-528126783.20000094,.
409000438620',2018-12-26,MICRO ATM GST DATED 24121,,2018-12-26,,119.09,-528126664.11000097,.
409000438620',2018-12-26,MICRO ATM WDL FEE DT25121,,2018-12-26,,428100.0,-527698564.11000097,.
409000438620',2018-12-26,MICRO ATM INC DATED 25121,,2018-12-26,,957.6,-527697606.51000094,.
409000438620',2018-12-26,MICRO ATM GST DATED 25121,,2018-12-26,,191.52,-527697414.99000096,.
409000438620',2018-12-26,AEPS INC DT 12-25-2018 RO,,2018-12-26,,2254.31,-527695160.68000096,.
409000438620',2018-12-26,AEPS GST INC DT 12-25-201,,2018-12-26,,450.86,-527694709.82000095,.
409000438620',2018-12-26,MICRO ATM WDL FEE DT20121,,2018-12-26,,128800.0,-527565909.82000095,.
409000438620',2018-12-26,MICRO ATM INC DATED 20121,,2018-12-26,,259.56,-527565650.26000094,.
409000438620',2018-12-26,MICRO ATM GST DATED 20121,,2018-12-26,,51.91,-527565598.3500009,.
409000438620',2018-12-27,Indiaforensic AEPS NPCI WDL SET,,2018-12-27,,919500.0,-526646098.3500009,.
409000438620',2018-12-27,TRF TO  Indiaforensic SERVICES I,,2018-12-27,2000000.0,,-528646098.3500009,.
409000438620',2018-12-27,AEPS PAY Indiaforensic 2612,,2018-12-27,,299.52,-528645798.83000094,.
409000438620',2018-12-27,MICRO ATM WDL FEE DT26121,,2018-12-27,,364000.0,-528281798.83000094,.
409000438620',2018-12-27,MICRO ATM INC DATED 26121,,2018-12-27,,734.04,-528281064.7900009,.
409000438620',2018-12-27,MICRO ATM GST DATED 26121,,2018-12-27,,146.81,-528280917.9800009,.
409000438620',2018-12-27,AEPS INC DT 26-12-2018 RO,,2018-12-27,,2226.71,-528278691.27000093,.
409000438620',2018-12-27,AEPS GST INC DT 26-12-201,,2018-12-27,,445.34,-528278245.93000096,.
409000438620',2018-12-27,MICRO ATM WDL FEE DT20121,,2018-12-27,,170700.0,-528107545.93000096,.
409000438620',2018-12-27,MICRO ATM INC DATED 20121,,2018-12-27,,313.92,-528107232.01000094,.
409000438620',2018-12-27,MICRO ATM GST DATED 20121,,2018-12-27,,62.78,-528107169.230001,.
409000438620',2018-12-28,FDRL/INTERNAL FUND TRANSFE,,2018-12-28,500000.0,,-528607169.230001,.
409000438620',2018-12-28,MAW/502964XXXXXX2167/NAGA,,2018-12-28,,200.0,-528606969.230001,.
409000438620',2018-12-28,Indiaforensic AEPS NPCI WDL SET,,2018-12-28,,892000.0,-527714969.230001,.
409000438620',2018-12-28,CR835312497192/RMCPL28497/1,,2018-12-28,10000.0,,-527724969.230001,.
409000438620',2018-12-28,CR835414765623/RMCPL28497/2,,2018-12-28,5000.0,,-527729969.230001,.
409000438620',2018-12-28,MICRO ATM WDL FEE DT27121,,2018-12-28,,303500.0,-527426469.230001,.
409000438620',2018-12-28,MICRO ATM INC DATED 27121,,2018-12-28,,705.6,-527425763.63000095,.
409000438620',2018-12-28,MICRO ATM GST DATED 27121,,2018-12-28,,141.12,-527425622.51000094,.
409000438620',2018-12-28,FDRL/INTERNAL FUND TRANSFE,,2018-12-28,1000000.0,,-528425622.51000094,.
409000438620',2018-12-28,AEPS PAY Indiaforensic 2712,,2018-12-28,,3497.34,-528422125.170001,.
409000438620',2018-12-28,AEPS INC DT 27-12-2018 RO,,2018-12-28,,2315.85,-528419809.32000095,.
409000438620',2018-12-28,AEPS GST INC DT 27-12-201,,2018-12-28,,463.17,-528419346.15000093,.
409000438620',2018-12-28,AEPS ACQ REP ADJ FEES 271,,2018-12-28,,8.85,-528419337.3000009,.
409000438620',2018-12-28,MICRO ATM WDL FEE DT28121,,2018-12-28,,232100.0,-528187237.3000009,.
409000438620',2018-12-28,MICRO ATM INC DATED 28121,,2018-12-28,,471.96,-528186765.3400009,.
409000438620',2018-12-28,MICRO ATM GST DATED 28121,,2018-12-28,,94.39,-528186670.95000094,.
409000438620',2018-12-29,MICRO ATM WDL FEE DT28121,,2018-12-29,,221300.0,-527965370.95000094,.
409000438620',2018-12-29,MICRO ATM INC DATED 28121,,2018-12-29,,525.24,-527964845.71000093,.
409000438620',2018-12-29,MICRO ATM GST DATED 28121,,2018-12-29,,105.05,-527964740.6600009,.
409000438620',2018-12-29,Indiaforensic AEPS NPCI WDL SET,,2018-12-29,,850500.0,-527114240.6600009,.
409000438620',2018-12-29,CR836010126401/RMCPL26349/2,,2018-12-29,3500.0,,-527117740.6600009,.
409000438620',2018-12-29,CR835810650254/RMCPL09590/2,,2018-12-29,3000.0,,-527120740.6600009,.
409000438620',2018-12-29,CR835510955335/RMCPL28497/2,,2018-12-29,1000.0,,-527121740.6600009,.
409000438620',2018-12-29,FDRL/INTERNAL FUND TRANSFE,,2018-12-29,1000000.0,,-528121740.6600009,.
409000438620',2018-12-29,FDRL/INTERNAL FUND TRANSFE,,2018-12-29,500000.0,,-528621740.6600009,.
409000438620',2018-12-29,AEPS INC DT 28-12-2018 RO,,2018-12-29,,2109.32,-528619631.3400009,.
409000438620',2018-12-29,AEPS GST INC DT 28-12-201,,2018-12-29,,421.86,-528619209.4800009,.
409000438620',2018-12-29,AEPS ACQ CR ADJ FEES 2812,,2018-12-29,41.3,,-528619250.7800009,.
409000438620',2018-12-29,MICRO ATM WDL FEE DT29121,,2018-12-29,,226100.0,-528393150.7800009,.
409000438620',2018-12-29,MICRO ATM INC DATED 29121,,2018-12-29,,461.16,-528392689.6200009,.
409000438620',2018-12-29,MICRO ATM GST DATED 29121,,2018-12-29,,92.23,-528392597.3900009,.
409000438620',2018-12-31,Indiaforensic AEPS NPCI WDL SET,,2018-12-31,,791500.0,-527601097.3900009,.
409000438620',2018-12-31,Indiaforensic AEPS NPCI WDL SET,,2018-12-31,,410100.0,-527190997.3900009,.
409000438620',2018-12-31,FDRL/INTERNAL FUND TRANSFE,,2018-12-31,1000000.0,,-528190997.3900009,.
409000438620',2018-12-31,MICRO ATM WDL FEE DT29121,,2018-12-31,,302400.0,-527888597.3900009,.
409000438620',2018-12-31,MICRO ATM INC DATED 29121,,2018-12-31,,680.04,-527887917.35000086,.
409000438620',2018-12-31,MICRO ATM GST DATED 29121,,2018-12-31,,136.01,-527887781.34000087,.
409000438620',2018-12-31,MICRO ATM WDL FEE DT30121,,2018-12-31,,362400.0,-527525381.34000087,.
409000438620',2018-12-31,MICRO ATM INC DATED 30121,,2018-12-31,,806.04,-527524575.30000085,.
409000438620',2018-12-31,MICRO ATM GST DATED 30121,,2018-12-31,,161.21,-527524414.09000087,.
409000438620',2018-12-31,FDRL/INTERNAL FUND TRANSFE,,2018-12-31,1000000.0,,-528524414.09000087,.
409000438620',2018-12-31,AEPS INC DT 12-29-2018 RO,,2018-12-31,,1950.08,-528522464.0100009,.
409000438620',2018-12-31,AEPS GST INC DT 12-29-201,,2018-12-31,,390.02,-528522073.9900009,.
409000438620',2018-12-31,MICRO ATM WDL FEE DT31121,,2018-12-31,,218100.0,-528303973.9900009,.
409000438620',2018-12-31,MICRO ATM INC DATED 31121,,2018-12-31,,455.76,-528303518.2300009,.
409000438620',2018-12-31,MICRO ATM GST DATED 31121,,2018-12-31,,91.15,-528303427.08000094,.
409000438620',2018-12-31,AEPS INC DT 12-30-2018 RO,,2018-12-31,,1145.23,-528302281.8500009,.
409000438620',2018-12-31,AEPS GST INC DT 12-30-201,,2018-12-31,,229.05,-528302052.8000009,.
409000438620',2019-01-01,Indiaforensic AEPS NPCI WDL SET,,2019-01-01,,864200.0,-527437852.8000009,.
409000438620',2019-01-01,FDRL/INTERNAL FUND TRANSFE,,2019-01-01,1000000.0,,-528437852.8000009,.
409000438620',2019-01-01,MICRO ATM WDL FEE DT31121,,2019-01-01,,347500.0,-528090352.8000009,.
409000438620',2019-01-01,MICRO ATM INC DATED 31121,,2019-01-01,,777.24,-528089575.5600009,.
409000438620',2019-01-01,MICRO ATM GST DATED 31121,,2019-01-01,,155.45,-528089420.1100009,.
409000438620',2019-01-01,FDRL/INTERNAL FUND TRANSFE,,2019-01-01,500000.0,,-528589420.1100009,.
409000438620',2019-01-01,AEPS PAY Indiaforensic 3112,,2019-01-01,,489.41,-528588930.7000009,.
409000438620',2019-01-01,AEPS INC DT 31-12-2018 RO,,2019-01-01,,2250.15,-528586680.5500009,.
409000438620',2019-01-01,AEPS GST INC DT 31-12-201,,2019-01-01,,450.03,-528586230.52000093,.
409000438620',2019-01-01,AEPS ACQUIRING ADJ FEES 3,,2019-01-01,5.9,,-528586236.4200009,.
409000438620',2019-01-01,MICRO ATM WDL FEE DT01011,,2019-01-01,,115400.0,-528470836.4200009,.
409000438620',2019-01-01,MICRO ATM INC DATED 01011,,2019-01-01,,281.52,-528470554.90000093,.
409000438620',2019-01-01,MICRO ATM GST DATED 01011,,2019-01-01,,56.3,-528470498.6000009,.
409000438620',2019-01-02,Indiaforensic AEPS NPCI WDL SET,,2019-01-02,,736000.0,-527734498.6000009,.
409000438620',2019-01-02,FDRL/INTERNAL FUND TRANSFE,,2019-01-02,500000.0,,-528234498.6000009,.
409000438620',2019-01-02,MICRO ATM WDL FEE DT01011,,2019-01-02,,231300.0,-528003198.6000009,.
409000438620',2019-01-02,MICRO ATM INC DATED 01011,,2019-01-02,,490.68,-528002707.9200009,.
409000438620',2019-01-02,MICRO ATM GST DATED 01011,,2019-01-02,,98.14,-528002609.7800009,.
409000438620',2019-01-02,FDRL/INTERNAL FUND TRANSFE,,2019-01-02,500000.0,,-528502609.7800009,.
409000438620',2019-01-02,AEPS INC DT 01-01-2019 RO,,2019-01-02,,1891.3,-528500718.4800009,.
409000438620',2019-01-02,AEPS GST INC DT 01-01-201,,2019-01-02,,378.26,-528500340.2200009,.
409000438620',2019-01-02,CB836213625246/RMCPL20307/2,,2019-01-02,1000.0,,-528501340.2200009,.
409000438620',2019-01-02,MICRO ATM WDL FEE DT02011,,2019-01-02,,234000.0,-528267340.2200009,.
409000438620',2019-01-02,MICRO ATM INC DATED 02011,,2019-01-02,,454.68,-528266885.5400009,.
409000438620',2019-01-02,MICRO ATM GST DATED 02011,,2019-01-02,,90.94,-528266794.6000009,.
409000438620',2019-01-03,Indiaforensic AEPS NPCI WDL SET,,2019-01-03,,866200.0,-527400594.6000009,.
409000438620',2019-01-03,FDRL/INTERNAL FUND TRANSFE,,2019-01-03,1000000.0,,-528400594.6000009,.
409000438620',2019-01-03,MICRO ATM WDL FEE DT02011,,2019-01-03,,189400.0,-528211194.6000009,.
409000438620',2019-01-03,MICRO ATM INC DATED 02011,,2019-01-03,,477.0,-528210717.6000009,.
409000438620',2019-01-03,MICRO ATM GST DATED 02011,,2019-01-03,,95.4,-528210622.20000094,.
409000438620',2019-01-03,AEPS PAY Indiaforensic 0201,,2019-01-03,,69.41,-528210552.7900009,.
409000438620',2019-01-03,AEPS INC DT 02-01-2019 RO,,2019-01-03,,2160.97,-528208391.8200009,.
409000438620',2019-01-03,AEPS GST INC DT 02-01-201,,2019-01-03,,432.19,-528207959.6300009,.
409000438620',2019-01-03,MICRO ATM WDL FEE DT03011,,2019-01-03,,100300.0,-528107659.6300009,.
409000438620',2019-01-03,MICRO ATM INC DATED 03011,,2019-01-03,,295.92,-528107363.7100009,.
409000438620',2019-01-03,MICRO ATM GST DATED 03011,,2019-01-03,,59.18,-528107304.53000087,.
409000438620',2019-01-03,MAW/502964XXXXXX9583/NAGA,,2019-01-03,,1000.0,-528106304.53000087,.
409000438620',2019-01-04,MAW/502964XXXXXX2110/NAGA,,2019-01-04,,300.0,-528106004.53000087,.
409000438620',2019-01-04,Indiaforensic AEPS NPCI WDL SET,,2019-01-04,,795500.0,-527310504.53000087,.
409000438620',2019-01-04,CR836314871891/RMCPL26835/2,,2019-01-04,1000.0,,-527311504.53000087,.
409000438620',2019-01-04,CR836211585420/RMCPL22655/2,,2019-01-04,3000.0,,-527314504.53000087,.
409000438620',2019-01-04,CR836112382862/RMCPL09588/2,,2019-01-04,10000.0,,-527324504.53000087,.
409000438620',2019-01-04,FDRL/INTERNAL FUND TRANSFE,,2019-01-04,1000000.0,,-528324504.53000087,.
409000438620',2019-01-04,MAW/502964XXXXXX9466/NAGA,,2019-01-04,,300.0,-528324204.53000087,.
409000438620',2019-01-04,MICRO ATM WDL FEE DT03011,,2019-01-04,,179200.0,-528145004.53000087,.
409000438620',2019-01-04,MICRO ATM INC DATED 03011,,2019-01-04,,450.72,-528144553.81000084,.
409000438620',2019-01-04,MICRO ATM GST DATED 03011,,2019-01-04,,90.14,-528144463.67000085,.
409000438620',2019-01-04,MAW/502964XXXXXX1963/NAGA,,2019-01-04,,200.0,-528144263.67000085,.
409000438620',2019-01-04,AEPS INC DT 03-01-2019 RO,,2019-01-04,,1950.62,-528142313.05000085,.
409000438620',2019-01-04,AEPS GST INC DT 03-01-201,,2019-01-04,,390.12,-528141922.93000084,.
409000438620',2019-01-04,AEPS ACQ CR ADJ FEES 0301,,2019-01-04,41.3,,-528141964.23000085,.
409000438620',2019-01-04,MICRO ATM WDL FEE DT04011,,2019-01-04,,108000.0,-528033964.23000085,.
409000438620',2019-01-04,MICRO ATM INC DATED 04011,,2019-01-04,,278.28,-528033685.9500009,.
409000438620',2019-01-04,MICRO ATM GST DATED 04011,,2019-01-04,,55.66,-528033630.29000086,.
409000438620',2019-01-04,FDRL/INTERNAL FUND TRANSFE,,2019-01-04,500000.0,,-528533630.29000086,.
409000438620',2019-01-05,MAW/502964XXXXXX3522/NAGA,,2019-01-05,,500.0,-528533130.29000086,.
409000438620',2019-01-05,Indiaforensic AEPS NPCI WDL SET,,2019-01-05,,822500.0,-527710630.29000086,.
409000438620',2019-01-05,MICRO ATM WDL FEE DT04011,,2019-01-05,,249700.0,-527460930.29000086,.
409000438620',2019-01-05,MICRO ATM INC DATED 04011,,2019-01-05,,482.4,-527460447.8900009,.
409000438620',2019-01-05,MICRO ATM GST DATED 04011,,2019-01-05,,96.48,-527460351.41000086,.
409000438620',2019-01-05,FDRL/INTERNAL FUND TRANSFE,,2019-01-05,1000000.0,,-528460351.41000086,.
409000438620',2019-01-05,MAW/502964XXXXXX0254/NAGA,,2019-01-05,,1400.0,-528458951.41000086,.
409000438620',2019-01-05,AEPS INC DT 01-04-2019 RO,,2019-01-05,,1976.83,-528456974.5800009,.
409000438620',2019-01-05,AEPS GST INC DT 01-04-201,,2019-01-05,,395.37,-528456579.2100009,.
409000438620',2019-01-05,MAW/502964XXXXXX0821/NAGA,,2019-01-05,,300.0,-528456279.2100009,.
409000438620',2019-01-05,MICRO ATM WDL FEE DT05011,,2019-01-05,,104500.0,-528351779.2100009,.
409000438620',2019-01-05,MICRO ATM INC DATED 05011,,2019-01-05,,241.2,-528351538.0100009,.
409000438620',2019-01-05,MICRO ATM GST DATED 05011,,2019-01-05,,48.24,-528351489.7700009,.
409000438620',2019-01-07,FDRL/INTERNAL FUND TRANSFE,,2019-01-07,300000.0,,-528651489.7700009,.
409000438620',2019-01-07,Indiaforensic AEPS NPCI WDL SET,,2019-01-07,,624900.0,-528026589.7700009,.
409000438620',2019-01-07,Indiaforensic AEPS NPCI WDL SET,,2019-01-07,,499100.0,-527527489.7700009,.
409000438620',2019-01-07,CR836516379169/RMCPL12858/3,,2019-01-07,1000.0,,-527528489.7700009,.
409000438620',2019-01-07,FDRL/INTERNAL FUND TRANSFE,,2019-01-07,1000000.0,,-528528489.7700009,.
409000438620',2019-01-07,MAW/502964XXXXXX0296/NAGA,,2019-01-07,,1600.0,-528526889.7700009,.
409000438620',2019-01-07,MAW/502964XXXXXX8926/NAGA,,2019-01-07,,700.0,-528526189.7700009,.
409000438620',2019-01-07,MICRO ATM WDL FEE DT05011,,2019-01-07,,250700.0,-528275489.7700009,.
409000438620',2019-01-07,MICRO ATM INC DATED 05011,,2019-01-07,,548.64,-528274941.1300009,.
409000438620',2019-01-07,MICRO ATM GST DATED 05011,,2019-01-07,,109.73,-528274831.4000009,.
409000438620',2019-01-07,MICRO ATM WDL FEE DT06011,,2019-01-07,,153400.0,-528121431.4000009,.
409000438620',2019-01-07,MICRO ATM INC DATED 06011,,2019-01-07,,386.28,-528121045.1200009,.
409000438620',2019-01-07,MICRO ATM GST DATED 06011,,2019-01-07,,77.26,-528120967.8600009,.
409000438620',2019-01-07,AEPS INC DT 05-01-2019 RO,,2019-01-07,,1615.46,-528119352.40000093,.
409000438620',2019-01-07,AEPS GST INC DT 05-01-201,,2019-01-07,,323.09,-528119029.31000096,.
409000438620',2019-01-07,AEPS INC DT 06-01-2019 RO,,2019-01-07,,1312.36,-528117716.95000094,.
409000438620',2019-01-07,AEPS GST INC DT 06-01-201,,2019-01-07,,262.47,-528117454.4800009,.
409000438620',2019-01-07,MAW/502964XXXXXX8587/NAGA,,2019-01-07,,1600.0,-528115854.4800009,.
409000438620',2019-01-07,FDRL/INTERNAL FUND TRANSFE,,2019-01-07,500000.0,,-528615854.4800009,.
409000438620',2019-01-07,AEPS ACQ CR ADJ FEES 0501,,2019-01-07,5.9,,-528615860.3800009,.
409000438620',2019-01-07,MAW/502964XXXXXX9031/NAGA,,2019-01-07,,1400.0,-528614460.3800009,.
409000438620',2019-01-07,MICRO ATM WDL FEE DT07011,,2019-01-07,,73300.0,-528541160.3800009,.
409000438620',2019-01-07,MICRO ATM INC DATED 07011,,2019-01-07,,130.68,-528541029.7000009,.
409000438620',2019-01-07,MICRO ATM GST DATED 07011,,2019-01-07,,26.14,-528541003.5600009,.
409000438620',2019-01-08,Indiaforensic AEPS NPCI WDL SET,,2019-01-08,,778800.0,-527762203.5600009,.
409000438620',2019-01-08,FDRL/INTERNAL FUND TRANSFE,,2019-01-08,300000.0,,-528062203.5600009,.
409000438620',2019-01-08,FDRL/INTERNAL FUND TRANSFE,,2019-01-08,300000.0,,-528362203.5600009,.
409000438620',2019-01-08,AEPS INC DT 07-01-2019 RO,,2019-01-08,,1942.38,-528360261.1800009,.
409000438620',2019-01-08,AEPS GST INC DT 07-01-201,,2019-01-08,,388.48,-528359872.7000009,.
409000438620',2019-01-08,MICRO ATM WDL FEE DT08011,,2019-01-08,,71500.0,-528288372.7000009,.
409000438620',2019-01-08,MICRO ATM INC DATED 08011,,2019-01-08,,131.4,-528288241.3000009,.
409000438620',2019-01-08,MICRO ATM GST DATED 08011,,2019-01-08,,26.28,-528288215.02000093,.
409000438620',2019-01-09,Indiaforensic AEPS NPCI WDL SET,,2019-01-09,,1043000.0,-527245215.02000093,.
409000438620',2019-01-09,MICRO ATM WDL FEE DT08011,,2019-01-09,,129800.0,-527115415.02000093,.
409000438620',2019-01-09,MICRO ATM INC DATED 08011,,2019-01-09,,309.24,-527115105.7800009,.
409000438620',2019-01-09,MICRO ATM GST DATED 08011,,2019-01-09,,61.85,-527115043.9300009,.
409000438620',2019-01-09,FDRL/INTERNAL FUND TRANSFE,,2019-01-09,1000000.0,,-528115043.9300009,.
409000438620',2019-01-09,FDRL/INTERNAL FUND TRANSFE,,2019-01-09,500000.0,,-528615043.9300009,.
409000438620',2019-01-09,AEPS INC DT 08-01-2019 RO,,2019-01-09,,2527.13,-528612516.8000009,.
409000438620',2019-01-09,AEPS GST INC DT 08-01-201,,2019-01-09,,505.43,-528612011.3700009,.
409000438620',2019-01-09,MICRO ATM WDL FEE DT09011,,2019-01-09,,88700.0,-528523311.3700009,.
409000438620',2019-01-09,MICRO ATM INC DATED 09011,,2019-01-09,,162.72,-528523148.6500009,.
409000438620',2019-01-09,MICRO ATM GST DATED 09011,,2019-01-09,,32.54,-528523116.11000085,.
409000438620',2019-01-10,Indiaforensic AEPS NPCI WDL SET,,2019-01-10,,916000.0,-527607116.11000085,.
409000438620',2019-01-10,MICRO ATM WDL FEE DT09011,,2019-01-10,,141900.0,-527465216.11000085,.
409000438620',2019-01-10,MICRO ATM INC DATED 09011,,2019-01-10,,323.64,-527464892.47000086,.
409000438620',2019-01-10,MICRO ATM GST DATED 09011,,2019-01-10,,64.73,-527464827.74000084,.
409000438620',2019-01-10,FDRL/INTERNAL FUND TRANSFE,,2019-01-10,300000.0,,-527764827.74000084,.
409000438620',2019-01-10,FDRL/INTERNAL FUND TRANSFE,,2019-01-10,300000.0,,-528064827.74000084,.
409000438620',2019-01-10,FDRL/INTERNAL FUND TRANSFE,,2019-01-10,500000.0,,-528564827.74000084,.
409000438620',2019-01-10,MICRO ATM WDL FEE DT10011,,2019-01-10,,100600.0,-528464227.74000084,.
409000438620',2019-01-10,MICRO ATM INC DATED 10011,,2019-01-10,,182.16,-528464045.5800008,.
409000438620',2019-01-10,MICRO ATM GST DATED 10011,,2019-01-10,,36.43,-528464009.1500008,.
409000438620',2019-01-10,AEPS PAY Indiaforensic 0901,,2019-01-10,,99.64,-528463909.5100008,.
409000438620',2019-01-10,AEPS INC DT 01-09-2019 RO,,2019-01-10,,2278.9,-528461630.61000085,.
409000438620',2019-01-10,AEPS GST INC DT 01-09-201,,2019-01-10,,455.78,-528461174.8300009,.
409000438620',2019-01-11,Indiaforensic AEPS NPCI WDL SET,,2019-01-11,,773900.0,-527687274.8300009,.
409000438620',2019-01-11,FDRL/INTERNAL FUND TRANSFE,,2019-01-11,300000.0,,-527987274.8300009,.
409000438620',2019-01-11,FDRL/INTERNAL FUND TRANSFE,,2019-01-11,300000.0,,-528287274.8300009,.
409000438620',2019-01-11,FDRL/INTERNAL FUND TRANSFE,,2019-01-11,300000.0,,-528587274.8300009,.
409000438620',2019-01-11,MICRO ATM WDL FEE DT10011,,2019-01-11,,117900.0,-528469374.8300009,.
409000438620',2019-01-11,MICRO ATM INC DATED 10011,,2019-01-11,,284.76,-528469090.0700009,.
409000438620',2019-01-11,MICRO ATM GST DATED 10011,,2019-01-11,,56.95,-528469033.1200009,.
409000438620',2019-01-11,AEPS PAY Indiaforensic 1001,,2019-01-11,,278.24,-528468754.8800009,.
409000438620',2019-01-11,AEPS PAY Indiaforensic 0901,,2019-01-11,500.0,,-528469254.8800009,.
409000438620',2019-01-11,AEPS INC DT 10-01-2019 RO,,2019-01-11,,1737.25,-528467517.6300009,.
409000438620',2019-01-11,AEPS GST INC DT 10-01-201,,2019-01-11,,347.45,-528467170.1800009,.
409000438620',2019-01-11,MICRO ATM WDL FEE DT11011,,2019-01-11,,22400.0,-528444770.1800009,.
409000438620',2019-01-11,MICRO ATM INC DATED 11011,,2019-01-11,,37.44,-528444732.7400009,.
409000438620',2019-01-11,MICRO ATM GST DATED 11011,,2019-01-11,,7.49,-528444725.2500009,.
409000438620',2019-01-14,Indiaforensic AEPS NPCI WDL SET,,2019-01-14,,900200.0,-527544525.2500009,.
409000438620',2019-01-14,Indiaforensic AEPS NPCI WDL SET,,2019-01-14,,817900.0,-526726625.2500009,.
409000438620',2019-01-14,FDRL/INTERNAL FUND TRANSFE,,2019-01-14,1000000.0,,-527726625.2500009,.
409000438620',2019-01-14,FDRL/INTERNAL FUND TRANSFE,,2019-01-14,500000.0,,-528226625.2500009,.
409000438620',2019-01-14,Indiaforensic AEPS NPCI WDL SET,,2019-01-14,,363700.0,-527862925.2500009,.
409000438620',2019-01-14,FDRL/INTERNAL FUND TRANSFE,,2019-01-14,300000.0,,-528162925.2500009,.
409000438620',2019-01-14,FDRL/INTERNAL FUND TRANSFE,,2019-01-14,300000.0,,-528462925.2500009,.
409000438620',2019-01-14,AEPS PAY Indiaforensic 1101,,2019-01-14,,1998.52,-528460926.7300009,.
409000438620',2019-01-14,MICRO ATM WDL FEE DT11011,,2019-01-14,,101200.0,-528359726.7300009,.
409000438620',2019-01-14,MICRO ATM INC DATED 11011,,2019-01-14,,203.04,-528359523.6900009,.
409000438620',2019-01-14,MICRO ATM GST DATED 11011,,2019-01-14,,40.61,-528359483.0800009,.
409000438620',2019-01-14,AEPS INC DT 11-01-2019 RO,,2019-01-14,,2147.27,-528357335.8100009,.
409000438620',2019-01-14,AEPS GST INC DT 11-01-201,,2019-01-14,,429.45,-528356906.3600009,.
409000438620',2019-01-14,MICRO ATM WDL FEE DT13011,,2019-01-14,,203300.0,-528153606.3600009,.
409000438620',2019-01-14,MICRO ATM INC DATED 13011,,2019-01-14,,432.0,-528153174.3600009,.
409000438620',2019-01-14,MICRO ATM GST DATED 13011,,2019-01-14,,86.4,-528153087.96000093,.
409000438620',2019-01-14,AEPS INC DT 12-01-2019 RO,,2019-01-14,,1987.09,-528151100.87000096,.
409000438620',2019-01-14,AEPS GST INC DT 12-01-201,,2019-01-14,,397.42,-528150703.45000094,.
409000438620',2019-01-14,AEPS INC DT 13-01-2019 RO,,2019-01-14,,906.86,-528149796.5900009,.
409000438620',2019-01-14,AEPS GST INC DT 13-01-201,,2019-01-14,,181.37,-528149615.2200009,.
409000438620',2019-01-14,MICRO ATM WDL FEE DT14011,,2019-01-14,,87500.0,-528062115.2200009,.
409000438620',2019-01-14,MICRO ATM INC DATED 14011,,2019-01-14,,199.44,-528061915.7800009,.
409000438620',2019-01-14,MICRO ATM GST DATED 14011,,2019-01-14,,39.89,-528061875.89000094,.
409000438620',2019-01-14,FDRL/INTERNAL FUND TRANSFE,,2019-01-14,300000.0,,-528361875.89000094,.
409000438620',2019-01-14,MICRO ATM WDL FEE DT12011,,2019-01-14,,260300.0,-528101575.89000094,.
409000438620',2019-01-14,MICRO ATM INC DATED 12011,,2019-01-14,,531.72,-528101044.1700009,.
409000438620',2019-01-14,MICRO ATM GST DATED 12011,,2019-01-14,,106.34,-528100937.83000094,.
409000438620',2019-01-15,Indiaforensic AEPS NPCI WDL SET,,2019-01-15,,545600.0,-527555337.83000094,.
409000438620',2019-01-15,FDRL/INTERNAL FUND TRANSFE,,2019-01-15,1000000.0,,-528555337.83000094,.
409000438620',2019-01-15,MICRO ATM WDL FEE DT14011,,2019-01-15,,88600.0,-528466737.83000094,.
409000438620',2019-01-15,MICRO ATM INC DATED 14011,,2019-01-15,,237.96,-528466499.87000096,.
409000438620',2019-01-15,MICRO ATM GST DATED 14011,,2019-01-15,,47.59,-528466452.280001,.
409000438620',2019-01-15,AEPS PAY Indiaforensic 1401,,2019-01-15,,499.4,-528465952.880001,.
409000438620',2019-01-15,MICRO ATM WDL FEE DT15011,,2019-01-15,,59700.0,-528406252.880001,.
409000438620',2019-01-15,MICRO ATM INC DATED 15011,,2019-01-15,,121.32,-528406131.560001,.
409000438620',2019-01-15,MICRO ATM GST DATED 15011,,2019-01-15,,24.26,-528406107.300001,.
409000438620',2019-01-15,AEPS INC DT 14-01-2019 RO,,2019-01-15,,1357.19,-528404750.110001,.
409000438620',2019-01-15,AEPS GST INC DT 14-01-201,,2019-01-15,,271.44,-528404478.67000103,.
409000438620',2019-01-16,Indiaforensic AEPS NPCI WDL SET,,2019-01-16,,538800.0,-527865678.67000103,.
409000438620',2019-01-16,MICRO ATM WDL FEE DT15011,,2019-01-16,,117500.0,-527748178.67000103,.
409000438620',2019-01-16,MICRO ATM INC DATED 15011,,2019-01-16,,252.0,-527747926.67000103,.
409000438620',2019-01-16,MICRO ATM GST DATED 15011,,2019-01-16,,50.4,-527747876.27000105,.
409000438620',2019-01-16,FDRL/INTERNAL FUND TRANSFE,,2019-01-16,500000.0,,-528247876.27000105,.
409000438620',2019-01-16,FDRL/INTERNAL FUND TRANSFE,,2019-01-16,400000.0,,-528647876.27000105,.
409000438620',2019-01-16,MICRO ATM WDL FEE DT16011,,2019-01-16,,80400.0,-528567476.27000105,.
409000438620',2019-01-16,MICRO ATM INC DATED 16011,,2019-01-16,,162.72,-528567313.550001,.
409000438620',2019-01-16,MICRO ATM GST DATED 16011,,2019-01-16,,32.54,-528567281.010001,.
409000438620',2019-01-16,AEPS INC DT 15-01-2019 RO,,2019-01-16,,1427.02,-528565853.990001,.
409000438620',2019-01-16,AEPS GST INC DT 15-01-201,,2019-01-16,,285.4,-528565568.59000105,.
409000438620',2019-01-16,NPCI SETELEMENT DIFF_1501,,2019-01-16,,20000.0,-528545568.59000105,.
409000438620',2019-01-17,Indiaforensic AEPS NPCI WDL SET,,2019-01-17,,746300.0,-527799268.59000105,.
409000438620',2019-01-17,CR901316468550/RMCPL13238/1,,2019-01-17,1000.0,,-527800268.59000105,.
409000438620',2019-01-17,CR901316474850/RMCPL21953/1,,2019-01-17,500.0,,-527800768.59000105,.
409000438620',2019-01-17,CR901316478016/RMCPL25681/1,,2019-01-17,1000.0,,-527801768.59000105,.
409000438620',2019-01-17,CR901317479499/RMCPL25681/1,,2019-01-17,1000.0,,-527802768.59000105,.
409000438620',2019-01-17,CR901012727542/RMCPL12747/1,,2019-01-17,1500.0,,-527804268.59000105,.
409000438620',2019-01-17,CR900815280575/RMCPL29047/0,,2019-01-17,3000.0,,-527807268.59000105,.
409000438620',2019-01-17,CR900817313748/RMCPL12455/0,,2019-01-17,500.0,,-527807768.59000105,.
409000438620',2019-01-17,CR900619868338/RMCPL28235/0,,2019-01-17,1000.0,,-527808768.59000105,.
409000438620',2019-01-17,CR900615811005/RMCPL28153/0,,2019-01-17,5000.0,,-527813768.59000105,.
409000438620',2019-01-17,CR900615812281/RMCPL27841/0,,2019-01-17,500.0,,-527814268.59000105,.
409000438620',2019-01-17,CR900616813784/RMCPL18574/0,,2019-01-17,600.0,,-527814868.59000105,.
409000438620',2019-01-17,CR900616815141/RMCPL18215/0,,2019-01-17,1500.0,,-527816368.59000105,.
409000438620',2019-01-17,CR900616815860/RMCPL18656/0,,2019-01-17,500.0,,-527816868.59000105,.
409000438620',2019-01-17,CR900616816878/RMCPL25123/0,,2019-01-17,700.0,,-527817568.59000105,.
409000438620',2019-01-17,CR900620880102/RMCPL12909/0,,2019-01-17,10000.0,,-527827568.59000105,.
409000438620',2019-01-17,FDRL/INTERNAL FUND TRANSFE,,2019-01-17,400000.0,,-528227568.59000105,.
409000438620',2019-01-17,FDRL/INTERNAL FUND TRANSFE,,2019-01-17,400000.0,,-528627568.59000105,.
409000438620',2019-01-17,MATM TRN CHARGE JUNE16-DE,,2019-01-17,9710101.0,,-538337669.5900011,.
409000438620',2019-01-17,MATM TRN CHARGE JAN18-MAY,,2019-01-17,1917937.0,,-540255606.5900011,.
409000438620',2019-01-17,MICRO ATM WDL FEE DT16011,,2019-01-17,,126600.0,-540129006.5900011,.
409000438620',2019-01-17,MICRO ATM INC DATED 16011,,2019-01-17,,284.04,-540128722.5500011,.
409000438620',2019-01-17,MICRO ATM GST DATED 16011,,2019-01-17,,56.81,-540128665.7400012,.
409000438620',2019-01-17,AEPS INC DT 16-01-2019 RO,,2019-01-17,,1806.92,-540126858.8200012,.
409000438620',2019-01-17,AEPS GST INC DT 16-01-201,,2019-01-17,,361.38,-540126497.4400012,.
409000438620',2019-01-17,AEPS ACQ CR ADJ FEES 1501,,2019-01-17,113.87,,-540126611.3100013,.
409000438620',2019-01-17,MICRO ATM WDL FEE DT17011,,2019-01-17,,76400.0,-540050211.3100013,.
409000438620',2019-01-17,MICRO ATM INC DATED 17011,,2019-01-17,,171.0,-540050040.3100013,.
409000438620',2019-01-17,MICRO ATM GST DATED 17011,,2019-01-17,,34.2,-540050006.1100012,.
409000438620',2019-01-18,Indiaforensic AEPS NPCI WDL SET,,2019-01-18,,581400.0,-539468606.1100012,.
409000438620',2019-01-18,FDRL/INTERNAL FUND TRANSFE,,2019-01-18,400000.0,,-539868606.1100012,.
409000438620',2019-01-18,FDRL/INTERNAL FUND TRANSFE,,2019-01-18,400000.0,,-540268606.1100012,.
409000438620',2019-01-18,MICRO ATM WDL FEE DT17011,,2019-01-18,,113000.0,-540155606.1100012,.
409000438620',2019-01-18,MICRO ATM INC DATED 17011,,2019-01-18,,239.76,-540155366.3500012,.
409000438620',2019-01-18,MICRO ATM GST DATED 17011,,2019-01-18,,47.95,-540155318.4000012,.
409000438620',2019-01-18,AEPS PAY Indiaforensic 1701,,2019-01-18,,1675.42,-540153642.9800012,.
409000438620',2019-01-18,MICRO ATM WDL FEE DT18011,,2019-01-18,,48000.0,-540105642.9800012,.
409000438620',2019-01-18,MICRO ATM INC DATED 18011,,2019-01-18,,108.0,-540105534.9800012,.
409000438620',2019-01-18,MICRO ATM GST DATED 18011,,2019-01-18,,21.6,-540105513.3800012,.
409000438620',2019-01-18,AEPS INC DT 17-01-2019 RO,,2019-01-18,,1400.54,-540104112.8400012,.
409000438620',2019-01-18,AEPS GST INC DT 17-01-201,,2019-01-18,,280.11,-540103832.7300012,.
409000438620',2019-01-19,Indiaforensic AEPS NPCI WDL SET,,2019-01-19,,766800.0,-539337032.7300012,.
409000438620',2019-01-19,MAW/502964XXXXXX7517/NAGA,,2019-01-19,,500.0,-539336532.7300012,.
409000438620',2019-01-19,FDRL/INTERNAL FUND TRANSFE,,2019-01-19,400000.0,,-539736532.7300012,.
409000438620',2019-01-19,FDRL/INTERNAL FUND TRANSFE,,2019-01-19,500000.0,,-540236532.7300012,.
409000438620',2019-01-19,MICRO ATM WDL FEE DT18011,,2019-01-19,,131900.0,-540104632.7300012,.
409000438620',2019-01-19,MICRO ATM INC DATED 18011,,2019-01-19,,275.04,-540104357.6900012,.
409000438620',2019-01-19,MICRO ATM GST DATED 18011,,2019-01-19,,55.01,-540104302.6800013,.
409000438620',2019-01-19,AEPS PAY Indiaforensic 1801,,2019-01-19,,5595.91,-540098706.7700013,.
409000438620',2019-01-19,AEPS INC DT 18-01-2019 RO,,2019-01-19,,2029.87,-540096676.9000013,.
409000438620',2019-01-19,AEPS GST INC DT 18-01-201,,2019-01-19,,405.97,-540096270.9300013,.
409000438620',2019-01-19,MAW/502964XXXXXX7973/NAGA,,2019-01-19,,1700.0,-540094570.9300013,.
409000438620',2019-01-19,MAW/502964XXXXXX0486/NAGA,,2019-01-19,,2000.0,-540092570.9300013,.
409000438620',2019-01-19,MICRO ATM WDL FEE DT19011,,2019-01-19,,124500.0,-539968070.9300013,.
409000438620',2019-01-19,MICRO ATM INC DATED 19011,,2019-01-19,,216.0,-539967854.9300013,.
409000438620',2019-01-19,MICRO ATM GST DATED 19011,,2019-01-19,,43.2,-539967811.7300012,.
409000438620',2019-01-21,Indiaforensic AEPS NPCI WDL SET,,2019-01-21,,649900.0,-539317911.7300012,.
409000438620',2019-01-21,Indiaforensic AEPS NPCI WDL SET,,2019-01-21,,403700.0,-538914211.7300012,.
409000438620',2019-01-21,CR901414674150/RMCPL28015/1,,2019-01-21,2000.0,,-538916211.7300012,.
409000438620',2019-01-21,FDRL/INTERNAL FUND TRANSFE,,2019-01-21,300000.0,,-539216211.7300012,.
409000438620',2019-01-21,FDRL/INTERNAL FUND TRANSFE,,2019-01-21,1000000.0,,-540216211.7300012,.
409000438620',2019-01-21,MAW/502964XXXXXX3498/NAGA,,2019-01-21,,2000.0,-540214211.7300012,.
409000438620',2019-01-21,MICRO ATM WDL FEE DT19011,,2019-01-21,,118400.0,-540095811.7300012,.
409000438620',2019-01-21,MICRO ATM INC DATED 19011,,2019-01-21,,297.36,-540095514.3700012,.
409000438620',2019-01-21,MICRO ATM GST DATED 19011,,2019-01-21,,59.47,-540095454.9000012,.
409000438620',2019-01-21,MICRO ATM WDL FEE DT20011,,2019-01-21,,179600.0,-539915854.9000012,.
409000438620',2019-01-21,MICRO ATM INC DATED 20011,,2019-01-21,,410.76,-539915444.1400012,.
409000438620',2019-01-21,MICRO ATM GST DATED 20011,,2019-01-21,,82.15,-539915361.9900012,.
409000438620',2019-01-21,MAW/502964XXXXXX0452/NAGA,,2019-01-21,,1600.0,-539913761.9900012,.
409000438620',2019-01-21,AEPS PAY Indiaforensic 2001,,2019-01-21,,1147.74,-539912614.2500012,.
409000438620',2019-01-21,FDRL/INTERNAL FUND TRANSFE,,2019-01-21,300000.0,,-540212614.2500012,.
409000438620',2019-01-21,MICRO ATM WDL FEE DT21011,,2019-01-21,,81500.0,-540131114.2500012,.
409000438620',2019-01-21,MICRO ATM INC DATED 21011,,2019-01-21,,160.2,-540130954.0500011,.
409000438620',2019-01-21,MICRO ATM GST DATED 21011,,2019-01-21,,32.04,-540130922.0100012,.
409000438620',2019-01-21,AEPS INC DT 19-01-2019 RO,,2019-01-21,,1623.99,-540129298.0200012,.
409000438620',2019-01-21,AEPS GST INC DT 19-01-201,,2019-01-21,,324.8,-540128973.2200012,.
409000438620',2019-01-21,AEPS ACQ CR ADJ FEES 1901,,2019-01-21,11.8,,-540128985.0200012,.
409000438620',2019-01-21,AEPS INC DT 20-01-2019 RO,,2019-01-21,,1076.35,-540127908.6700011,.
409000438620',2019-01-21,AEPS GST INC DT 20-01-201,,2019-01-21,,215.27,-540127693.4000012,.
409000438620',2019-01-22,Indiaforensic AEPS NPCI WDL SET,,2019-01-22,,775600.0,-539352093.4000012,.
409000438620',2019-01-22,FDRL/INTERNAL FUND TRANSFE,,2019-01-22,500000.0,,-539852093.4000012,.
409000438620',2019-01-22,FDRL/INTERNAL FUND TRANSFE,,2019-01-22,400000.0,,-540252093.4000012,.
409000438620',2019-01-22,MICRO ATM WDL FEE DT21011,,2019-01-22,,125600.0,-540126493.4000012,.
409000438620',2019-01-22,MICRO ATM INC DATED 21011,,2019-01-22,,342.36,-540126151.0400012,.
409000438620',2019-01-22,MICRO ATM GST DATED 21011,,2019-01-22,,68.47,-540126082.5700011,.
409000438620',2019-01-22,AEPS INC DT 21-01-2019 RO,,2019-01-22,,1945.88,-540124136.6900011,.
409000438620',2019-01-22,AEPS GST INC DT 21-01-201,,2019-01-22,,389.18,-540123747.5100012,.
409000438620',2019-01-22,MICRO ATM WDL FEE DT22011,,2019-01-22,,50000.0,-540073747.5100012,.
409000438620',2019-01-22,MICRO ATM INC DATED 22011,,2019-01-22,,133.2,-540073614.3100011,.
409000438620',2019-01-22,MICRO ATM GST DATED 22011,,2019-01-22,,26.64,-540073587.6700011,.
409000438620',2019-01-23,Indiaforensic AEPS NPCI WDL SET,,2019-01-23,,706700.0,-539366887.6700011,.
409000438620',2019-01-23,MICRO ATM WDL FEE DT22011,,2019-01-23,,155000.0,-539211887.6700011,.
409000438620',2019-01-23,MICRO ATM INC DATED 22011,,2019-01-23,,331.56,-539211556.1100012,.
409000438620',2019-01-23,MICRO ATM GST DATED 22011,,2019-01-23,,66.31,-539211489.8000013,.
409000438620',2019-01-23,FDRL/INTERNAL FUND TRANSFE,,2019-01-23,1000000.0,,-540211489.8000013,.
409000438620',2019-01-23,AEPS PAY Indiaforensic 2201,,2019-01-23,,199.58,-540211290.2200012,.
409000438620',2019-01-23,MICRO ATM WDL FEE DT23011,,2019-01-23,,66300.0,-540144990.2200012,.
409000438620',2019-01-23,MICRO ATM INC DATED 23011,,2019-01-23,,143.28,-540144846.9400012,.
409000438620',2019-01-23,MICRO ATM GST DATED 23011,,2019-01-23,,28.66,-540144818.2800013,.
409000438620',2019-01-23,AEPS INC DT 22-01-2019 RO,,2019-01-23,,1745.36,-540143072.9200013,.
409000438620',2019-01-23,AEPS GST INC DT 22-01-201,,2019-01-23,,349.07,-540142723.8500012,.
409000438620',2019-01-24,Indiaforensic AEPS NPCI WDL SET,,2019-01-24,,654900.0,-539487823.8500012,.
409000438620',2019-01-24,CR902013964473/RMCPL29770/2,,2019-01-24,3500.0,,-539491323.8500012,.
409000438620',2019-01-24,FDRL/INTERNAL FUND TRANSFE,,2019-01-24,300000.0,,-539791323.8500012,.
409000438620',2019-01-24,FDRL/INTERNAL FUND TRANSFE,,2019-01-24,400000.0,,-540191323.8500012,.
409000438620',2019-01-24,MICRO ATM WDL FEE DT23011,,2019-01-24,,97400.0,-540093923.8500012,.
409000438620',2019-01-24,MICRO ATM INC DATED 23011,,2019-01-24,,237.24,-540093686.6100012,.
409000438620',2019-01-24,MICRO ATM GST DATED 23011,,2019-01-24,,47.45,-540093639.1600012,.
409000438620',2019-01-24,MICRO ATM WDL FEE DT24011,,2019-01-24,,103900.0,-539989739.1600012,.
409000438620',2019-01-24,MICRO ATM INC DATED 24011,,2019-01-24,,221.04,-539989518.1200012,.
409000438620',2019-01-24,MICRO ATM GST DATED 24011,,2019-01-24,,44.21,-539989473.9100012,.
409000438620',2019-01-24,AEPS INC DT 23-01-2019 RO,,2019-01-24,,1629.87,-539987844.0400012,.
409000438620',2019-01-24,AEPS GST INC DT 23-01-201,,2019-01-24,,325.97,-539987518.0700011,.
409000438620',2019-01-24,AEPS ACQ CR ADJ FEES 2301,,2019-01-24,17.7,,-539987535.7700012,.
409000438620',2019-01-24,NFS SETTELMENT DIFF_22011,,2019-01-24,12000.0,,-539999535.7700012,.
409000438620',2019-01-25,Indiaforensic AEPS NPCI WDL SET,,2019-01-25,,630600.0,-539368935.7700012,.
409000438620',2019-01-25,NFS SETTELMENT DIFF_22011,,2019-01-25,,12000.0,-539356935.7700012,.
409000438620',2019-01-25,FDRL/INTERNAL FUND TRANSFE,,2019-01-25,500000.0,,-539856935.7700012,.
409000438620',2019-01-25,FDRL/INTERNAL FUND TRANSFE,,2019-01-25,400000.0,,-540256935.7700012,.
409000438620',2019-01-25,MICRO ATM WDL FEE DT24011,,2019-01-25,,117200.0,-540139735.7700012,.
409000438620',2019-01-25,MICRO ATM INC DATED 24011,,2019-01-25,,269.64,-540139466.1300012,.
409000438620',2019-01-25,MICRO ATM GST DATED 24011,,2019-01-25,,53.93,-540139412.2000012,.
409000438620',2019-01-25,AEPS INC DT 24-01-2019 RO,,2019-01-25,,1577.14,-540137835.0600013,.
409000438620',2019-01-25,AEPS GST INC DT 24-01-201,,2019-01-25,,315.43,-540137519.6300013,.
409000438620',2019-01-25,MICRO ATM WDL FEE DT25011,,2019-01-25,,120200.0,-540017319.6300013,.
409000438620',2019-01-25,MICRO ATM INC DATED 25011,,2019-01-25,,229.32,-540017090.3100013,.
409000438620',2019-01-25,MICRO ATM GST DATED 25011,,2019-01-25,,45.86,-540017044.4500012,.
409000438620',2019-01-25,NFS SETTELMENT DIFF_22011,,2019-01-25,,12000.0,-540005044.4500012,.
409000438620',2019-01-28,MAW/502964XXXXXX9796/NAGA,,2019-01-28,,200.0,-540004844.4500012,.
409000438620',2019-01-28,Indiaforensic AEPS NPCI WDL SET,,2019-01-28,,726600.0,-539278244.4500012,.
409000438620',2019-01-28,Indiaforensic AEPS NPCI WDL SET,,2019-01-28,,375100.0,-538903144.4500012,.
409000438620',2019-01-28,MAW/502964XXXXXX3506/NAGA,,2019-01-28,,500.0,-538902644.4500012,.
409000438620',2019-01-28,Indiaforensic AEPS NPCI WDL SET,,2019-01-28,,340900.0,-538561744.4500012,.
409000438620',2019-01-28,MAW/502964XXXXXX1757/NAGA,,2019-01-28,,500.0,-538561244.4500012,.
409000438620',2019-01-28,FDRL/INTERNAL FUND TRANSFE,,2019-01-28,1000000.0,,-539561244.4500012,.
409000438620',2019-01-28,FDRL/INTERNAL FUND TRANSFE,,2019-01-28,400000.0,,-539961244.4500012,.
409000438620',2019-01-28,FDRL/INTERNAL FUND TRANSFE,,2019-01-28,300000.0,,-540261244.4500012,.
409000438620',2019-01-28,MICRO ATM WDL FEE DT25011,,2019-01-28,,129500.0,-540131744.4500012,.
409000438620',2019-01-28,MICRO ATM INC DATED 25011,,2019-01-28,,236.16,-540131508.2900013,.
409000438620',2019-01-28,MICRO ATM GST DATED 25011,,2019-01-28,,47.23,-540131461.0600013,.
409000438620',2019-01-28,MICRO ATM WDL FEE DT26011,,2019-01-28,,144400.0,-539987061.0600013,.
409000438620',2019-01-28,MICRO ATM INC DATED 26011,,2019-01-28,,285.84,-539986775.2200012,.
409000438620',2019-01-28,MICRO ATM GST DATED 26011,,2019-01-28,,57.17,-539986718.0500013,.
409000438620',2019-01-28,AEPS PAY Indiaforensic 2701,,2019-01-28,,1998.52,-539984719.5300013,.
409000438620',2019-01-28,AEPS PAY Indiaforensic 2501,,2019-01-28,,499.11,-539984220.4200013,.
409000438620',2019-01-28,FDRL/INTERNAL FUND TRANSFE,,2019-01-28,300000.0,,-540284220.4200013,.
409000438620',2019-01-28,AEPS INC DT 25-01-2019 RO,,2019-01-28,,1853.94,-540282366.4800012,.
409000438620',2019-01-28,AEPS GST INC DT 25-01-201,,2019-01-28,,370.79,-540281995.6900012,.
409000438620',2019-01-28,AEPS INC DT 26-01-2019 RO,,2019-01-28,,1016.69,-540280979.0000012,.
409000438620',2019-01-28,AEPS GST INC DT 26-01-201,,2019-01-28,,203.34,-540280775.6600012,.
409000438620',2019-01-28,AEPS INC DT 27-01-2019 RO,,2019-01-28,,962.96,-540279812.7000011,.
409000438620',2019-01-28,AEPS GST INC DT 27-01-201,,2019-01-28,,192.59,-540279620.1100011,.
409000438620',2019-01-28,MICRO ATM WDL FEE DT27011,,2019-01-28,,102700.0,-540176920.1100011,.
409000438620',2019-01-28,MICRO ATM INC DATED 27011,,2019-01-28,,229.32,-540176690.790001,.
409000438620',2019-01-28,MICRO ATM GST DATED 27011,,2019-01-28,,45.86,-540176644.930001,.
409000438620',2019-01-28,MICRO ATM WDL FEE DT28011,,2019-01-28,,49200.0,-540127444.930001,.
409000438620',2019-01-28,MICRO ATM INC DATED 28011,,2019-01-28,,129.24,-540127315.690001,.
409000438620',2019-01-28,MICRO ATM GST DATED 28011,,2019-01-28,,25.85,-540127289.840001,.
409000438620',2019-01-29,Indiaforensic AEPS NPCI WDL SET,,2019-01-29,,701800.0,-539425489.840001,.
409000438620',2019-01-29,MAW/502964XXXXXX8975/NAGA,,2019-01-29,,400.0,-539425089.840001,.
409000438620',2019-01-29,FDRL/INTERNAL FUND TRANSFE,,2019-01-29,400000.0,,-539825089.840001,.
409000438620',2019-01-29,FDRL/INTERNAL FUND TRANSFE,,2019-01-29,400000.0,,-540225089.840001,.
409000438620',2019-01-29,AEPS PAY Indiaforensic 2801,,2019-01-29,,499.11,-540224590.730001,.
409000438620',2019-01-29,MICRO ATM WDL FEE DT28011,,2019-01-29,,160600.0,-540063990.730001,.
409000438620',2019-01-29,MICRO ATM INC DATED 28011,,2019-01-29,,321.84,-540063668.8900009,.
409000438620',2019-01-29,MICRO ATM GST DATED 28011,,2019-01-29,,64.37,-540063604.5200009,.
409000438620',2019-01-29,MICRO ATM WDL FEE DT29011,,2019-01-29,,75000.0,-539988604.5200009,.
409000438620',2019-01-29,MICRO ATM INC DATED 29011,,2019-01-29,,157.32,-539988447.2000009,.
409000438620',2019-01-29,MICRO ATM GST DATED 29011,,2019-01-29,,31.46,-539988415.7400008,.
409000438620',2019-01-29,AEPS INC DT 28-01-2019 RO,,2019-01-29,,1792.67,-539986623.0700009,.
409000438620',2019-01-29,AEPS GST INC DT 28-01-201,,2019-01-29,,358.53,-539986264.5400009,.
409000438620',2019-01-30,Indiaforensic AEPS NPCI WDL SET,,2019-01-30,,869500.0,-539116764.5400009,.
409000438620',2019-01-30,FDRL/INTERNAL FUND TRANSFE,,2019-01-30,400000.0,,-539516764.5400009,.
409000438620',2019-01-30,FDRL/INTERNAL FUND TRANSFE,,2019-01-30,400000.0,,-539916764.5400009,.
409000438620',2019-01-30,FDRL/INTERNAL FUND TRANSFE,,2019-01-30,300000.0,,-540216764.5400009,.
409000438620',2019-01-30,MICRO ATM WDL FEE DT29011,,2019-01-30,,153400.0,-540063364.5400009,.
409000438620',2019-01-30,MICRO ATM INC DATED 29011,,2019-01-30,,352.44,-540063012.1000009,.
409000438620',2019-01-30,MICRO ATM GST DATED 29011,,2019-01-30,,70.49,-540062941.6100008,.
409000438620',2019-01-30,AEPS INC DT 29-01-2019 RO,,2019-01-30,,2001.4,-540060940.2100009,.
409000438620',2019-01-30,AEPS GST INC DT 29-01-201,,2019-01-30,,400.28,-540060539.9300009,.
409000438620',2019-01-30,MICRO ATM WDL FEE DT30011,,2019-01-30,,42500.0,-540018039.9300009,.
409000438620',2019-01-30,MICRO ATM INC DATED 30011,,2019-01-30,,77.4,-540017962.5300009,.
409000438620',2019-01-30,MICRO ATM GST DATED 30011,,2019-01-30,,15.48,-540017947.0500009,.
409000438620',2019-01-30,TRF TO  Indiaforensic SERVICES I,,2019-01-30,200000.0,,-540217947.0500009,.
409000438620',2019-01-31,Indiaforensic AEPS NPCI WDL SET,,2019-01-31,,728200.0,-539489747.0500009,.
409000438620',2019-01-31,CR902410742880/RMCPL20143/2,,2019-01-31,500.0,,-539490247.0500009,.
409000438620',2019-01-31,FDRL/INTERNAL FUND TRANSFE,,2019-01-31,400000.0,,-539890247.0500009,.
409000438620',2019-01-31,FDRL/INTERNAL FUND TRANSFE,,2019-01-31,300000.0,,-540190247.0500009,.
409000438620',2019-01-31,DMT(BC)FEESJUNE-SEP-1TO12,,2019-01-31,5960.0,,-540196207.0500009,.
409000438620',2019-01-31,BC SER GST JUNE-SEP-1TO12,,2019-01-31,1072.8,,-540197279.8500009,.
409000438620',2019-01-31,MICRO ATM WDL FEE DT30011,,2019-01-31,,150100.0,-540047179.8500009,.
409000438620',2019-01-31,MICRO ATM INC DATED 30011,,2019-01-31,,353.16,-540046826.6900009,.
409000438620',2019-01-31,MICRO ATM GST DATED 30011,,2019-01-31,,70.63,-540046756.0600009,.
409000438620',2019-01-31,AEPS INC DT 30-01-2019 RO,,2019-01-31,,1720.41,-540045035.6500009,.
409000438620',2019-01-31,AEPS GST INC DT 30-01-201,,2019-01-31,,344.08,-540044691.5700009,.
409000438620',2019-01-31,AEPS ACQ CR ADJ FEES 2901,,2019-01-31,2.95,,-540044694.5200009,.
409000438620',2019-01-31,MICRO ATM WDL FEE DT31011,,2019-01-31,,96000.0,-539948694.5200009,.
409000438620',2019-01-31,MICRO ATM INC DATED 31011,,2019-01-31,,205.56,-539948488.960001,.
409000438620',2019-01-31,MICRO ATM GST DATED 31011,,2019-01-31,,41.11,-539948447.850001,.
409000438620',2019-01-31,FDRL/INTERNAL FUND TRANSFE,,2019-01-31,300000.0,,-540248447.850001,.
409000438620',2019-02-01,Indiaforensic AEPS NPCI WDL SET,,2019-02-01,,732000.0,-539516447.850001,.
409000438620',2019-02-01,MAW/502964XXXXXX7981/NAGA,,2019-02-01,,100.0,-539516347.850001,.
409000438620',2019-02-01,FDRL/INTERNAL FUND TRANSFE,,2019-02-01,400000.0,,-539916347.850001,.
409000438620',2019-02-01,FDRL/INTERNAL FUND TRANSFE,,2019-02-01,300000.0,,-540216347.850001,.
409000438620',2019-02-01,AEPS INC DT 31-01-2019 RO,,2019-02-01,,1791.69,-540214556.1600009,.
409000438620',2019-02-01,AEPS GST INC DT 31-01-201,,2019-02-01,,358.34,-540214197.8200009,.
409000438620',2019-02-01,MICRO ATM WDL FEE DT31011,,2019-02-01,,124100.0,-540090097.8200009,.
409000438620',2019-02-01,MICRO ATM INC DATED 31011,,2019-02-01,,271.8,-540089826.0200009,.
409000438620',2019-02-01,MICRO ATM GST DATED 31011,,2019-02-01,,54.36,-540089771.6600009,.
409000438620',2019-02-01,MICRO ATM WDL FEE DT01021,,2019-02-01,,119400.0,-539970371.6600009,.
409000438620',2019-02-01,MICRO ATM INC DATED 01021,,2019-02-01,,207.36,-539970164.3000009,.
409000438620',2019-02-01,MICRO ATM GST DATED 01021,,2019-02-01,,41.47,-539970122.8300009,.
409000438620',2019-02-01,FDRL/INTERNAL FUND TRANSFE,,2019-02-01,300000.0,,-540270122.8300009,.
409000438620',2019-02-02,Indiaforensic AEPS NPCI WDL SET,,2019-02-02,,918400.0,-539351722.8300009,.
409000438620',2019-02-02,CR902913632012/RMCPL24552/2,,2019-02-02,10000.0,,-539361722.8300009,.
409000438620',2019-02-02,CR902918679654/RMCPL15696/2,,2019-02-02,500.0,,-539362222.8300009,.
409000438620',2019-02-02,FDRL/INTERNAL FUND TRANSFE,,2019-02-02,300000.0,,-539662222.8300009,.
409000438620',2019-02-02,FDRL/INTERNAL FUND TRANSFE,,2019-02-02,300000.0,,-539962222.8300009,.
409000438620',2019-02-02,FDRL/INTERNAL FUND TRANSFE,,2019-02-02,300000.0,,-540262222.8300009,.
409000438620',2019-02-02,AEPS PAY Indiaforensic 0102,,2019-02-02,,199.58,-540262023.2500008,.
409000438620',2019-02-02,MAW/502964XXXXXX0502/NAGA,,2019-02-02,,200.0,-540261823.2500008,.
409000438620',2019-02-02,MICRO ATM WDL FEE DT01021,,2019-02-02,,129700.0,-540132123.2500008,.
409000438620',2019-02-02,MICRO ATM INC DATED 01021,,2019-02-02,,261.72,-540131861.5300008,.
409000438620',2019-02-02,MICRO ATM GST DATED 01021,,2019-02-02,,52.34,-540131809.1900008,.
409000438620',2019-02-02,MICRO ATM WDL FEE DT02021,,2019-02-02,,109900.0,-540021909.1900008,.
409000438620',2019-02-02,MICRO ATM INC DATED 02021,,2019-02-02,,194.4,-540021714.7900008,.
409000438620',2019-02-02,MICRO ATM GST DATED 02021,,2019-02-02,,38.88,-540021675.9100008,.
409000438620',2019-02-02,AEPS INC DT 01-02-2019 RO,,2019-02-02,,1968.89,-540019707.0200008,.
409000438620',2019-02-02,AEPS GST INC DT 01-02-201,,2019-02-02,,393.78,-540019313.2400008,.
409000438620',2019-02-02,AEPS ACQ CR ADJ FEES 0102,,2019-02-02,20.65,,-540019333.8900008,.
409000438620',2019-02-04,Indiaforensic AEPS NPCI WDL SET,,2019-02-04,,520000.0,-539499333.8900008,.
409000438620',2019-02-04,Indiaforensic AEPS NPCI WDL SET,,2019-02-04,,365000.0,-539134333.8900008,.
409000438620',2019-02-04,FDRL/INTERNAL FUND TRANSFE,,2019-02-04,400000.0,,-539534333.8900008,.
409000438620',2019-02-04,FDRL/INTERNAL FUND TRANSFE,,2019-02-04,300000.0,,-539834333.8900008,.
409000438620',2019-02-04,FDRL/INTERNAL FUND TRANSFE,,2019-02-04,400000.0,,-540234333.8900008,.
409000438620',2019-02-04,MAW/502964XXXXXX1732/NAGA,,2019-02-04,,2500.0,-540231833.8900008,.
409000438620',2019-02-04,MAW/502964XXXXXX0502/NAGA,,2019-02-04,,1600.0,-540230233.8900008,.
409000438620',2019-02-04,MICRO ATM WDL FEE DT02021,,2019-02-04,,131700.0,-540098533.8900008,.
409000438620',2019-02-04,MICRO ATM INC DATED 02021,,2019-02-04,,267.48,-540098266.4100008,.
409000438620',2019-02-04,MICRO ATM GST DATED 02021,,2019-02-04,,53.5,-540098212.9100008,.
409000438620',2019-02-04,MICRO ATM WDL FEE DT03021,,2019-02-04,,139700.0,-539958512.9100008,.
409000438620',2019-02-04,MICRO ATM INC DATED 03021,,2019-02-04,,384.12,-539958128.7900008,.
409000438620',2019-02-04,MICRO ATM GST DATED 03021,,2019-02-04,,76.82,-539958051.9700007,.
409000438620',2019-02-04,FDRL/INTERNAL FUND TRANSFE,,2019-02-04,300000.0,,-540258051.9700007,.
409000438620',2019-02-04,AEPS INC DT 02-02-2019 RO,,2019-02-04,,1244.88,-540256807.0900007,.
409000438620',2019-02-04,AEPS GST INC DT 02-02-201,,2019-02-04,,248.98,-540256558.1100007,.
409000438620',2019-02-04,MICRO ATM WDL FEE DT04021,,2019-02-04,,40300.0,-540216258.1100007,.
409000438620',2019-02-04,MICRO ATM INC DATED 04021,,2019-02-04,,87.48,-540216170.6300007,.
409000438620',2019-02-04,MICRO ATM GST DATED 04021,,2019-02-04,,17.5,-540216153.1300007,.
409000438620',2019-02-04,AEPS INC DT 03-02-2019 RO,,2019-02-04,,953.87,-540215199.2600007,.
409000438620',2019-02-04,AEPS GST INC DT 03-02-201,,2019-02-04,,190.77,-540215008.4900007,.
409000438620',2019-02-05,Indiaforensic AEPS NPCI WDL SET,,2019-02-05,,692000.0,-539523008.4900007,.
409000438620',2019-02-05,MAW/502964XXXXXX9734/NAGA,,2019-02-05,,500.0,-539522508.4900007,.
409000438620',2019-02-05,MICRO ATM WDL FEE DT04021,,2019-02-05,,68700.0,-539453808.4900007,.
409000438620',2019-02-05,MICRO ATM INC DATED 04021,,2019-02-05,,149.04,-539453659.4500008,.
409000438620',2019-02-05,MICRO ATM GST DATED 04021,,2019-02-05,,29.81,-539453629.6400008,.
409000438620',2019-02-05,FDRL/INTERNAL FUND TRANSFE,,2019-02-05,400000.0,,-539853629.6400008,.
409000438620',2019-02-05,FDRL/INTERNAL FUND TRANSFE,,2019-02-05,300000.0,,-540153629.6400008,.
409000438620',2019-02-05,AEPS PAY Indiaforensic 0402,,2019-02-05,,599.06,-540153030.5800009,.
409000438620',2019-02-05,MAW/502964XXXXXX2094/NAGA,,2019-02-05,,500.0,-540152530.5800009,.
409000438620',2019-02-05,MICRO ATM WDL FEE DT05021,,2019-02-05,,68000.0,-540084530.5800009,.
409000438620',2019-02-05,MICRO ATM INC DATED 05021,,2019-02-05,,126.0,-540084404.5800009,.
409000438620',2019-02-05,MICRO ATM GST DATED 05021,,2019-02-05,,25.2,-540084379.3800008,.
409000438620',2019-02-05,AEPS INC DT 04-02-2019 RO,,2019-02-05,,1686.38,-540082693.0000008,.
409000438620',2019-02-05,AEPS GST INC DT 04-02-201,,2019-02-05,,337.28,-540082355.7200009,.
409000438620',2019-02-06,Indiaforensic AEPS NPCI WDL SET,,2019-02-06,,827400.0,-539254955.7200009,.
409000438620',2019-02-06,MICRO ATM WDL FEE DT05021,,2019-02-06,,120300.0,-539134655.7200009,.
409000438620',2019-02-06,MICRO ATM INC DATED 05021,,2019-02-06,,256.68,-539134399.0400009,.
409000438620',2019-02-06,MICRO ATM GST DATED 05021,,2019-02-06,,51.34,-539134347.7000009,.
409000438620',2019-02-06,FDRL/INTERNAL FUND TRANSFE,,2019-02-06,1000000.0,,-540134347.7000009,.
409000438620',2019-02-06,AEPS INC DT 050219 RMCPL,,2019-02-06,,2120.92,-540132226.7800009,.
409000438620',2019-02-06,AEPS GST INC DT 050219 RO,,2019-02-06,,424.18,-540131802.600001,.
409000438620',2019-02-06,AEPS PAY Indiaforensic 0502,,2019-02-06,,399.46,-540131403.1400009,.
409000438620',2019-02-06,MICRO ATM WDL FEE DT06021,,2019-02-06,,97200.0,-540034203.1400009,.
409000438620',2019-02-06,MICRO ATM INC DATED 06021,,2019-02-06,,206.64,-540033996.500001,.
409000438620',2019-02-06,MICRO ATM GST DATED 06021,,2019-02-06,,41.33,-540033955.1700009,.
409000438620',2019-02-07,Indiaforensic AEPS NPCI WDL SET,,2019-02-07,,698300.0,-539335655.1700009,.
409000438620',2019-02-07,CR903318428741/RMCPL24424/0,,2019-02-07,500.0,,-539336155.1700009,.
409000438620',2019-02-07,CR903318432189/RMCPL13413/0,,2019-02-07,1500.0,,-539337655.1700009,.
409000438620',2019-02-07,CR903318432431/RMCPL28235/0,,2019-02-07,8000.0,,-539345655.1700009,.
409000438620',2019-02-07,CR903318433725/RMCPL13631/0,,2019-02-07,500.0,,-539346155.1700009,.
409000438620',2019-02-07,CR903318434102/RMCPL08013/0,,2019-02-07,500.0,,-539346655.1700009,.
409000438620',2019-02-07,FDRL/INTERNAL FUND TRANSFE,,2019-02-07,300000.0,,-539646655.1700009,.
409000438620',2019-02-07,FDRL/INTERNAL FUND TRANSFE,,2019-02-07,300000.0,,-539946655.1700009,.
409000438620',2019-02-07,FDRL/INTERNAL FUND TRANSFE,,2019-02-07,300000.0,,-540246655.1700009,.
409000438620',2019-02-07,MAW/502964XXXXXX0502/NAGA,,2019-02-07,,2000.0,-540244655.1700009,.
409000438620',2019-02-07,AEPS PAY Indiaforensic 0602,,2019-02-07,,299.23,-540244355.9400009,.
409000438620',2019-02-07,MICRO ATM WDL FEE DT06021,,2019-02-07,,102700.0,-540141655.9400009,.
409000438620',2019-02-07,MICRO ATM INC DATED 06021,,2019-02-07,,231.84,-540141424.1000009,.
409000438620',2019-02-07,MICRO ATM GST DATED 06021,,2019-02-07,,46.37,-540141377.7300009,.
409000438620',2019-02-07,MICRO ATM WDL FEE DT07021,,2019-02-07,,127200.0,-540014177.7300009,.
409000438620',2019-02-07,MICRO ATM INC DATED 07021,,2019-02-07,,226.8,-540013950.9300009,.
409000438620',2019-02-07,MICRO ATM GST DATED 07021,,2019-02-07,,45.36,-540013905.5700009,.
409000438620',2019-02-07,FDRL/INTERNAL FUND TRANSFE,,2019-02-07,200000.0,,-540213905.5700009,.
409000438620',2019-02-07,AEPS INC DT 060219 RMCPL,,2019-02-07,,1746.06,-540212159.510001,.
409000438620',2019-02-07,AEPS GST INC DT 060219 RO,,2019-02-07,,349.21,-540211810.3000009,.
409000438620',2019-02-07,AEPS ACQ CR ADJ FEES 0602,,2019-02-07,35.4,,-540211845.7000009,.
409000438620',2019-02-08,Indiaforensic AEPS NPCI WDL SET,,2019-02-08,,727400.0,-539484445.7000009,.
409000438620',2019-02-08,FDRL/INTERNAL FUND TRANSFE,,2019-02-08,500000.0,,-539984445.7000009,.
409000438620',2019-02-08,FDRL/INTERNAL FUND TRANSFE,,2019-02-08,300000.0,,-540284445.7000009,.
409000438620',2019-02-08,MICRO ATM WDL FEE DT07021,,2019-02-08,,145000.0,-540139445.7000009,.
409000438620',2019-02-08,MICRO ATM INC DATED 07021,,2019-02-08,,279.0,-540139166.7000009,.
409000438620',2019-02-08,MICRO ATM GST DATED 07021,,2019-02-08,,55.8,-540139110.9000009,.
409000438620',2019-02-08,MAW/502964XXXXXX8926/NAGA,,2019-02-08,,1000.0,-540138110.9000009,.
409000438620',2019-02-08,AEPS INC DT 070219 RMCPL,,2019-02-08,,1884.51,-540136226.3900009,.
409000438620',2019-02-08,AEPS GST INC DT 070219 RO,,2019-02-08,,376.9,-540135849.490001,.
409000438620',2019-02-08,MICRO ATM WDL FEE DT08021,,2019-02-08,,84700.0,-540051149.490001,.
409000438620',2019-02-08,MICRO ATM INC DATED 08021,,2019-02-08,,189.72,-540050959.7700009,.
409000438620',2019-02-08,MICRO ATM GST DATED 08021,,2019-02-08,,37.94,-540050921.8300009,.
409000438620',2019-02-08,FDRL/INTERNAL FUND TRANSFE,,2019-02-08,200000.0,,-540250921.8300009,.
409000438620',2019-02-09,MAW/502964XXXXXX4415/NAGA,,2019-02-09,,1600.0,-540249321.8300009,.
409000438620',2019-02-11,Indiaforensic AEPS NPCI WDL SET,,2019-02-11,,683700.0,-539565621.8300009,.
409000438620',2019-02-11,Indiaforensic AEPS NPCI WDL SET,,2019-02-11,,735000.0,-538830621.8300009,.
409000438620',2019-02-11,Indiaforensic AEPS NPCI WDL SET,,2019-02-11,,336800.0,-538493821.8300009,.
409000438620',2019-02-11,FDRL/INTERNAL FUND TRANSFE,,2019-02-11,1000000.0,,-539493821.8300009,.
409000438620',2019-02-11,FDRL/INTERNAL FUND TRANSFE,,2019-02-11,200000.0,,-539693821.8300009,.
409000438620',2019-02-11,FDRL/INTERNAL FUND TRANSFE,,2019-02-11,200000.0,,-539893821.8300009,.
409000438620',2019-02-11,FDRL/INTERNAL FUND TRANSFE,,2019-02-11,300000.0,,-540193821.8300009,.
409000438620',2019-02-11,MICRO ATM WDL FEE DT08021,,2019-02-11,,131300.0,-540062521.8300009,.
409000438620',2019-02-11,MICRO ATM INC DATED 08021,,2019-02-11,,298.08,-540062223.7500008,.
409000438620',2019-02-11,MICRO ATM GST DATED 08021,,2019-02-11,,59.62,-540062164.1300008,.
409000438620',2019-02-11,AEPS PAY Indiaforensic 1002,,2019-02-11,,669.3,-540061494.8300009,.
409000438620',2019-02-11,AEPS PAY Indiaforensic 0902,,2019-02-11,,2507.33,-540058987.5000008,.
409000438620',2019-02-11,MICRO ATM WDL FEE DT09021,,2019-02-11,,204200.0,-539854787.5000008,.
409000438620',2019-02-11,MICRO ATM INC DATED 09021,,2019-02-11,,475.92,-539854311.5800009,.
409000438620',2019-02-11,MICRO ATM GST DATED 09021,,2019-02-11,,95.18,-539854216.4000009,.
409000438620',2019-02-11,MICRO ATM WDL FEE DT10021,,2019-02-11,,214200.0,-539640016.4000009,.
409000438620',2019-02-11,MICRO ATM INC DATED 10021,,2019-02-11,,445.32,-539639571.0800009,.
409000438620',2019-02-11,MICRO ATM GST DATED 10021,,2019-02-11,,89.06,-539639482.0200009,.
409000438620',2019-02-11,MICRO ATM WDL FEE DT11021,,2019-02-11,,87400.0,-539552082.0200009,.
409000438620',2019-02-11,MICRO ATM INC DATED 11021,,2019-02-11,,144.72,-539551937.3000009,.
409000438620',2019-02-11,MICRO ATM GST DATED 11021,,2019-02-11,,28.94,-539551908.3600008,.
409000438620',2019-02-11,AEPS INC DT 100219 RMCPL,,2019-02-11,,989.45,-539550918.9100008,.
409000438620',2019-02-11,AEPS GST INC DT 100219 RO,,2019-02-11,,197.89,-539550721.0200008,.
409000438620',2019-02-11,AEPS INC DT 090219 RMCPL,,2019-02-11,,1887.46,-539548833.5600008,.
409000438620',2019-02-11,AEPS GST INC DT 090219 RO,,2019-02-11,,377.49,-539548456.0700008,.
409000438620',2019-02-11,AEPS INC DT 080219 RMCPL,,2019-02-11,,1693.89,-539546762.1800008,.
409000438620',2019-02-11,AEPS GST INC DT 080219 RO,,2019-02-11,,338.78,-539546423.4000008,.
409000438620',2019-02-11,FDRL/INTERNAL FUND TRANSFE,,2019-02-11,200000.0,,-539746423.4000008,.
409000438620',2019-02-12,FDRL/INTERNAL FUND TRANSFE,,2019-02-12,500000.0,,-540246423.4000008,.
409000438620',2019-02-12,Indiaforensic AEPS NPCI WDL SET,,2019-02-12,,778200.0,-539468223.4000008,.
409000438620',2019-02-12,FDRL/INTERNAL FUND TRANSFE,,2019-02-12,300000.0,,-539768223.4000008,.
409000438620',2019-02-12,FDRL/INTERNAL FUND TRANSFE,,2019-02-12,500000.0,,-540268223.4000008,.
409000438620',2019-02-12,MICRO ATM WDL FEE DT11021,,2019-02-12,,99700.0,-540168523.4000008,.
409000438620',2019-02-12,MICRO ATM INC DATED 11021,,2019-02-12,,261.72,-540168261.6800008,.
409000438620',2019-02-12,MICRO ATM GST DATED 11021,,2019-02-12,,52.34,-540168209.3400007,.
409000438620',2019-02-12,AEPS PAY Indiaforensic 1102,,2019-02-12,,2667.83,-540165541.5100007,.
409000438620',2019-02-12,MAW/502964XXXXXX2136/NAGA,,2019-02-12,,500.0,-540165041.5100007,.
409000438620',2019-02-12,MICRO ATM WDL FEE DT12021,,2019-02-12,,28100.0,-540136941.5100007,.
409000438620',2019-02-12,MICRO ATM INC DATED 12021,,2019-02-12,,75.96,-540136865.5500007,.
409000438620',2019-02-12,MICRO ATM GST DATED 12021,,2019-02-12,,15.19,-540136850.3600006,.
409000438620',2019-02-12,AEPS INCOME DT 11-02-2019,,2019-02-12,,1923.61,-540134926.7500006,.
409000438620',2019-02-12,AEPS GST INC DT 11-02-201,,2019-02-12,,384.72,-540134542.0300006,.
409000438620',2019-02-13,Indiaforensic AEPS NPCI WDL SET,,2019-02-13,,763700.0,-539370842.0300006,.
409000438620',2019-02-13,FDRL/INTERNAL FUND TRANSFE,,2019-02-13,300000.0,,-539670842.0300006,.
409000438620',2019-02-13,FDRL/INTERNAL FUND TRANSFE,,2019-02-13,300000.0,,-539970842.0300006,.
409000438620',2019-02-13,FDRL/INTERNAL FUND TRANSFE,,2019-02-13,300000.0,,-540270842.0300006,.
409000438620',2019-02-13,AEPS PAY Indiaforensic 1202,,2019-02-13,,1998.52,-540268843.5100006,.
409000438620',2019-02-13,MICRO ATM WDL FEE DT12021,,2019-02-13,,117600.0,-540151243.5100006,.
409000438620',2019-02-13,MICRO ATM INC DATED 12021,,2019-02-13,,317.16,-540150926.3500006,.
409000438620',2019-02-13,MICRO ATM GST DATED 12021,,2019-02-13,,63.43,-540150862.9200007,.
409000438620',2019-02-13,MICRO ATM WDL FEE DT13021,,2019-02-13,,80200.0,-540070662.9200007,.
409000438620',2019-02-13,MICRO ATM INC DATED 13021,,2019-02-13,,164.52,-540070498.4000007,.
409000438620',2019-02-13,MICRO ATM GST DATED 13021,,2019-02-13,,32.9,-540070465.5000007,.
409000438620',2019-02-13,AEPS INCOME DT 12-02-2019,,2019-02-13,,1890.01,-540068575.4900007,.
409000438620',2019-02-13,AEPS GST INC DT 12-02-201,,2019-02-13,,378.0,-540068197.4900007,.
409000438620',2019-02-13,FDRL/INTERNAL FUND TRANSFE,,2019-02-13,200000.0,,-540268197.4900007,.
409000438620',2019-02-14,Indiaforensic AEPS NPCI WDL SET,,2019-02-14,,779900.0,-539488297.4900007,.
409000438620',2019-02-14,FDRL/INTERNAL FUND TRANSFE,,2019-02-14,200000.0,,-539688297.4900007,.
409000438620',2019-02-14,FDRL/INTERNAL FUND TRANSFE,,2019-02-14,500000.0,,-540188297.4900007,.
409000438620',2019-02-14,MICRO ATM WDL FEE DT13021,,2019-02-14,,132800.0,-540055497.4900007,.
409000438620',2019-02-14,MICRO ATM INC DATED 13021,,2019-02-14,,294.48,-540055203.0100007,.
409000438620',2019-02-14,MICRO ATM GST DATED 13021,,2019-02-14,,58.9,-540055144.1100007,.
409000438620',2019-02-14,AEPS INCOME DT 13-02-2019,,2019-02-14,,2072.16,-540053071.9500008,.
409000438620',2019-02-14,AEPS GST INC DT 13-02-201,,2019-02-14,,414.43,-540052657.5200008,.
409000438620',2019-02-14,MICRO ATM WDL FEE DT14021,,2019-02-14,,500.0,-540052157.5200008,.
409000438620',2019-02-14,MICRO ATM INC DATED 14021,,2019-02-14,,1.8,-540052155.7200009,.
409000438620',2019-02-14,MICRO ATM GST DATED 14021,,2019-02-14,,0.36,-540052155.3600008,.
409000438620',2019-02-14,MAW/502964XXXXXX1841/NAGA,,2019-02-14,,100.0,-540052055.3600008,.
409000438620',2019-02-14,FDRL/INTERNAL FUND TRANSFE,,2019-02-14,200000.0,,-540252055.3600008,.
409000438620',2019-02-15,Indiaforensic AEPS NPCI WDL SET,,2019-02-15,,615900.0,-539636155.3600008,.
409000438620',2019-02-15,FDRL/INTERNAL FUND TRANSFE,,2019-02-15,300000.0,,-539936155.3600008,.
409000438620',2019-02-15,FDRL/INTERNAL FUND TRANSFE,,2019-02-15,300000.0,,-540236155.3600008,.
409000438620',2019-02-15,MICRO ATM WDL FEE DT14021,,2019-02-15,,145500.0,-540090655.3600008,.
409000438620',2019-02-15,MICRO ATM INC DATED 14021,,2019-02-15,,373.68,-540090281.6800009,.
409000438620',2019-02-15,MICRO ATM GST DATED 14021,,2019-02-15,,74.74,-540090206.9400009,.
409000438620',2019-02-15,AEPS INCOME DT 14-02-2019,,2019-02-15,,1526.79,-540088680.1500009,.
409000438620',2019-02-15,AEPS GST INC DT 14-02-201,,2019-02-15,,305.36,-540088374.7900009,.
409000438620',2019-02-15,MICRO ATM WDL FEE DT15021,,2019-02-15,,46800.0,-540041574.7900009,.
409000438620',2019-02-15,MICRO ATM INC DATED 15021,,2019-02-15,,114.48,-540041460.3100009,.
409000438620',2019-02-15,MICRO ATM GST DATED 15021,,2019-02-15,,22.9,-540041437.4100009,.
409000438620',2019-02-16,Indiaforensic AEPS NPCI WDL SET,,2019-02-16,,646900.0,-539394537.4100009,.
409000438620',2019-02-16,FDRL/INTERNAL FUND TRANSFE,,2019-02-16,300000.0,,-539694537.4100009,.
409000438620',2019-02-16,FDRL/INTERNAL FUND TRANSFE,,2019-02-16,500000.0,,-540194537.4100009,.
409000438620',2019-02-16,MICRO ATM WDL FEE DT15021,,2019-02-16,,121000.0,-540073537.4100009,.
409000438620',2019-02-16,MICRO ATM INC DATED 15021,,2019-02-16,,262.8,-540073274.610001,.
409000438620',2019-02-16,MICRO ATM GST DATED 15021,,2019-02-16,,52.56,-540073222.050001,.
409000438620',2019-02-16,MAW/502964XXXXXX2088/NAGA,,2019-02-16,,200.0,-540073022.050001,.
409000438620',2019-02-16,FDRL/INTERNAL FUND TRANSFE,,2019-02-16,200000.0,,-540273022.050001,.
409000438620',2019-02-16,AEPS INCOME DT 15-02-2019,,2019-02-16,,1672.43,-540271349.6200011,.
409000438620',2019-02-16,AEPS GST INC DT 15-02-201,,2019-02-16,,334.49,-540271015.1300011,.
409000438620',2019-02-16,MICRO ATM WDL FEE DT16021,,2019-02-16,,80500.0,-540190515.1300011,.
409000438620',2019-02-17,MAW/502964XXXXXX6410/NAGA,,2019-02-17,,1300.0,-540189215.1300011,.
409000438620',2019-02-18,Indiaforensic AEPS NPCI WDL SET,,2019-02-18,,801400.0,-539387815.1300011,.
409000438620',2019-02-18,CR904516440235/RMCPL29707/1,,2019-02-18,9000.0,,-539396815.1300011,.
409000438620',2019-02-18,Indiaforensic AEPS NPCI WDL SET,,2019-02-18,,669500.0,-538727315.1300011,.
409000438620',2019-02-18,FDRL/INTERNAL FUND TRANSFE,,2019-02-18,1000000.0,,-539727315.1300011,.
409000438620',2019-02-18,FDRL/INTERNAL FUND TRANSFE,,2019-02-18,500000.0,,-540227315.1300011,.
409000438620',2019-02-18,AEPS PAY Indiaforensic 1602,,2019-02-18,,3796.87,-540223518.2600011,.
409000438620',2019-02-18,AEPS PAY Indiaforensic 1702,,2019-02-18,,1697.7,-540221820.560001,.
409000438620',2019-02-18,MICRO ATM WDL FEE DT16021,,2019-02-18,,129000.0,-540092820.560001,.
409000438620',2019-02-18,MICRO ATM INC DATED 16021,,2019-02-18,,282.24,-540092538.320001,.
409000438620',2019-02-18,MICRO ATM GST DATED 16021,,2019-02-18,,56.45,-540092481.870001,.
409000438620',2019-02-18,MICRO ATM WDL FEE DT17021,,2019-02-18,,180700.0,-539911781.870001,.
409000438620',2019-02-18,MICRO ATM INC DATED 17021,,2019-02-18,,483.12,-539911298.750001,.
409000438620',2019-02-18,MICRO ATM GST DATED 17021,,2019-02-18,,96.62,-539911202.130001,.
409000438620',2019-02-18,AEPS INCOME DT 16-02-2019,,2019-02-18,,1941.25,-539909260.880001,.
409000438620',2019-02-18,AEPS GST INC DT 16-02-201,,2019-02-18,,388.25,-539908872.630001,.
409000438620',2019-02-18,AEPS INCOME DT 17-02-2019,,2019-02-18,,1781.15,-539907091.480001,.
409000438620',2019-02-18,AEPS GST INC DT 17-02-201,,2019-02-18,,356.23,-539906735.250001,.
409000438620',2019-02-18,MICRO ATM WDL FEE DT18021,,2019-02-18,,41200.0,-539865535.250001,.
409000438620',2019-02-18,MICRO ATM INC DATED 18021,,2019-02-18,,101.52,-539865433.730001,.
409000438620',2019-02-18,MICRO ATM GST DATED 18021,,2019-02-18,,20.3,-539865413.430001,.
409000438620',2019-02-18,AEPS ACQ CR ADJ FEES 1602,,2019-02-18,17.7,,-539865431.1300011,.
409000438620',2019-02-18,FDRL/INTERNAL FUND TRANSFE,,2019-02-18,200000.0,,-540065431.1300011,.
409000438620',2019-02-18,FDRL/INTERNAL FUND TRANSFE,,2019-02-18,200000.0,,-540265431.1300011,.
409000438620',2019-02-18,MICRO ATM INC DATED 16021,,2019-02-18,,182.52,-540265248.6100011,.
409000438620',2019-02-18,MICRO ATM GST DATED 16021,,2019-02-18,,36.5,-540265212.1100011,.
409000438620',2019-02-19,Indiaforensic AEPS NPCI WDL SET,,2019-02-19,,680900.0,-539584312.1100011,.
409000438620',2019-02-19,CR904613585255/RMCPL09580/1,,2019-02-19,10000.0,,-539594312.1100011,.
409000438620',2019-02-19,CR904613585243/RMCPL21743/1,,2019-02-19,500.0,,-539594812.1100011,.
409000438620',2019-02-19,CR904613586342/RMCPL22655/1,,2019-02-19,1100.0,,-539595912.1100011,.
409000438620',2019-02-19,AEPS INCOME DT 18-02-2019,,2019-02-19,,1804.04,-539594108.0700011,.
409000438620',2019-02-19,AEPS GST INC DT 18-02-201,,2019-02-19,,360.81,-539593747.2600012,.
409000438620',2019-02-19,AEPS ACQ CR ADJ FEES 1802,,2019-02-19,27.14,,-539593774.4000012,.
409000438620',2019-02-19,FDRL/INTERNAL FUND TRANSFE,,2019-02-19,300000.0,,-539893774.4000012,.
409000438620',2019-02-19,FDRL/INTERNAL FUND TRANSFE,,2019-02-19,300000.0,,-540193774.4000012,.
409000438620',2019-02-20,Indiaforensic AEPS NPCI WDL SET,,2019-02-20,,798400.0,-539395374.4000012,.
409000438620',2019-02-20,FDRL/INTERNAL FUND TRANSFE,,2019-02-20,500000.0,,-539895374.4000012,.
409000438620',2019-02-20,FDRL/INTERNAL FUND TRANSFE,,2019-02-20,300000.0,,-540195374.4000012,.
409000438620',2019-02-20,MAW/502964XXXXXX3383/NAGA,,2019-02-20,,1500.0,-540193874.4000012,.
409000438620',2019-02-20,MICRO ATM WDL FEE DT18021,,2019-02-20,,217500.0,-539976374.4000012,.
409000438620',2019-02-20,MICRO ATM INC DATED 18021,,2019-02-20,,451.08,-539975923.3200011,.
409000438620',2019-02-20,MICRO ATM GST DATED 18021,,2019-02-20,,90.22,-539975833.1000011,.
409000438620',2019-02-20,MICRO ATM WDL FEE DT19021,,2019-02-20,,135200.0,-539840633.1000011,.
409000438620',2019-02-20,MICRO ATM INC DATED 19021,,2019-02-20,,286.92,-539840346.1800011,.
409000438620',2019-02-20,MICRO ATM GST DATED 19021,,2019-02-20,,57.38,-539840288.8000011,.
409000438620',2019-02-20,AEPS PAY Indiaforensic 1802,,2019-02-20,,199.58,-539840089.2200011,.
409000438620',2019-02-20,FDRL/INTERNAL FUND TRANSFE,,2019-02-20,200000.0,,-540040089.2200011,.
409000438620',2019-02-20,FDRL/INTERNAL FUND TRANSFE,,2019-02-20,200000.0,,-540240089.2200011,.
409000438620',2019-02-20,AEPS INCOME DT 19-02-2019,,2019-02-20,,2036.47,-540238052.7500011,.
409000438620',2019-02-20,AEPS GST INC DT 19-02-201,,2019-02-20,,407.29,-540237645.4600011,.
409000438620',2019-02-20,MICRO ATM WDL FEE DT20021,,2019-02-20,,68500.0,-540169145.4600011,.
409000438620',2019-02-20,MICRO ATM INC DATED 20021,,2019-02-20,,178.2,-540168967.2600011,.
409000438620',2019-02-20,MICRO ATM GST DATED 20021,,2019-02-20,,35.64,-540168931.6200011,.
409000438620',2019-02-20,MICRO ATM WDL FEE DT19021,,2019-02-20,,242600.0,-539926331.6200011,.
409000438620',2019-02-20,MICRO ATM INC DATED 19021,,2019-02-20,,525.6,-539925806.020001,.
409000438620',2019-02-20,MICRO ATM GST DATED 19021,,2019-02-20,,105.12,-539925700.900001,.
409000438620',2019-02-21,MAW/502964XXXXXX7981/NAGA,,2019-02-21,,100.0,-539925600.900001,.
409000438620',2019-02-21,MAW/502964XXXXXX7057/NAGA,,2019-02-21,,1500.0,-539924100.900001,.
409000438620',2019-02-21,FDRL/INTERNAL FUND TRANSFE,,2019-02-21,300000.0,,-540224100.900001,.
409000438620',2019-02-21,Indiaforensic AEPS NPCI WDL SET,,2019-02-21,,741200.0,-539482900.900001,.
409000438620',2019-02-21,FDRL/INTERNAL FUND TRANSFE,,2019-02-21,300000.0,,-539782900.900001,.
409000438620',2019-02-21,FDRL/INTERNAL FUND TRANSFE,,2019-02-21,500000.0,,-540282900.900001,.
409000438620',2019-02-21,MICRO ATM WDL FEE DT20021,,2019-02-21,,174400.0,-540108500.900001,.
409000438620',2019-02-21,MICRO ATM INC DATED 20021,,2019-02-21,,421.56,-540108079.3400011,.
409000438620',2019-02-21,MICRO ATM GST DATED 20021,,2019-02-21,,84.31,-540107995.0300012,.
409000438620',2019-02-21,MICRO ATM WDL FEE DT21021,,2019-02-21,,37900.0,-540070095.0300012,.
409000438620',2019-02-21,MICRO ATM INC DATED 21021,,2019-02-21,,122.4,-540069972.6300012,.
409000438620',2019-02-21,MICRO ATM GST DATED 21021,,2019-02-21,,24.48,-540069948.1500012,.
409000438620',2019-02-21,AEPS INCOME DT 20-02-2019,,2019-02-21,,1928.21,-540068019.9400011,.
409000438620',2019-02-21,AEPS GST INC DT 20-02-201,,2019-02-21,,385.64,-540067634.3000011,.
409000438620',2019-02-21,AEPS PAY Indiaforensic 2002,,2019-02-21,,499.4,-540067134.9000012,.
409000438620',2019-02-21,FDRL/INTERNAL FUND TRANSFE,,2019-02-21,200000.0,,-540267134.9000012,.
409000438620',2019-02-22,Indiaforensic AEPS NPCI WDL SET,,2019-02-22,,758400.0,-539508734.9000012,.
409000438620',2019-02-22,CR905010249558/RMCPL21736/1,,2019-02-22,2100.0,,-539510834.9000012,.
409000438620',2019-02-22,MICRO ATM WDL FEE DT21021,,2019-02-22,,91400.0,-539419434.9000012,.
409000438620',2019-02-22,MICRO ATM INC DATED 21021,,2019-02-22,,219.6,-539419215.3000011,.
409000438620',2019-02-22,MICRO ATM GST DATED 21021,,2019-02-22,,43.92,-539419171.3800012,.
409000438620',2019-02-22,FDRL/INTERNAL FUND TRANSFE,,2019-02-22,500000.0,,-539919171.3800012,.
409000438620',2019-02-22,FDRL/INTERNAL FUND TRANSFE,,2019-02-22,300000.0,,-540219171.3800012,.
409000438620',2019-02-22,AEPS INCOME DT 21-02-2019,,2019-02-22,,1860.63,-540217310.7500012,.
409000438620',2019-02-22,AEPS GST INC DT 21-02-201,,2019-02-22,,372.13,-540216938.6200012,.
409000438620',2019-02-22,AEPS ACQ CR ADJ FEES 2102,,2019-02-22,12.39,,-540216951.0100012,.
409000438620',2019-02-22,MICRO ATM WDL FEE DT22021,,2019-02-22,,106200.0,-540110751.0100012,.
409000438620',2019-02-22,MICRO ATM INC DATED 22021,,2019-02-22,,198.36,-540110552.6500012,.
409000438620',2019-02-22,MICRO ATM GST DATED 22021,,2019-02-22,,39.67,-540110512.9800012,.
409000438620',2019-02-25,Indiaforensic AEPS NPCI WDL SET,,2019-02-25,,825700.0,-539284812.9800012,.
409000438620',2019-02-25,FDRL/INTERNAL FUND TRANSFE,,2019-02-25,300000.0,,-539584812.9800012,.
409000438620',2019-02-25,FDRL/INTERNAL FUND TRANSFE,,2019-02-25,200000.0,,-539784812.9800012,.
409000438620',2019-02-25,FDRL/INTERNAL FUND TRANSFE,,2019-02-25,200000.0,,-539984812.9800012,.
409000438620',2019-02-25,FDRL/INTERNAL FUND TRANSFE,,2019-02-25,200000.0,,-540184812.9800012,.
409000438620',2019-02-25,Indiaforensic AEPS NPCI WDL SET,,2019-02-25,,892700.0,-539292112.9800012,.
409000438620',2019-02-25,Indiaforensic AEPS NPCI WDL SET,,2019-02-25,,559100.0,-538733012.9800012,.
409000438620',2019-02-25,FDRL/INTERNAL FUND TRANSFE,,2019-02-25,1000000.0,,-539733012.9800012,.
409000438620',2019-02-25,FDRL/INTERNAL FUND TRANSFE,,2019-02-25,500000.0,,-540233012.9800012,.
409000438620',2019-02-25,NPCI_SETT_DIFF_LOT1_20021,,2019-02-25,,1500.0,-540231512.9800012,.
409000438620',2019-02-25,MICRO ATM WDL FEE DT22021,,2019-02-25,,146500.0,-540085012.9800012,.
409000438620',2019-02-25,MICRO ATM INC DATED 22021,,2019-02-25,,300.24,-540084712.7400012,.
409000438620',2019-02-25,MICRO ATM GST DATED 22021,,2019-02-25,,60.05,-540084652.6900012,.
409000438620',2019-02-25,FDRL/INTERNAL FUND TRANSFE,,2019-02-25,200000.0,,-540284652.6900012,.
409000438620',2019-02-25,MICRO ATM WDL FEE DT23021,,2019-02-25,,346400.0,-539938252.6900012,.
409000438620',2019-02-25,MICRO ATM INC DATED 23021,,2019-02-25,,807.12,-539937445.5700012,.
409000438620',2019-02-25,MICRO ATM GST DATED 23021,,2019-02-25,,161.42,-539937284.1500013,.
409000438620',2019-02-25,AEPS INCOME DT 22-02-2019,,2019-02-25,,2068.95,-539935215.2000012,.
409000438620',2019-02-25,AEPS GST INC DT 22-02-201,,2019-02-25,,413.79,-539934801.4100013,.
409000438620',2019-02-25,AEPS INCOME DT 23-02-2019,,2019-02-25,,2314.78,-539932486.6300013,.
409000438620',2019-02-25,AEPS GST INC DT 23-02-201,,2019-02-25,,462.96,-539932023.6700013,.
409000438620',2019-02-25,AEPS INCOME DT 24-02-2019,,2019-02-25,,1553.09,-539930470.5800012,.
409000438620',2019-02-25,AEPS GST INC DT 24-02-201,,2019-02-25,,310.62,-539930159.9600012,.
409000438620',2019-02-25,MICRO ATM WDL FEE DT24021,,2019-02-25,,381700.0,-539548459.9600012,.
409000438620',2019-02-25,MICRO ATM INC DATED 24021,,2019-02-25,,807.48,-539547652.4800012,.
409000438620',2019-02-25,MICRO ATM GST DATED 24021,,2019-02-25,,161.5,-539547490.9800012,.
409000438620',2019-02-25,MICRO ATM WDL FEE DT25021,,2019-02-25,,81800.0,-539465690.9800012,.
409000438620',2019-02-25,MICRO ATM INC DATED 25021,,2019-02-25,,220.32,-539465470.6600012,.
409000438620',2019-02-25,MICRO ATM GST DATED 25021,,2019-02-25,,44.06,-539465426.6000012,.
409000438620',2019-02-25,FDRL/INTERNAL FUND TRANSFE,,2019-02-25,500000.0,,-539965426.6000012,.
409000438620',2019-02-25,FDRL/INTERNAL FUND TRANSFE,,2019-02-25,300000.0,,-540265426.6000012,.
409000438620',2019-02-26,Indiaforensic AEPS NPCI WDL SET,,2019-02-26,,1000800.0,-539264626.6000012,.
409000438620',2019-02-26,FDRL/INTERNAL FUND TRANSFE,,2019-02-26,1000000.0,,-540264626.6000012,.
409000438620',2019-02-26,MICRO ATM WDL FEE DT25021,,2019-02-26,,240200.0,-540024426.6000012,.
409000438620',2019-02-26,MICRO ATM INC DATED 25021,,2019-02-26,,486.72,-540023939.8800012,.
409000438620',2019-02-26,MICRO ATM GST DATED 25021,,2019-02-26,,97.34,-540023842.5400012,.
409000438620',2019-02-26,FDRL/INTERNAL FUND TRANSFE,,2019-02-26,200000.0,,-540223842.5400012,.
409000438620',2019-02-26,MICRO ATM WDL FEE DT26021,,2019-02-26,,100800.0,-540123042.5400012,.
409000438620',2019-02-26,MICRO ATM INC DATED 26021,,2019-02-26,,233.28,-540122809.2600012,.
409000438620',2019-02-26,MICRO ATM GST DATED 26021,,2019-02-26,,46.66,-540122762.6000012,.
409000438620',2019-02-26,AEPS INCOME DT 25-02-2019,,2019-02-26,,2593.25,-540120169.3500012,.
409000438620',2019-02-26,AEPS GST INC DT 25-02-201,,2019-02-26,,518.65,-540119650.7000012,.
409000438620',2019-02-26,AEPS PAY Indiaforensic 2502,,2019-02-26,,400.87,-540119249.8300012,.
409000438620',2019-02-26,AEPS ACQUIRING ADJ FEES 2,,2019-02-26,2.95,,-540119252.7800013,.
409000438620',2019-02-27,Indiaforensic AEPS NPCI WDL SET,,2019-02-27,,870100.0,-539249152.7800013,.
409000438620',2019-02-27,FDRL/INTERNAL FUND TRANSFE,,2019-02-27,1000000.0,,-540249152.7800013,.
409000438620',2019-02-27,MICRO ATM WDL FEE DT26021,,2019-02-27,,178800.0,-540070352.7800013,.
409000438620',2019-02-27,MICRO ATM INC DATED 26021,,2019-02-27,,398.16,-540069954.6200013,.
409000438620',2019-02-27,MICRO ATM GST DATED 26021,,2019-02-27,,79.63,-540069874.9900013,.
409000438620',2019-02-27,AEPS INCOME DT 26-02-2019,,2019-02-27,,2212.11,-540067662.8800013,.
409000438620',2019-02-27,AEPS GST INC DT 26-02-201,,2019-02-27,,442.42,-540067220.4600013,.
409000438620',2019-02-27,FDRL/INTERNAL FUND TRANSFE,,2019-02-27,200000.0,,-540267220.4600013,.
409000438620',2019-02-27,MICRO ATM WDL FEE DT27021,,2019-02-27,,118800.0,-540148420.4600013,.
409000438620',2019-02-27,MICRO ATM INC DATED 27021,,2019-02-27,,268.56,-540148151.9000014,.
409000438620',2019-02-27,MICRO ATM GST DATED 27021,,2019-02-27,,53.71,-540148098.1900014,.
409000438620',2019-02-28,Indiaforensic AEPS NPCI WDL SET,,2019-02-28,,889700.0,-539258398.1900014,.
409000438620',2019-02-28,CR905112437179/RMCPL09580/2,,2019-02-28,10000.0,,-539268398.1900014,.
409000438620',2019-02-28,FDRL/INTERNAL FUND TRANSFE,,2019-02-28,1000000.0,,-540268398.1900014,.
409000438620',2019-02-28,MICRO ATM WDL FEE DT27021,,2019-02-28,,132900.0,-540135498.1900014,.
409000438620',2019-02-28,MICRO ATM INC DATED 27021,,2019-02-28,,298.8,-540135199.3900014,.
409000438620',2019-02-28,MICRO ATM GST DATED 27021,,2019-02-28,,59.76,-540135139.6300014,.
409000438620',2019-02-28,AEPS INCOME DT 27-02-2019,,2019-02-28,,2159.19,-540132980.4400014,.
409000438620',2019-02-28,AEPS GST INC DT 27-02-201,,2019-02-28,,431.84,-540132548.6000013,.
409000438620',2019-02-28,AEPS ACQ CR ADJ FEES 2702,,2019-02-28,17.7,,-540132566.3000014,.
409000438620',2019-02-28,AEPS ACQ REP ADJ FEES 270,,2019-02-28,,2.95,-540132563.3500013,.
409000438620',2019-02-28,AEPS PAY CR ADJIndiaforensic 270,,2019-02-28,,1699.0,-540130864.3500013,.
409000438620',2019-02-28,AEPS PAY CR ADJIndiaforensic_R 2,,2019-02-28,1699.0,,-540132563.3500013,.
409000438620',2019-02-28,AEPS PAY CR ADJIndiaforensic 270,,2019-02-28,1699.0,,-540134262.3500013,.
409000438620',2019-02-28,MICRO ATM WDL FEE DT28021,,2019-02-28,,98300.0,-540035962.3500013,.
409000438620',2019-02-28,MICRO ATM INC DATED 28021,,2019-02-28,,231.48,-540035730.8700013,.
409000438620',2019-02-28,MICRO ATM GST DATED 28021,,2019-02-28,,46.3,-540035684.5700014,.
409000438620',2019-03-01,Indiaforensic AEPS NPCI WDL SET,,2019-03-01,,876400.0,-539159284.5700014,.
409000438620',2019-03-01,FDRL/INTERNAL FUND TRANSFE,,2019-03-01,500000.0,,-539659284.5700014,.
409000438620',2019-03-01,FDRL/INTERNAL FUND TRANSFE,,2019-03-01,300000.0,,-539959284.5700014,.
409000438620',2019-03-01,FDRL/INTERNAL FUND TRANSFE,,2019-03-01,300000.0,,-540259284.5700014,.
409000438620',2019-03-01,AEPS PAY CR ADJIndiaforensic 270,,2019-03-01,,1.0,-540259283.5700014,.
409000438620',2019-03-01,AEPS PAY Indiaforensic 2802,,2019-03-01,,666.41,-540258617.1600014,.
409000438620',2019-03-01,AEPS INCOME DT 02-28-2019,,2019-03-01,,2128.05,-540256489.1100014,.
409000438620',2019-03-01,AEPS GST INC DT 02-28-201,,2019-03-01,,425.61,-540256063.5000014,.
409000438620',2019-03-01,MICRO ATM WDL FEE DT28021,,2019-03-01,,125100.0,-540130963.5000014,.
409000438620',2019-03-01,MICRO ATM INC DATED 28021,,2019-03-01,,315.0,-540130648.5000014,.
409000438620',2019-03-01,MICRO ATM GST DATED 28021,,2019-03-01,,63.0,-540130585.5000014,.
409000438620',2019-03-01,MICRO ATM WDL FEE DT01031,,2019-03-01,,113700.0,-540016885.5000014,.
409000438620',2019-03-01,MICRO ATM INC DATED 01031,,2019-03-01,,211.68,-540016673.8200015,.
409000438620',2019-03-01,MICRO ATM GST DATED 01031,,2019-03-01,,42.34,-540016631.4800014,.
409000438620',2019-03-01,FDRL/INTERNAL FUND TRANSFE,,2019-03-01,200000.0,,-540216631.4800014,.
409000438620',2019-03-02,Indiaforensic AEPS NPCI WDL SET,,2019-03-02,,1029800.0,-539186831.4800014,.
409000438620',2019-03-02,FDRL/INTERNAL FUND TRANSFE,,2019-03-02,1000000.0,,-540186831.4800014,.
409000438620',2019-03-02,MICRO ATM WDL FEE DT01031,,2019-03-02,,238700.0,-539948131.4800014,.
409000438620',2019-03-02,MICRO ATM INC DATED 01031,,2019-03-02,,492.84,-539947638.6400014,.
409000438620',2019-03-02,MICRO ATM GST DATED 01031,,2019-03-02,,98.57,-539947540.0700014,.
409000438620',2019-03-02,AEPS INCOME DT 03-01-2019,,2019-03-02,,2574.36,-539944965.7100013,.
409000438620',2019-03-02,AEPS GST INC DT 03-01-201,,2019-03-02,,514.87,-539944450.8400013,.
409000438620',2019-03-02,FDRL/INTERNAL FUND TRANSFE,,2019-03-02,300000.0,,-540244450.8400013,.
409000438620',2019-03-02,MICRO ATM WDL FEE DT02031,,2019-03-02,,71000.0,-540173450.8400013,.
409000438620',2019-03-02,MICRO ATM INC DATED 02031,,2019-03-02,,183.6,-540173267.2400013,.
409000438620',2019-03-02,MICRO ATM GST DATED 02031,,2019-03-02,,36.72,-540173230.5200013,.
409000438620',2019-03-04,Indiaforensic AEPS NPCI WDL SET,,2019-03-04,,907100.0,-539266130.5200013,.
409000438620',2019-03-04,Indiaforensic AEPS NPCI WDL SET,,2019-03-04,,729700.0,-538536430.5200013,.
409000438620',2019-03-04,AEPS INCOME DT 03-02-2019,,2019-03-04,,2185.38,-538534245.1400013,.
409000438620',2019-03-04,AEPS GST INC DT 03-02-201,,2019-03-04,,437.08,-538533808.0600013,.
409000438620',2019-03-04,AEPS INCOME DT 03-03-2019,,2019-03-04,,2045.16,-538531762.9000013,.
409000438620',2019-03-04,AEPS GST INC DT 03-03-201,,2019-03-04,,409.03,-538531353.8700013,.
409000438620',2019-03-04,FDRL/INTERNAL FUND TRANSFE,,2019-03-04,500000.0,,-539031353.8700013,.
409000438620',2019-03-04,FDRL/INTERNAL FUND TRANSFE,,2019-03-04,200000.0,,-539231353.8700013,.
409000438620',2019-03-04,FDRL/INTERNAL FUND TRANSFE,,2019-03-04,1000000.0,,-540231353.8700013,.
409000438620',2019-03-05,Indiaforensic AEPS NPCI WDL SET,,2019-03-05,,777400.0,-539453953.8700013,.
409000438620',2019-03-05,FDRL/INTERNAL FUND TRANSFE,,2019-03-05,500000.0,,-539953953.8700013,.
409000438620',2019-03-05,FDRL/INTERNAL FUND TRANSFE,,2019-03-05,300000.0,,-540253953.8700013,.
409000438620',2019-03-05,MICRO ATM WDL FEE DT02031,,2019-03-05,,235000.0,-540018953.8700013,.
409000438620',2019-03-05,MICRO ATM INC DATED 02031,,2019-03-05,,501.12,-540018452.7500013,.
409000438620',2019-03-05,MICRO ATM GST DATED 02031,,2019-03-05,,100.22,-540018352.5300013,.
409000438620',2019-03-05,MAW/502964XXXXXX1001/NAGA,,2019-03-05,,500.0,-540017852.5300013,.
409000438620',2019-03-05,MICRO ATM WDL FEE DT03031,,2019-03-05,,324400.0,-539693452.5300013,.
409000438620',2019-03-05,MICRO ATM INC DATED 03031,,2019-03-05,,698.4,-539692754.1300013,.
409000438620',2019-03-05,MICRO ATM GST DATED 03031,,2019-03-05,,139.68,-539692614.4500014,.
409000438620',2019-03-05,AEPS INCOME DT 03-04-2019,,2019-03-05,,2036.52,-539690577.9300014,.
409000438620',2019-03-05,AEPS GST INC DT 03-04-201,,2019-03-05,,407.3,-539690170.6300014,.
409000438620',2019-03-05,MICRO ATM WDL FEE DT04031,,2019-03-05,,162500.0,-539527670.6300014,.
409000438620',2019-03-05,MICRO ATM INC DATED 04031,,2019-03-05,,363.6,-539527307.0300014,.
409000438620',2019-03-05,MICRO ATM GST DATED 04031,,2019-03-05,,72.72,-539527234.3100014,.
409000438620',2019-03-05,MICRO ATM WDL FEE DT04031,,2019-03-05,,195800.0,-539331434.3100014,.
409000438620',2019-03-05,MICRO ATM INC DATED 04031,,2019-03-05,,440.64,-539330993.6700014,.
409000438620',2019-03-05,MICRO ATM GST DATED 04031,,2019-03-05,,88.13,-539330905.5400014,.
409000438620',2019-03-05,FDRL/INTERNAL FUND TRANSFE,,2019-03-05,300000.0,,-539630905.5400014,.
409000438620',2019-03-05,FDRL/INTERNAL FUND TRANSFE,,2019-03-05,300000.0,,-539930905.5400014,.
409000438620',2019-03-05,FDRL/INTERNAL FUND TRANSFE,,2019-03-05,300000.0,,-540230905.5400014,.
409000438620',2019-03-05,MICRO ATM WDL FEE DT05031,,2019-03-05,,267200.0,-539963705.5400014,.
409000438620',2019-03-05,MICRO ATM INC DATED 05031,,2019-03-05,,487.44,-539963218.1000013,.
409000438620',2019-03-05,MICRO ATM GST DATED 05031,,2019-03-05,,97.49,-539963120.6100013,.
